,date,Gross Sales,Discounts,Net Sales,Tax,Total Collected,Cash,Card,PayPay
0,2019-01-01,306,0,306,24,330,330,0,0
1,2019-01-01,1120,0,1120,80,1200,1200,0,0
2,2019-01-01,769,0,769,61,830,830,0,0
3,2019-01-01,1028,0,1028,82,1110,1110,0,0
4,2019-01-01,260,0,260,20,280,280,0,0
5,2019-01-01,629,0,629,41,670,670,0,0
6,2019-01-01,2389,0,2389,191,2580,2580,0,0
7,2019-01-01,260,0,260,20,280,280,0,0
8,2019-01-01,311,0,311,24,335,335,0,0
9,2019-01-01,1047,0,1047,83,1130,1130,0,0
10,2019-01-01,260,0,260,20,280,280,0,0
11,2019-01-01,112,0,112,8,120,120,0,0
12,2019-01-01,760,0,760,60,820,820,0,0
13,2019-01-01,690,0,690,55,745,745,0,0
14,2019-01-01,639,0,639,51,690,690,0,0
15,2019-01-01,1519,0,1519,121,1640,1640,0,0
16,2019-01-01,1112,0,1112,88,1200,1200,0,0
17,2019-01-01,1751,0,1751,139,1890,1890,0,0
18,2019-01-01,1490,0,1490,110,1600,1600,0,0
19,2019-01-01,1926,0,1926,154,2080,2080,0,0
20,2019-01-01,686,0,686,54,740,740,0,0
21,2019-01-01,1972,0,1972,148,2120,2120,0,0
22,2019-01-01,1445,0,1445,115,1560,1560,0,0
23,2019-01-01,1112,0,1112,88,1200,1200,0,0
24,2019-01-01,1815,0,1815,145,1960,1960,0,0
25,2019-01-01,139,0,139,11,150,150,0,0
26,2019-01-01,1018,0,1018,72,1090,1090,0,0
27,2019-01-01,1815,0,1815,145,1960,1960,0,0
28,2019-01-01,288,0,288,22,310,310,0,0
29,2019-01-01,575,0,575,45,620,620,0,0
30,2019-01-01,751,0,751,59,810,810,0,0
31,2019-01-01,1815,0,1815,145,1960,1960,0,0
32,2019-01-01,408,0,408,32,440,440,0,0
33,2019-01-01,1334,0,1334,106,1440,1440,0,0
34,2019-01-01,1084,0,1084,86,1170,1170,0,0
35,2019-01-01,389,0,389,31,420,420,0,0
36,2019-01-01,1343,0,1343,107,1450,1450,0,0
37,2019-01-01,648,0,648,42,690,690,0,0
38,2019-01-01,1223,-1000,223,17,240,240,0,0
39,2019-01-01,1815,0,1815,145,1960,1960,0,0
40,2019-01-01,1028,-1000,28,2,30,30,0,0
41,2019-01-01,732,0,732,58,790,790,0,0
42,2019-01-01,991,0,991,79,1070,1070,0,0
43,2019-01-01,1306,-1000,306,24,330,330,0,0
44,2019-01-01,760,0,760,60,820,820,0,0
45,2019-01-01,2538,0,2538,202,2740,2740,0,0
46,2019-01-01,2075,0,2075,165,2240,0,2240,0
47,2019-01-01,2723,0,2723,217,2940,2940,0,0
48,2019-01-01,908,0,908,72,980,980,0,0
49,2019-01-01,908,0,908,72,980,980,0,0
50,2019-01-01,639,0,639,51,690,690,0,0
51,2019-01-01,249,0,249,11,260,260,0,0
52,2019-01-01,1815,0,1815,145,1960,1960,0,0
53,2019-01-01,528,0,528,42,570,570,0,0
54,2019-01-01,788,0,788,62,850,850,0,0
55,2019-01-01,5001,0,5001,399,5400,5400,0,0
56,2019-01-01,232,0,232,18,250,250,0,0
57,2019-01-01,842,0,842,58,900,900,0,0
58,2019-01-01,1065,0,1065,85,1150,1150,0,0
59,2019-01-01,1047,-1000,47,3,50,50,0,0
60,2019-01-01,1195,0,1195,95,1290,1290,0,0
61,2019-01-01,1815,0,1815,145,1960,1960,0,0
62,2019-01-01,2723,0,2723,217,2940,2940,0,0
63,2019-01-01,749,0,749,51,800,800,0,0
64,2019-01-01,417,0,417,33,450,450,0,0
65,2019-01-01,362,0,362,28,390,390,0,0
66,2019-01-01,362,0,362,28,390,0,390,0
67,2019-01-01,667,0,667,53,720,720,0,0
68,2019-01-01,908,0,908,72,980,980,0,0
69,2019-01-01,379,0,379,21,400,400,0,0
70,2019-01-01,260,0,260,20,280,280,0,0
71,2019-01-01,1371,0,1371,109,1480,1480,0,0
72,2019-01-01,945,0,945,75,1020,1020,0,0
73,2019-01-01,463,0,463,37,500,500,0,0
74,2019-01-01,925,0,925,65,990,990,0,0
75,2019-01-01,796,0,796,54,850,850,0,0
76,2019-01-01,2723,0,2723,217,2940,2940,0,0
77,2019-01-01,712,0,712,48,760,0,760,0
78,2019-01-01,889,0,889,71,960,960,0,0
79,2019-01-01,1019,0,1019,81,1100,1100,0,0
80,2019-01-01,445,0,445,35,480,480,0,0
81,2019-01-01,167,0,167,13,180,180,0,0
82,2019-01-01,371,0,371,29,400,400,0,0
83,2019-01-01,139,0,139,11,150,150,0,0
84,2019-01-01,112,0,112,8,120,120,0,0
85,2019-01-01,352,0,352,28,380,380,0,0
86,2019-01-01,278,0,278,22,300,300,0,0
87,2019-01-01,1620,0,1620,120,1740,1740,0,0
88,2019-01-01,1176,0,1176,94,1270,1270,0,0
89,2019-01-01,139,0,139,11,150,150,0,0
90,2019-01-01,278,0,278,22,300,300,0,0
91,2019-01-01,602,0,602,48,650,650,0,0
92,2019-01-01,1056,0,1056,84,1140,1140,0,0
93,2019-01-01,630,0,630,50,680,680,0,0
94,2019-01-01,751,0,751,59,810,810,0,0
95,2019-01-01,1565,0,1565,125,1690,1690,0,0
96,2019-01-01,278,0,278,22,300,300,0,0
97,2019-01-01,519,0,519,41,560,560,0,0
98,2019-01-01,1648,0,1648,122,1770,1770,0,0
99,2019-01-01,306,0,306,24,330,330,0,0
100,2019-01-01,325,0,325,25,350,350,0,0
101,2019-01-01,389,0,389,31,420,420,0,0
102,2019-01-01,139,0,139,11,150,150,0,0
103,2019-01-01,600,0,600,30,630,630,0,0
104,2019-01-01,769,0,769,61,830,830,0,0
105,2019-01-01,527,0,527,33,560,560,0,0
106,2019-01-01,4019,-1000,3019,241,3260,3260,0,0
107,2019-01-01,445,0,445,35,480,480,0,0
108,2019-01-01,630,0,630,50,680,680,0,0
109,2019-01-01,315,0,315,25,340,340,0,0
110,2019-01-01,1269,0,1269,101,1370,1370,0,0
111,2019-01-01,1232,0,1232,98,1330,1330,0,0
112,2019-01-01,1491,0,1491,119,1610,1610,0,0
113,2019-01-01,612,0,612,48,660,660,0,0
114,2019-01-01,232,0,232,18,250,250,0,0
115,2019-01-01,2139,0,2139,171,2310,2310,0,0
116,2019-01-01,1186,0,1186,94,1280,1280,0,0
117,2019-01-01,1325,0,1325,105,1430,1430,0,0
118,2019-01-01,1352,0,1352,108,1460,1460,0,0
119,2019-01-01,2408,0,2408,192,2600,2600,0,0
120,2019-01-01,278,0,278,22,300,300,0,0
121,2019-01-01,510,0,510,40,550,550,0,0
122,2019-01-01,407,0,407,23,430,430,0,0
123,2019-01-01,1001,0,1001,79,1080,1080,0,0
124,2019-01-01,1389,0,1389,111,1500,1500,0,0
125,2019-01-01,1667,0,1667,133,1800,1800,0,0
126,2019-01-01,926,0,926,74,1000,1000,0,0
127,2019-01-01,454,0,454,36,490,490,0,0
128,2019-01-01,1213,-1000,213,17,230,230,0,0
129,2019-01-01,1473,0,1473,117,1590,1590,0,0
130,2019-01-01,695,0,695,55,750,750,0,0
131,2019-01-01,565,0,565,45,610,610,0,0
132,2019-01-01,1683,0,1683,117,1800,1800,0,0
133,2019-01-01,612,0,612,48,660,660,0,0
134,2019-01-01,473,0,473,37,510,510,0,0
135,2019-01-01,519,0,519,41,560,560,0,0
136,2019-01-01,1036,0,1036,74,1110,1110,0,0
137,2019-01-01,1797,0,1797,143,1940,1940,0,0
138,2019-01-01,417,0,417,33,450,450,0,0
139,2019-01-01,463,0,463,37,500,500,0,0
140,2019-01-01,843,0,843,67,910,910,0,0
141,2019-01-01,908,0,908,72,980,980,0,0
142,2019-01-01,815,0,815,65,880,880,0,0
143,2019-01-01,1491,0,1491,119,1610,1610,0,0
144,2019-01-01,1658,0,1658,132,1790,1790,0,0
145,2019-01-01,1528,0,1528,122,1650,1650,0,0
146,2019-01-01,926,0,926,74,1000,1000,0,0
147,2019-01-01,1195,0,1195,95,1290,1290,0,0
148,2019-01-01,1158,0,1158,92,1250,1250,0,0
149,2019-01-01,1815,0,1815,145,1960,1960,0,0
150,2019-01-01,1027,0,1027,73,1100,1100,0,0
151,2019-01-01,991,0,991,79,1070,1070,0,0
152,2019-01-01,463,0,463,37,500,500,0,0
153,2019-01-01,306,0,306,24,330,330,0,0
154,2019-01-01,1815,0,1815,145,1960,1960,0,0
155,2019-01-01,1111,0,1111,79,1190,1190,0,0
156,2019-01-01,875,-58,817,65,882,882,0,0
157,2019-01-01,269,0,269,21,290,290,0,0
158,2019-01-01,-1389,0,-1389,-111,-1500,-1500,0,0
159,2019-01-01,1389,0,1389,111,1500,1500,0,0
160,2019-01-01,1917,0,1917,153,2070,2070,0,0
161,2019-01-01,1815,0,1815,145,1960,1960,0,0
162,2019-01-01,3630,0,3630,290,3920,3920,0,0
163,2019-01-01,2723,0,2723,217,2940,2940,0,0
164,2019-01-01,445,0,445,35,480,480,0,0
165,2019-01-01,5001,0,5001,399,5400,0,5400,0
166,2019-01-01,1121,0,1121,89,1210,1210,0,0
167,2019-01-01,1149,0,1149,91,1240,1240,0,0
168,2019-01-01,1815,0,1815,145,1960,1960,0,0
169,2019-01-01,510,0,510,40,550,550,0,0
170,2019-01-01,343,0,343,27,370,370,0,0
171,2019-01-01,908,0,908,72,980,980,0,0
172,2019-01-01,389,0,389,31,420,0,420,0
173,2019-01-01,565,0,565,45,610,610,0,0
174,2019-01-01,1352,0,1352,108,1460,1460,0,0
175,2019-01-01,334,0,334,26,360,360,0,0
176,2019-01-01,954,0,954,76,1030,1030,0,0
177,2019-01-01,778,0,778,62,840,840,0,0
178,2019-01-01,1815,0,1815,145,1960,1960,0,0
179,2019-01-01,315,0,315,25,340,340,0,0
180,2019-01-01,518,0,518,32,550,550,0,0
181,2019-01-01,1825,0,1825,145,1970,1970,0,0
182,2019-01-01,556,0,556,44,600,600,0,0
183,2019-01-01,796,0,796,54,850,850,0,0
184,2019-01-01,510,0,510,40,550,550,0,0
185,2019-01-01,908,0,908,72,980,980,0,0
186,2019-01-01,750,0,750,60,810,810,0,0
187,2019-01-01,1815,0,1815,145,1960,1960,0,0
188,2019-01-01,1528,0,1528,122,1650,1650,0,0
189,2019-01-01,1084,0,1084,86,1170,1170,0,0
190,2019-01-01,1167,0,1167,93,1260,1260,0,0
191,2019-01-01,528,0,528,42,570,570,0,0
192,2019-01-01,389,0,389,31,420,420,0,0
193,2019-01-01,1306,0,1306,104,1410,1410,0,0
194,2019-01-01,1380,0,1380,110,1490,1490,0,0
195,2019-01-01,2158,0,2158,172,2330,2330,0,0
196,2019-01-01,1843,-1000,843,67,910,910,0,0
197,2019-01-01,1038,0,1038,82,1120,1120,0,0
198,2019-01-01,491,0,491,39,530,530,0,0
199,2019-01-01,806,0,806,64,870,870,0,0
200,2019-01-01,343,0,343,27,370,370,0,0
201,2019-01-01,667,0,667,53,720,720,0,0
202,2019-01-01,1399,0,1399,111,1510,0,1510,0
203,2019-01-01,1232,0,1232,98,1330,1330,0,0
204,2019-01-01,695,0,695,55,750,750,0,0
205,2019-01-01,788,0,788,62,850,850,0,0
206,2019-01-01,167,0,167,13,180,180,0,0
207,2019-01-01,1028,0,1028,82,1110,1110,0,0
208,2019-01-01,389,0,389,31,420,420,0,0
209,2019-01-01,1260,0,1260,100,1360,1360,0,0
210,2019-01-01,1223,0,1223,97,1320,0,1320,0
211,2019-01-01,93,0,93,7,100,100,0,0
212,2019-01-01,1158,-1000,158,12,170,170,0,0
213,2019-01-01,2887,0,2887,213,3100,3100,0,0
214,2019-01-01,556,0,556,44,600,600,0,0
215,2019-01-01,584,0,584,46,630,630,0,0
216,2019-01-01,658,0,658,52,710,710,0,0
217,2019-01-01,1954,0,1954,156,2110,2110,0,0
218,2019-01-01,2380,0,2380,190,2570,2570,0,0
219,2019-01-01,1065,0,1065,85,1150,1150,0,0
220,2019-01-01,862,0,862,68,930,930,0,0
221,2019-01-01,639,0,639,51,690,690,0,0
222,2019-01-01,676,0,676,54,730,730,0,0
223,2019-01-01,1251,0,1251,99,1350,1350,0,0
224,2019-01-01,2158,0,2158,172,2330,2330,0,0
225,2019-01-01,399,0,399,31,430,430,0,0
226,2019-01-01,751,0,751,59,810,810,0,0
227,2019-01-01,1213,0,1213,97,1310,1310,0,0
228,2019-01-01,917,0,917,73,990,990,0,0
229,2019-01-01,482,0,482,38,520,520,0,0
230,2019-01-01,510,0,510,40,550,550,0,0
231,2019-01-01,806,0,806,64,870,870,0,0
232,2019-01-01,1241,0,1241,99,1340,1340,0,0
233,2019-01-01,232,0,232,18,250,250,0,0
234,2019-01-01,917,0,917,73,990,990,0,0
235,2019-01-01,1075,0,1075,85,1160,1160,0,0
236,2019-01-01,769,0,769,61,830,830,0,0
237,2019-01-01,1815,0,1815,145,1960,1960,0,0
238,2019-01-01,315,0,315,25,340,340,0,0
239,2019-01-01,278,0,278,22,300,300,0,0
240,2019-01-01,1288,0,1288,102,1390,1390,0,0
241,2019-01-01,723,0,723,57,780,780,0,0
242,2019-01-01,2001,0,2001,159,2160,2160,0,0
243,2019-01-01,676,0,676,54,730,730,0,0
244,2019-01-01,1121,0,1121,89,1210,1210,0,0
245,2019-01-01,1815,0,1815,145,1960,1960,0,0
246,2019-01-01,371,0,371,29,400,400,0,0
247,2019-01-01,1001,0,1001,79,1080,1080,0,0
248,2019-01-01,620,0,620,40,660,660,0,0
249,2019-01-02,-1815,0,-1815,-145,-1960,-1960,0,0
250,2019-01-02,649,0,649,51,700,700,0,0
251,2019-01-02,917,0,917,73,990,990,0,0
252,2019-01-02,1019,0,1019,81,1100,1100,0,0
253,2019-01-02,2038,0,2038,162,2200,2200,0,0
254,2019-01-02,1815,0,1815,145,1960,1960,0,0
255,2019-01-02,1167,0,1167,93,1260,1260,0,0
256,2019-01-02,232,0,232,18,250,250,0,0
257,2019-01-02,1176,0,1176,94,1270,1270,0,0
258,2019-01-02,3693,0,3693,277,3970,3970,0,0
259,2019-01-02,1065,0,1065,85,1150,1150,0,0
260,2019-01-02,1149,0,1149,91,1240,1240,0,0
261,2019-01-02,931,0,931,74,1005,1005,0,0
262,2019-01-02,1028,0,1028,82,1110,1110,0,0
263,2019-01-02,1454,0,1454,116,1570,1570,0,0
264,2019-01-02,1334,0,1334,106,1440,1440,0,0
265,2019-01-02,1815,0,1815,145,1960,1960,0,0
266,2019-01-02,1806,0,1806,144,1950,1950,0,0
267,2019-01-02,963,0,963,77,1040,1040,0,0
268,2019-01-02,1815,0,1815,145,1960,1960,0,0
269,2019-01-02,1047,0,1047,83,1130,1130,0,0
270,2019-01-02,1815,0,1815,145,1960,1960,0,0
271,2019-01-02,1010,0,1010,80,1090,1090,0,0
272,2019-01-02,1510,0,1510,120,1630,1630,0,0
273,2019-01-02,1815,0,1815,145,1960,1960,0,0
274,2019-01-02,1380,0,1380,110,1490,1490,0,0
275,2019-01-02,769,0,769,61,830,0,830,0
276,2019-01-02,2167,0,2167,173,2340,2340,0,0
277,2019-01-02,612,0,612,48,660,660,0,0
278,2019-01-02,482,0,482,38,520,520,0,0
279,2019-01-02,565,0,565,45,610,610,0,0
280,2019-01-02,786,0,786,54,840,840,0,0
281,2019-01-02,565,0,565,45,610,610,0,0
282,2019-01-02,334,0,334,26,360,360,0,0
283,2019-01-02,823,0,823,57,880,880,0,0
284,2019-01-02,306,0,306,24,330,330,0,0
285,2019-01-02,731,0,731,49,780,780,0,0
286,2019-01-02,538,0,538,42,580,580,0,0
287,2019-01-02,2195,0,2195,175,2370,2370,0,0
288,2019-01-02,639,0,639,51,690,690,0,0
289,2019-01-02,102,0,102,8,110,110,0,0
290,2019-01-02,1176,0,1176,94,1270,1270,0,0
291,2019-01-02,2019,0,2019,161,2180,2180,0,0
292,2019-01-02,908,0,908,72,980,0,980,0
293,2019-01-02,-491,0,-491,-39,-530,0,-530,0
294,2019-01-02,769,0,769,61,830,830,0,0
295,2019-01-02,686,0,686,54,740,740,0,0
296,2019-01-02,593,0,593,47,640,640,0,0
297,2019-01-02,880,0,880,70,950,950,0,0
298,2019-01-02,3630,0,3630,290,3920,3920,0,0
299,2019-01-02,1815,0,1815,145,1960,1960,0,0
300,2019-01-02,528,0,528,42,570,570,0,0
301,2019-01-02,463,0,463,37,500,500,0,0
302,2019-01-02,602,0,602,48,650,650,0,0
303,2019-01-02,908,0,908,72,980,980,0,0
304,2019-01-02,1399,0,1399,111,1510,1510,0,0
305,2019-01-02,371,0,371,29,400,400,0,0
306,2019-01-02,306,0,306,24,330,330,0,0
307,2019-01-02,1510,0,1510,120,1630,1630,0,0
308,2019-01-02,695,0,695,55,750,750,0,0
309,2019-01-02,908,0,908,72,980,980,0,0
310,2019-01-02,1139,0,1139,91,1230,1230,0,0
311,2019-01-02,935,0,935,65,1000,1000,0,0
312,2019-01-02,47,0,47,3,50,50,0,0
313,2019-01-02,1139,0,1139,91,1230,1230,0,0
314,2019-01-02,1213,0,1213,97,1310,1310,0,0
315,2019-01-02,306,0,306,24,330,330,0,0
316,2019-01-02,1815,0,1815,145,1960,1960,0,0
317,2019-01-02,649,0,649,51,700,700,0,0
318,2019-01-02,667,0,667,53,720,720,0,0
319,2019-01-02,389,0,389,31,420,420,0,0
320,2019-01-02,2936,0,2936,234,3170,0,3170,0
321,2019-01-02,2112,0,2112,168,2280,2280,0,0
322,2019-01-02,1028,0,1028,82,1110,1110,0,0
323,2019-01-02,1815,0,1815,145,1960,1960,0,0
324,2019-01-02,2723,0,2723,217,2940,2940,0,0
325,2019-01-02,1408,0,1408,112,1520,1520,0,0
326,2019-01-02,908,0,908,72,980,980,0,0
327,2019-01-02,343,0,343,27,370,370,0,0
328,2019-01-02,3602,0,3602,288,3890,3890,0,0
329,2019-01-02,399,0,399,31,430,430,0,0
330,2019-01-02,649,0,649,51,700,700,0,0
331,2019-01-02,1010,0,1010,80,1090,1090,0,0
332,2019-01-02,371,0,371,29,400,400,0,0
333,2019-01-02,399,0,399,31,430,430,0,0
334,2019-01-02,713,0,713,57,770,770,0,0
335,2019-01-02,362,0,362,28,390,390,0,0
336,2019-01-02,2498,0,2498,182,2680,2680,0,0
337,2019-01-02,325,0,325,25,350,350,0,0
338,2019-01-02,1297,0,1297,103,1400,1400,0,0
339,2019-01-02,1649,0,1649,131,1780,1780,0,0
340,2019-01-02,435,0,435,25,460,460,0,0
341,2019-01-02,1102,0,1102,88,1190,1190,0,0
342,2019-01-02,452,0,452,18,470,470,0,0
343,2019-01-02,334,0,334,26,360,360,0,0
344,2019-01-02,639,0,639,51,690,690,0,0
345,2019-01-02,639,0,639,51,690,690,0,0
346,2019-01-02,954,0,954,76,1030,1030,0,0
347,2019-01-02,908,0,908,72,980,980,0,0
348,2019-01-02,1130,0,1130,90,1220,1220,0,0
349,2019-01-02,565,0,565,45,610,610,0,0
350,2019-01-02,1010,0,1010,80,1090,1090,0,0
351,2019-01-02,2815,0,2815,225,3040,3040,0,0
352,2019-01-02,2093,0,2093,167,2260,2260,0,0
353,2019-01-02,352,0,352,28,380,380,0,0
354,2019-01-02,362,0,362,28,390,390,0,0
355,2019-01-02,112,0,112,8,120,120,0,0
356,2019-01-02,1159,0,1159,93,1252,1252,0,0
357,2019-01-02,991,0,991,79,1070,1070,0,0
358,2019-01-02,1343,0,1343,107,1450,1450,0,0
359,2019-01-02,1241,0,1241,99,1340,0,1340,0
360,2019-01-02,195,0,195,15,210,210,0,0
361,2019-01-02,1056,0,1056,84,1140,1140,0,0
362,2019-01-02,1889,0,1889,151,2040,2040,0,0
363,2019-01-02,1019,0,1019,81,1100,1100,0,0
364,2019-01-02,362,0,362,28,390,390,0,0
365,2019-01-02,880,0,880,70,950,950,0,0
366,2019-01-02,2251,0,2251,179,2430,2430,0,0
367,2019-01-02,788,0,788,62,850,850,0,0
368,2019-01-02,695,0,695,55,750,750,0,0
369,2019-01-02,167,0,167,13,180,180,0,0
370,2019-01-02,1815,0,1815,145,1960,1960,0,0
371,2019-01-02,232,0,232,18,250,250,0,0
372,2019-01-02,1908,0,1908,152,2060,2060,0,0
373,2019-01-02,926,0,926,74,1000,1000,0,0
374,2019-01-02,676,0,676,54,730,730,0,0
375,2019-01-02,988,-210,778,62,840,840,0,0
376,2019-01-02,371,0,371,29,400,400,0,0
377,2019-01-02,1371,0,1371,109,1480,1480,0,0
378,2019-01-02,1815,0,1815,145,1960,1960,0,0
379,2019-01-02,399,0,399,31,430,430,0,0
380,2019-01-02,139,0,139,11,150,150,0,0
381,2019-01-02,491,0,491,39,530,530,0,0
382,2019-01-02,704,0,704,56,760,760,0,0
383,2019-01-02,232,0,232,18,250,250,0,0
384,2019-01-02,501,0,501,39,540,540,0,0
385,2019-01-02,130,0,130,10,140,140,0,0
386,2019-01-02,1334,0,1334,106,1440,1440,0,0
387,2019-01-02,130,0,130,10,140,140,0,0
388,2019-01-02,3259,0,3259,251,3510,3510,0,0
389,2019-01-02,278,0,278,22,300,300,0,0
390,2019-01-02,2723,0,2723,217,2940,2940,0,0
391,2019-01-02,417,0,417,33,450,450,0,0
392,2019-01-02,1070,0,1070,85,1155,1155,0,0
393,2019-01-02,510,0,510,40,550,550,0,0
394,2019-01-02,851,0,851,59,910,910,0,0
395,2019-01-02,232,0,232,18,250,250,0,0
396,2019-01-02,362,0,362,28,390,390,0,0
397,2019-01-02,334,0,334,26,360,360,0,0
398,2019-01-02,1334,0,1334,106,1440,1440,0,0
399,2019-01-02,908,0,908,72,980,980,0,0
400,2019-01-02,1639,0,1639,131,1770,1770,0,0
401,2019-01-02,195,0,195,15,210,210,0,0
402,2019-01-02,649,0,649,51,700,700,0,0
403,2019-01-02,186,0,186,14,200,200,0,0
404,2019-01-02,435,0,435,25,460,460,0,0
405,2019-01-02,436,0,436,34,470,470,0,0
406,2019-01-02,1482,0,1482,118,1600,1600,0,0
407,2019-01-02,510,0,510,40,550,550,0,0
408,2019-01-02,362,0,362,28,390,390,0,0
409,2019-01-02,797,0,797,63,860,860,0,0
410,2019-01-02,917,0,917,73,990,990,0,0
411,2019-01-02,510,0,510,40,550,550,0,0
412,2019-01-02,2047,0,2047,163,2210,0,2210,0
413,2019-01-02,556,0,556,44,600,600,0,0
414,2019-01-02,75862,0,75862,6068,81930,81930,0,0
415,2019-01-02,269,0,269,21,290,290,0,0
416,2019-01-02,917,0,917,73,990,990,0,0
417,2019-01-02,1945,0,1945,155,2100,2100,0,0
418,2019-01-02,612,0,612,48,660,660,0,0
419,2019-01-02,417,0,417,33,450,450,0,0
420,2019-01-02,871,0,871,69,940,940,0,0
421,2019-01-02,408,0,408,32,440,440,0,0
422,2019-01-02,741,0,741,59,800,800,0,0
423,2019-01-02,269,0,269,21,290,290,0,0
424,2019-01-02,408,0,408,32,440,440,0,0
425,2019-01-02,269,0,269,21,290,290,0,0
426,2019-01-02,556,0,556,44,600,600,0,0
427,2019-01-02,269,0,269,21,290,290,0,0
428,2019-01-02,871,0,871,69,940,940,0,0
429,2019-01-02,1473,0,1473,117,1590,1590,0,0
430,2019-01-02,1501,0,1501,119,1620,1620,0,0
431,2019-01-02,-75862,0,-75862,-6068,-81930,-81930,0,0
432,2019-01-02,380,0,380,30,410,410,0,0
433,2019-01-02,73084,0,73084,5846,78930,78930,0,0
434,2019-01-02,4538,0,4538,362,4900,4900,0,0
435,2019-01-02,362,0,362,28,390,390,0,0
436,2019-01-02,1269,0,1269,101,1370,1370,0,0
437,2019-01-02,778,0,778,62,840,840,0,0
438,2019-01-02,751,0,751,59,810,810,0,0
439,2019-01-02,251,0,251,19,270,270,0,0
440,2019-01-02,1509,0,1509,111,1620,1620,0,0
441,2019-01-02,741,0,741,59,800,800,0,0
442,2019-01-02,1815,0,1815,145,1960,1960,0,0
443,2019-01-02,1889,0,1889,151,2040,2040,0,0
444,2019-01-02,908,0,908,72,980,980,0,0
445,2019-01-02,908,0,908,72,980,980,0,0
446,2019-01-02,908,0,908,72,980,980,0,0
447,2019-01-02,908,0,908,72,980,980,0,0
448,2019-01-02,389,0,389,31,420,420,0,0
449,2019-01-02,1815,0,1815,145,1960,1960,0,0
450,2019-01-02,852,0,852,68,920,920,0,0
451,2019-01-02,2723,0,2723,217,2940,2940,0,0
452,2019-01-02,3000,-3000,0,0,0,0,0,0
453,2019-01-02,806,0,806,64,870,870,0,0
454,2019-01-02,269,0,269,21,290,290,0,0
455,2019-01-02,445,0,445,35,480,480,0,0
456,2019-01-02,352,0,352,28,380,380,0,0
457,2019-01-02,278,0,278,22,300,300,0,0
458,2019-01-02,139,0,139,11,150,150,0,0
459,2019-01-02,851,0,851,59,910,910,0,0
460,2019-01-02,565,0,565,45,610,610,0,0
461,2019-01-02,269,0,269,21,290,290,0,0
462,2019-01-02,241,0,241,19,260,260,0,0
463,2019-01-02,2723,0,2723,217,2940,2940,0,0
464,2019-01-02,371,0,371,29,400,400,0,0
465,2019-01-02,760,0,760,60,820,820,0,0
466,2019-01-02,723,0,723,57,780,780,0,0
467,2019-01-02,639,0,639,51,690,690,0,0
468,2019-01-02,47,0,47,3,50,50,0,0
469,2019-01-02,843,0,843,67,910,910,0,0
470,2019-01-02,362,0,362,28,390,390,0,0
471,2019-01-02,389,0,389,31,420,420,0,0
472,2019-01-02,1047,0,1047,83,1130,1130,0,0
473,2019-01-02,491,0,491,39,530,530,0,0
474,2019-01-02,880,0,880,70,950,950,0,0
475,2019-01-02,1112,0,1112,88,1200,1200,0,0
476,2019-01-02,399,0,399,31,430,430,0,0
477,2019-01-02,852,0,852,68,920,920,0,0
478,2019-01-02,797,0,797,63,860,860,0,0
479,2019-01-02,3001,0,3001,239,3240,3240,0,0
480,2019-01-02,732,0,732,58,790,790,0,0
481,2019-01-02,806,0,806,64,870,870,0,0
482,2019-01-02,519,0,519,41,560,560,0,0
483,2019-01-02,1167,0,1167,93,1260,1260,0,0
484,2019-01-02,223,0,223,17,240,240,0,0
485,2019-01-02,130,0,130,10,140,140,0,0
486,2019-01-02,399,0,399,31,430,430,0,0
487,2019-01-02,1658,0,1658,132,1790,1790,0,0
488,2019-01-02,538,0,538,42,580,580,0,0
489,2019-01-02,232,0,232,18,250,250,0,0
490,2019-01-02,741,0,741,59,800,800,0,0
491,2019-01-02,2852,0,2852,228,3080,3080,0,0
492,2019-01-02,269,0,269,21,290,290,0,0
493,2019-01-02,371,0,371,29,400,400,0,0
494,2019-01-02,1380,0,1380,110,1490,1490,0,0
495,2019-01-02,1084,0,1084,86,1170,1170,0,0
496,2019-01-02,501,0,501,39,540,540,0,0
497,2019-01-02,1815,0,1815,145,1960,1960,0,0
498,2019-01-02,852,0,852,68,920,920,0,0
499,2019-01-02,1185,0,1185,85,1270,1270,0,0
500,2019-01-02,1186,0,1186,94,1280,1280,0,0
501,2019-01-02,584,0,584,46,630,630,0,0
502,2019-01-02,371,0,371,29,400,400,0,0
503,2019-01-02,1380,0,1380,110,1490,1490,0,0
504,2019-01-02,575,0,575,45,620,620,0,0
505,2019-01-02,982,0,982,78,1060,1060,0,0
506,2019-01-02,389,0,389,31,420,420,0,0
507,2019-01-02,1121,0,1121,89,1210,1210,0,0
508,2019-01-02,723,0,723,57,780,780,0,0
509,2019-01-02,359,0,359,11,370,370,0,0
510,2019-01-02,825,0,825,65,890,890,0,0
511,2019-01-02,1001,0,1001,79,1080,1080,0,0
512,2019-01-02,1815,0,1815,145,1960,1960,0,0
513,2019-01-02,732,0,732,58,790,790,0,0
514,2019-01-02,362,0,362,28,390,390,0,0
515,2019-01-02,871,0,871,69,940,940,0,0
516,2019-01-02,426,0,426,34,460,460,0,0
517,2019-01-02,579,0,579,46,625,625,0,0
518,2019-01-02,1417,0,1417,113,1530,1530,0,0
519,2019-01-02,973,0,973,77,1050,1050,0,0
520,2019-01-02,1413,0,1413,112,1525,1525,0,0
521,2019-01-02,556,0,556,44,600,600,0,0
522,2019-01-02,908,0,908,72,980,980,0,0
523,2019-01-02,686,0,686,54,740,740,0,0
524,2019-01-02,306,0,306,24,330,330,0,0
525,2019-01-02,278,0,278,22,300,300,0,0
526,2019-01-02,834,0,834,66,900,900,0,0
527,2019-01-02,269,0,269,21,290,290,0,0
528,2019-01-02,463,0,463,37,500,500,0,0
529,2019-01-02,436,0,436,34,470,470,0,0
530,2019-01-02,1028,0,1028,82,1110,1110,0,0
531,2019-01-02,843,0,843,67,910,910,0,0
532,2019-01-02,612,0,612,48,660,660,0,0
533,2019-01-02,621,0,621,49,670,670,0,0
534,2019-01-02,686,0,686,54,740,740,0,0
535,2019-01-02,1862,0,1862,148,2010,2010,0,0
536,2019-01-02,463,0,463,37,500,500,0,0
537,2019-01-02,908,0,908,72,980,980,0,0
538,2019-01-02,218,0,218,17,235,235,0,0
539,2019-01-02,741,0,741,59,800,800,0,0
540,2019-01-02,723,0,723,57,780,780,0,0
541,2019-01-02,1843,0,1843,147,1990,1990,0,0
542,2019-01-02,629,0,629,41,670,670,0,0
543,2019-01-02,1398,0,1398,102,1500,1500,0,0
544,2019-01-02,3075,0,3075,245,3320,3320,0,0
545,2019-01-02,592,0,592,38,630,630,0,0
546,2019-01-02,1815,0,1815,145,1960,1960,0,0
547,2019-01-02,1880,0,1880,150,2030,2030,0,0
548,2019-01-02,1047,0,1047,83,1130,1130,0,0
549,2019-01-02,1815,0,1815,145,1960,1960,0,0
550,2019-01-02,908,0,908,72,980,980,0,0
551,2019-01-02,1399,0,1399,111,1510,1510,0,0
552,2019-01-02,1908,0,1908,152,2060,2060,0,0
553,2019-01-02,760,0,760,60,820,820,0,0
554,2019-01-02,186,0,186,14,200,200,0,0
555,2019-01-02,751,0,751,59,810,810,0,0
556,2019-01-02,2241,0,2241,179,2420,2420,0,0
557,2019-01-02,1473,0,1473,117,1590,1590,0,0
558,2019-01-02,723,0,723,57,780,780,0,0
559,2019-01-02,704,0,704,56,760,760,0,0
560,2019-01-02,926,0,926,74,1000,1000,0,0
561,2019-01-02,510,0,510,40,550,550,0,0
562,2019-01-02,528,0,528,42,570,570,0,0
563,2019-01-02,139,0,139,11,150,150,0,0
564,2019-01-02,538,0,538,42,580,580,0,0
565,2019-01-02,973,0,973,77,1050,1050,0,0
566,2019-01-02,713,0,713,57,770,770,0,0
567,2019-01-02,1167,0,1167,93,1260,1260,0,0
568,2019-01-02,1255,0,1255,100,1355,1355,0,0
569,2019-01-02,1241,0,1241,99,1340,1340,0,0
570,2019-01-02,908,0,908,72,980,980,0,0
571,2019-01-02,482,0,482,38,520,520,0,0
572,2019-01-02,538,0,538,42,580,580,0,0
573,2019-01-02,260,0,260,20,280,280,0,0
574,2019-01-02,278,0,278,22,300,300,0,0
575,2019-01-02,1056,0,1056,84,1140,1140,0,0
576,2019-01-02,732,0,732,58,790,790,0,0
577,2019-01-02,1473,0,1473,117,1590,1590,0,0
578,2019-01-03,723,0,723,57,780,780,0,0
579,2019-01-03,908,0,908,72,980,980,0,0
580,2019-01-03,1815,0,1815,145,1960,1960,0,0
581,2019-01-03,371,0,371,29,400,400,0,0
582,2019-01-03,167,0,167,13,180,180,0,0
583,2019-01-03,1269,0,1269,101,1370,1370,0,0
584,2019-01-03,2723,0,2723,217,2940,2940,0,0
585,2019-01-03,1056,0,1056,84,1140,1140,0,0
586,2019-01-03,1547,0,1547,123,1670,1670,0,0
587,2019-01-03,139,0,139,11,150,150,0,0
588,2019-01-03,343,0,343,27,370,370,0,0
589,2019-01-03,2112,0,2112,168,2280,2280,0,0
590,2019-01-03,1334,0,1334,106,1440,1440,0,0
591,2019-01-03,880,0,880,70,950,950,0,0
592,2019-01-03,491,0,491,39,530,530,0,0
593,2019-01-03,1019,0,1019,81,1100,1100,0,0
594,2019-01-03,1815,0,1815,145,1960,0,1960,0
595,2019-01-03,1158,0,1158,92,1250,1250,0,0
596,2019-01-03,445,0,445,35,480,480,0,0
597,2019-01-03,1408,0,1408,112,1520,1520,0,0
598,2019-01-03,445,0,445,35,480,480,0,0
599,2019-01-03,445,0,445,35,480,480,0,0
600,2019-01-03,445,0,445,35,480,480,0,0
601,2019-01-03,593,0,593,47,640,640,0,0
602,2019-01-03,491,0,491,39,530,530,0,0
603,2019-01-03,658,0,658,52,710,710,0,0
604,2019-01-03,963,0,963,77,1040,1040,0,0
605,2019-01-03,444,0,444,26,470,470,0,0
606,2019-01-03,908,0,908,72,980,980,0,0
607,2019-01-03,269,0,269,21,290,290,0,0
608,2019-01-03,1038,0,1038,82,1120,1120,0,0
609,2019-01-03,1815,0,1815,145,1960,1960,0,0
610,2019-01-03,908,0,908,72,980,980,0,0
611,2019-01-03,306,0,306,24,330,330,0,0
612,2019-01-03,862,0,862,68,930,930,0,0
613,2019-01-03,751,0,751,59,810,810,0,0
614,2019-01-03,352,0,352,28,380,380,0,0
615,2019-01-03,260,0,260,20,280,280,0,0
616,2019-01-03,751,0,751,59,810,810,0,0
617,2019-01-03,306,0,306,24,330,330,0,0
618,2019-01-03,1371,0,1371,109,1480,1480,0,0
619,2019-01-03,473,0,473,37,510,510,0,0
620,2019-01-03,908,0,908,72,980,980,0,0
621,2019-01-03,852,0,852,68,920,920,0,0
622,2019-01-03,908,0,908,72,980,980,0,0
623,2019-01-03,1564,0,1564,116,1680,1680,0,0
624,2019-01-03,908,0,908,72,980,980,0,0
625,2019-01-03,723,0,723,57,780,780,0,0
626,2019-01-03,1343,0,1343,107,1450,1450,0,0
627,2019-01-03,278,0,278,22,300,300,0,0
628,2019-01-03,908,0,908,72,980,980,0,0
629,2019-01-03,1036,0,1036,74,1110,1110,0,0
630,2019-01-03,1815,0,1815,145,1960,1960,0,0
631,2019-01-03,306,0,306,24,330,330,0,0
632,2019-01-03,695,0,695,55,750,750,0,0
633,2019-01-03,445,0,445,35,480,480,0,0
634,2019-01-03,519,0,519,41,560,560,0,0
635,2019-01-03,852,0,852,68,920,920,0,0
636,2019-01-03,1519,0,1519,121,1640,1640,0,0
637,2019-01-03,426,0,426,34,460,460,0,0
638,2019-01-03,1531,-164,1367,109,1476,1476,0,0
639,2019-01-03,1277,0,1277,93,1370,1370,0,0
640,2019-01-03,399,0,399,31,430,430,0,0
641,2019-01-03,1046,0,1046,74,1120,1120,0,0
642,2019-01-03,1047,0,1047,83,1130,1130,0,0
643,2019-01-03,1075,0,1075,85,1160,1160,0,0
644,2019-01-03,612,0,612,48,660,660,0,0
645,2019-01-03,1426,0,1426,114,1540,1540,0,0
646,2019-01-03,936,0,936,74,1010,1010,0,0
647,2019-01-03,1102,0,1102,88,1190,1190,0,0
648,2019-01-03,3139,0,3139,251,3390,3390,0,0
649,2019-01-03,2065,0,2065,165,2230,2230,0,0
650,2019-01-03,834,0,834,66,900,900,0,0
651,2019-01-03,751,0,751,59,810,810,0,0
652,2019-01-03,1018,0,1018,72,1090,1090,0,0
653,2019-01-03,380,0,380,30,410,410,0,0
654,2019-01-03,703,0,703,47,750,750,0,0
655,2019-01-03,380,0,380,30,410,410,0,0
656,2019-01-03,814,0,814,56,870,870,0,0
657,2019-01-03,852,0,852,68,920,920,0,0
658,2019-01-03,436,0,436,34,470,470,0,0
659,2019-01-03,547,0,547,43,590,590,0,0
660,2019-01-03,334,0,334,26,360,360,0,0
661,2019-01-03,501,0,501,39,540,540,0,0
662,2019-01-03,510,0,510,40,550,550,0,0
663,2019-01-03,1278,0,1278,102,1380,1380,0,0
664,2019-01-03,167,0,167,13,180,180,0,0
665,2019-01-03,417,0,417,33,450,450,0,0
666,2019-01-03,538,0,538,42,580,580,0,0
667,2019-01-03,1019,0,1019,81,1100,1100,0,0
668,2019-01-03,584,0,584,46,630,630,0,0
669,2019-01-03,797,0,797,63,860,860,0,0
670,2019-01-03,908,0,908,72,980,980,0,0
671,2019-01-03,639,0,639,51,690,690,0,0
672,2019-01-03,269,0,269,21,290,290,0,0
673,2019-01-03,241,0,241,19,260,260,0,0
674,2019-01-03,880,0,880,70,950,950,0,0
675,2019-01-03,102,0,102,8,110,110,0,0
676,2019-01-03,232,0,232,18,250,250,0,0
677,2019-01-03,908,0,908,72,980,980,0,0
678,2019-01-03,3213,0,3213,257,3470,3470,0,0
679,2019-01-03,491,0,491,39,530,530,0,0
680,2019-01-03,1315,0,1315,105,1420,1420,0,0
681,2019-01-03,499,-106,393,31,424,424,0,0
682,2019-01-03,1028,0,1028,82,1110,1110,0,0
683,2019-01-03,1306,0,1306,104,1410,1410,0,0
684,2019-01-03,649,0,649,51,700,700,0,0
685,2019-01-03,343,0,343,27,370,370,0,0
686,2019-01-03,371,0,371,29,400,400,0,0
687,2019-01-03,2065,0,2065,165,2230,2230,0,0
688,2019-01-03,444,0,444,26,470,470,0,0
689,2019-01-03,908,0,908,72,980,980,0,0
690,2019-01-03,1148,0,1148,82,1230,1230,0,0
691,2019-01-03,510,0,510,40,550,550,0,0
692,2019-01-03,621,0,621,49,670,670,0,0
693,2019-01-03,667,0,667,53,720,720,0,0
694,2019-01-03,1251,0,1251,99,1350,1350,0,0
695,2019-01-03,908,0,908,72,980,980,0,0
696,2019-01-03,121,0,121,9,130,130,0,0
697,2019-01-03,2723,0,2723,217,2940,2940,0,0
698,2019-01-03,713,0,713,57,770,770,0,0
699,2019-01-03,491,0,491,39,530,530,0,0
700,2019-01-03,602,0,602,48,650,650,0,0
701,2019-01-03,1232,0,1232,98,1330,1330,0,0
702,2019-01-03,454,0,454,36,490,490,0,0
703,2019-01-03,1009,0,1009,71,1080,0,1080,0
704,2019-01-03,1963,0,1963,157,2120,2120,0,0
705,2019-01-03,325,0,325,25,350,350,0,0
706,2019-01-03,908,0,908,72,980,980,0,0
707,2019-01-03,852,0,852,68,920,920,0,0
708,2019-01-03,612,0,612,48,660,660,0,0
709,2019-01-03,936,0,936,74,1010,1010,0,0
710,2019-01-03,908,0,908,72,980,980,0,0
711,2019-01-03,908,0,908,72,980,980,0,0
712,2019-01-03,286,0,286,14,300,300,0,0
713,2019-01-03,454,0,454,36,490,490,0,0
714,2019-01-03,1288,0,1288,102,1390,0,1390,0
715,2019-01-03,704,0,704,56,760,760,0,0
716,2019-01-03,426,0,426,34,460,460,0,0
717,2019-01-03,1815,0,1815,145,1960,1960,0,0
718,2019-01-03,667,0,667,53,720,720,0,0
719,2019-01-03,538,0,538,42,580,580,0,0
720,2019-01-03,389,0,389,31,420,420,0,0
721,2019-01-03,3630,0,3630,290,3920,3920,0,0
722,2019-01-03,325,0,325,25,350,350,0,0
723,2019-01-03,649,0,649,51,700,700,0,0
724,2019-01-03,2482,0,2482,198,2680,2680,0,0
725,2019-01-03,1815,0,1815,145,1960,1960,0,0
726,2019-01-03,399,0,399,31,430,430,0,0
727,2019-01-03,723,0,723,57,780,780,0,0
728,2019-01-03,1778,0,1778,142,1920,1920,0,0
729,2019-01-03,208,0,208,16,224,224,0,0
730,2019-01-03,-259,0,-259,-21,-280,-280,0,0
731,2019-01-03,556,0,556,44,600,600,0,0
732,2019-01-03,741,0,741,59,800,800,0,0
733,2019-01-03,352,0,352,28,380,380,0,0
734,2019-01-03,630,0,630,50,680,680,0,0
735,2019-01-03,2278,0,2278,182,2460,2460,0,0
736,2019-01-03,-2649,0,-2649,-211,-2860,-2860,0,0
737,2019-01-03,862,0,862,68,930,930,0,0
738,2019-01-03,186,0,186,14,200,200,0,0
739,2019-01-03,3352,0,3352,268,3620,3620,0,0
740,2019-01-03,556,0,556,44,600,600,0,0
741,2019-01-03,1686,0,1686,134,1820,1820,0,0
742,2019-01-03,362,0,362,28,390,390,0,0
743,2019-01-03,204,0,204,16,220,220,0,0
744,2019-01-03,760,0,760,60,820,820,0,0
745,2019-01-03,899,0,899,71,970,970,0,0
746,2019-01-03,269,0,269,21,290,290,0,0
747,2019-01-03,445,0,445,35,480,480,0,0
748,2019-01-03,1250,0,1250,100,1350,1350,0,0
749,2019-01-03,510,0,510,40,550,550,0,0
750,2019-01-03,3149,0,3149,251,3400,0,3400,0
751,2019-01-03,1575,0,1575,125,1700,1700,0,0
752,2019-01-03,501,0,501,39,540,540,0,0
753,2019-01-03,1575,0,1575,125,1700,1700,0,0
754,2019-01-03,1575,0,1575,125,1700,1700,0,0
755,2019-01-03,113,-24,89,7,96,96,0,0
756,2019-01-03,167,0,167,13,180,180,0,0
757,2019-01-03,1223,0,1223,97,1320,1320,0,0
758,2019-01-03,695,0,695,55,750,750,0,0
759,2019-01-03,1649,0,1649,131,1780,1780,0,0
760,2019-01-03,538,0,538,42,580,580,0,0
761,2019-01-03,167,0,167,13,180,180,0,0
762,2019-01-03,1213,0,1213,97,1310,1310,0,0
763,2019-01-03,704,0,704,56,760,760,0,0
764,2019-01-03,501,0,501,39,540,540,0,0
765,2019-01-03,269,0,269,21,290,290,0,0
766,2019-01-03,732,0,732,58,790,790,0,0
767,2019-01-03,732,0,732,58,790,790,0,0
768,2019-01-03,695,0,695,55,750,750,0,0
769,2019-01-03,908,0,908,72,980,980,0,0
770,2019-01-03,695,0,695,55,750,750,0,0
771,2019-01-03,630,0,630,50,680,680,0,0
772,2019-01-03,463,0,463,37,500,500,0,0
773,2019-01-03,825,0,825,65,890,890,0,0
774,2019-01-03,1686,0,1686,134,1820,1820,0,0
775,2019-01-03,723,0,723,57,780,780,0,0
776,2019-01-03,751,0,751,59,810,810,0,0
777,2019-01-03,556,0,556,44,600,600,0,0
778,2019-01-03,667,0,667,53,720,720,0,0
779,2019-01-03,2167,0,2167,173,2340,2340,0,0
780,2019-01-03,602,0,602,48,650,650,0,0
781,2019-01-03,501,0,501,39,540,540,0,0
782,2019-01-03,399,0,399,31,430,430,0,0
783,2019-01-03,1417,0,1417,113,1530,1530,0,0
784,2019-01-03,334,0,334,26,360,360,0,0
785,2019-01-03,973,0,973,77,1050,1050,0,0
786,2019-01-03,695,0,695,55,750,750,0,0
787,2019-01-03,102,0,102,8,110,110,0,0
788,2019-01-03,2251,0,2251,179,2430,0,2430,0
789,2019-01-03,2649,0,2649,211,2860,2860,0,0
790,2019-01-03,1547,0,1547,123,1670,1670,0,0
791,2019-01-03,519,0,519,41,560,560,0,0
792,2019-01-03,862,0,862,68,930,930,0,0
793,2019-01-03,602,0,602,48,650,650,0,0
794,2019-01-03,630,0,630,50,680,680,0,0
795,2019-01-03,584,0,584,46,630,630,0,0
796,2019-01-03,936,0,936,74,1010,1010,0,0
797,2019-01-03,704,0,704,56,760,760,0,0
798,2019-01-03,1334,0,1334,106,1440,1440,0,0
799,2019-01-03,1204,0,1204,96,1300,1300,0,0
800,2019-01-03,611,0,611,39,650,650,0,0
801,2019-01-03,2723,0,2723,217,2940,2940,0,0
802,2019-01-03,139,0,139,11,150,150,0,0
803,2019-01-03,1815,0,1815,145,1960,1960,0,0
804,2019-01-03,445,0,445,35,480,480,0,0
805,2019-01-03,786,0,786,54,840,840,0,0
806,2019-01-03,371,0,371,29,400,400,0,0
807,2019-01-03,843,0,843,67,910,910,0,0
808,2019-01-03,501,0,501,39,540,540,0,0
809,2019-01-03,749,0,749,51,800,800,0,0
810,2019-01-03,704,0,704,56,760,760,0,0
811,2019-01-03,899,0,899,71,970,970,0,0
812,2019-01-03,1982,0,1982,158,2140,2140,0,0
813,2019-01-03,417,0,417,33,450,450,0,0
814,2019-01-03,658,0,658,52,710,710,0,0
815,2019-01-03,778,0,778,62,840,840,0,0
816,2019-01-03,741,0,741,59,800,800,0,0
817,2019-01-03,112,0,112,8,120,120,0,0
818,2019-01-03,519,0,519,41,560,560,0,0
819,2019-01-03,2149,0,2149,171,2320,2320,0,0
820,2019-01-03,2723,0,2723,217,2940,2940,0,0
821,2019-01-03,963,0,963,77,1040,1040,0,0
822,2019-01-03,1139,0,1139,91,1230,1230,0,0
823,2019-01-03,315,0,315,25,340,340,0,0
824,2019-01-03,278,0,278,22,300,300,0,0
825,2019-01-03,667,0,667,53,720,720,0,0
826,2019-01-03,825,0,825,65,890,890,0,0
827,2019-01-03,908,0,908,72,980,980,0,0
828,2019-01-03,908,0,908,72,980,980,0,0
829,2019-01-03,908,0,908,72,980,980,0,0
830,2019-01-03,908,0,908,72,980,980,0,0
831,2019-01-03,908,0,908,72,980,980,0,0
832,2019-01-03,1241,0,1241,99,1340,1340,0,0
833,2019-01-03,278,0,278,22,300,300,0,0
834,2019-01-03,121,0,121,9,130,130,0,0
835,2019-01-03,3676,0,3676,294,3970,3970,0,0
836,2019-01-03,1815,0,1815,145,1960,1960,0,0
837,2019-01-03,139,0,139,11,150,150,0,0
838,2019-01-03,695,0,695,55,750,750,0,0
839,2019-01-03,788,0,788,62,850,850,0,0
840,2019-01-03,593,0,593,47,640,640,0,0
841,2019-01-03,269,0,269,21,290,290,0,0
842,2019-01-03,695,0,695,55,750,750,0,0
843,2019-01-03,1852,0,1852,148,2000,2000,0,0
844,2019-01-03,288,0,288,22,310,310,0,0
845,2019-01-03,408,0,408,32,440,440,0,0
846,2019-01-03,1371,0,1371,109,1480,1480,0,0
847,2019-01-03,917,0,917,73,990,990,0,0
848,2019-01-03,1232,0,1232,98,1330,1330,0,0
849,2019-01-03,788,0,788,62,850,850,0,0
850,2019-01-03,788,0,788,62,850,850,0,0
851,2019-01-03,1075,0,1075,85,1160,1160,0,0
852,2019-01-03,417,0,417,33,450,450,0,0
853,2019-01-03,593,0,593,47,640,0,640,0
854,2019-01-03,862,0,862,68,930,930,0,0
855,2019-01-03,1675,0,1675,125,1800,1800,0,0
856,2019-01-03,1213,0,1213,97,1310,1310,0,0
857,2019-01-03,786,0,786,54,840,840,0,0
858,2019-01-03,1732,0,1732,138,1870,1870,0,0
859,2019-01-03,408,0,408,32,440,440,0,0
860,2019-01-03,806,0,806,64,870,870,0,0
861,2019-01-03,306,0,306,24,330,330,0,0
862,2019-01-03,1260,0,1260,100,1360,1360,0,0
863,2019-01-03,1436,0,1436,114,1550,1550,0,0
864,2019-01-03,195,0,195,15,210,210,0,0
865,2019-01-03,1278,0,1278,102,1380,1380,0,0
866,2019-01-03,778,0,778,62,840,840,0,0
867,2019-01-03,658,0,658,52,710,710,0,0
868,2019-01-03,371,0,371,29,400,400,0,0
869,2019-01-03,269,0,269,21,290,290,0,0
870,2019-01-03,741,0,741,59,800,800,0,0
871,2019-01-03,751,0,751,59,810,810,0,0
872,2019-01-03,751,0,751,59,810,810,0,0
873,2019-01-04,1166,0,1166,84,1250,1250,0,0
874,2019-01-04,1084,0,1084,86,1170,1170,0,0
875,2019-01-04,2963,0,2963,237,3200,3200,0,0
876,2019-01-04,362,0,362,28,390,390,0,0
877,2019-01-04,843,0,843,67,910,910,0,0
878,2019-01-04,1815,0,1815,145,1960,1960,0,0
879,2019-01-04,1093,0,1093,87,1180,1180,0,0
880,2019-01-04,1815,0,1815,145,1960,1960,0,0
881,2019-01-04,547,0,547,43,590,590,0,0
882,2019-01-04,908,0,908,72,980,980,0,0
883,2019-01-04,2917,0,2917,233,3150,3150,0,0
884,2019-01-04,908,0,908,72,980,980,0,0
885,2019-01-04,575,0,575,45,620,620,0,0
886,2019-01-04,769,0,769,61,830,830,0,0
887,2019-01-04,473,0,473,37,510,510,0,0
888,2019-01-04,1602,0,1602,128,1730,1730,0,0
889,2019-01-04,371,0,371,29,400,400,0,0
890,2019-01-04,751,0,751,59,810,810,0,0
891,2019-01-04,538,0,538,42,580,580,0,0
892,2019-01-04,167,0,167,13,180,180,0,0
893,2019-01-04,1815,0,1815,145,1960,1960,0,0
894,2019-01-04,426,0,426,34,460,460,0,0
895,2019-01-04,510,0,510,40,550,550,0,0
896,2019-01-04,1277,0,1277,93,1370,1370,0,0
897,2019-01-04,592,0,592,38,630,630,0,0
898,2019-01-04,408,0,408,32,440,440,0,0
899,2019-01-04,1093,0,1093,87,1180,1180,0,0
900,2019-01-04,1815,0,1815,145,1960,1960,0,0
901,2019-01-04,1852,0,1852,148,2000,2000,0,0
902,2019-01-04,1380,0,1380,110,1490,0,1490,0
903,2019-01-04,1056,0,1056,84,1140,1140,0,0
904,2019-01-04,2288,0,2288,182,2470,2470,0,0
905,2019-01-04,1556,0,1556,124,1680,1680,0,0
906,2019-01-04,1556,0,1556,124,1680,1680,0,0
907,2019-01-04,667,0,667,53,720,720,0,0
908,2019-01-04,463,0,463,37,500,500,0,0
909,2019-01-04,1315,0,1315,105,1420,1420,0,0
910,2019-01-04,1575,0,1575,125,1700,1700,0,0
911,2019-01-04,297,0,297,23,320,320,0,0
912,2019-01-04,1209,0,1209,96,1305,1305,0,0
913,2019-01-04,380,0,380,30,410,410,0,0
914,2019-01-04,501,0,501,39,540,540,0,0
915,2019-01-04,1815,0,1815,145,1960,1960,0,0
916,2019-01-04,908,0,908,72,980,980,0,0
917,2019-01-04,908,0,908,72,980,980,0,0
918,2019-01-04,1556,0,1556,124,1680,1680,0,0
919,2019-01-04,510,0,510,40,550,550,0,0
920,2019-01-04,1815,0,1815,145,1960,1960,0,0
921,2019-01-04,1019,0,1019,81,1100,1100,0,0
922,2019-01-04,288,0,288,22,310,310,0,0
923,2019-01-04,278,0,278,22,300,300,0,0
924,2019-01-04,704,0,704,56,760,760,0,0
925,2019-01-04,371,0,371,29,400,400,0,0
926,2019-01-04,908,0,908,72,980,980,0,0
927,2019-01-04,102,0,102,8,110,110,0,0
928,2019-01-04,1815,0,1815,145,1960,1960,0,0
929,2019-01-04,565,0,565,45,610,610,0,0
930,2019-01-04,1084,0,1084,86,1170,1170,0,0
931,2019-01-04,388,0,388,22,410,410,0,0
932,2019-01-04,1222,0,1222,88,1310,1310,0,0
933,2019-01-04,417,0,417,33,450,450,0,0
934,2019-01-04,389,0,389,31,420,420,0,0
935,2019-01-04,1815,0,1815,145,1960,1960,0,0
936,2019-01-04,1815,0,1815,145,1960,1960,0,0
937,2019-01-04,1815,0,1815,145,1960,1960,0,0
938,2019-01-04,2723,0,2723,217,2940,2940,0,0
939,2019-01-04,315,0,315,25,340,340,0,0
940,2019-01-04,616,0,616,49,665,665,0,0
941,2019-01-04,260,0,260,20,280,280,0,0
942,2019-01-04,269,0,269,21,290,290,0,0
943,2019-01-04,1815,0,1815,145,1960,1960,0,0
944,2019-01-04,982,0,982,78,1060,0,1060,0
945,2019-01-04,399,0,399,31,430,430,0,0
946,2019-01-04,491,0,491,39,530,530,0,0
947,2019-01-04,695,0,695,55,750,750,0,0
948,2019-01-04,695,0,695,55,750,750,0,0
949,2019-01-04,834,0,834,66,900,900,0,0
950,2019-01-04,528,0,528,42,570,570,0,0
951,2019-01-04,538,0,538,42,580,0,580,0
952,2019-01-04,204,0,204,16,220,220,0,0
953,2019-01-04,1635,0,1635,130,1765,1765,0,0
954,2019-01-04,269,0,269,21,290,290,0,0
955,2019-01-04,510,0,510,40,550,550,0,0
956,2019-01-04,1102,0,1102,88,1190,1190,0,0
957,2019-01-04,834,0,834,66,900,0,900,0
958,2019-01-04,1843,0,1843,147,1990,1990,0,0
959,2019-01-04,2417,0,2417,193,2610,0,2610,0
960,2019-01-04,973,0,973,77,1050,1050,0,0
961,2019-01-04,473,0,473,37,510,510,0,0
962,2019-01-04,251,0,251,19,270,270,0,0
963,2019-01-04,834,0,834,66,900,900,0,0
964,2019-01-04,751,0,751,59,810,810,0,0
965,2019-01-04,269,0,269,21,290,290,0,0
966,2019-01-04,627,0,627,23,650,650,0,0
967,2019-01-04,1445,0,1445,115,1560,1560,0,0
968,2019-01-04,1768,0,1768,132,1900,1900,0,0
969,2019-01-04,463,0,463,37,500,500,0,0
970,2019-01-04,362,0,362,28,390,390,0,0
971,2019-01-04,834,0,834,66,900,0,900,0
972,2019-01-04,1269,0,1269,101,1370,1370,0,0
973,2019-01-04,260,0,260,20,280,280,0,0
974,2019-01-04,954,0,954,76,1030,1030,0,0
975,2019-01-04,399,0,399,31,430,430,0,0
976,2019-01-04,1212,0,1212,88,1300,1300,0,0
977,2019-01-04,371,0,371,29,400,400,0,0
978,2019-01-04,1797,0,1797,143,1940,1940,0,0
979,2019-01-04,2073,0,2073,157,2230,2230,0,0
980,2019-01-04,658,0,658,52,710,710,0,0
981,2019-01-04,399,0,399,31,430,430,0,0
982,2019-01-04,621,0,621,49,670,670,0,0
983,2019-01-04,121,0,121,9,130,130,0,0
984,2019-01-04,306,0,306,24,330,330,0,0
985,2019-01-04,408,0,408,32,440,440,0,0
986,2019-01-04,306,0,306,24,330,330,0,0
987,2019-01-04,1621,0,1621,129,1750,1750,0,0
988,2019-01-04,1871,0,1871,149,2020,2020,0,0
989,2019-01-04,306,0,306,24,330,330,0,0
990,2019-01-04,1584,0,1584,126,1710,1710,0,0
991,2019-01-04,510,0,510,40,550,550,0,0
992,2019-01-04,917,0,917,73,990,990,0,0
993,2019-01-04,1352,0,1352,108,1460,1460,0,0
994,2019-01-04,371,0,371,29,400,400,0,0
995,2019-01-04,102,0,102,8,110,110,0,0
996,2019-01-04,473,0,473,37,510,510,0,0
997,2019-01-04,491,0,491,39,530,530,0,0
998,2019-01-04,260,0,260,20,280,280,0,0
999,2019-01-04,1880,0,1880,150,2030,2030,0,0
1000,2019-01-04,334,0,334,26,360,360,0,0
1001,2019-01-04,741,0,741,59,800,800,0,0
1002,2019-01-04,1075,0,1075,85,1160,1160,0,0
1003,2019-01-04,195,0,195,15,210,210,0,0
1004,2019-01-04,334,0,334,26,360,360,0,0
1005,2019-01-04,362,0,362,28,390,390,0,0
1006,2019-01-04,1056,0,1056,84,1140,1140,0,0
1007,2019-01-04,112,0,112,8,120,120,0,0
1008,2019-01-04,-389,0,-389,-31,-420,0,-420,0
1009,2019-01-04,1575,0,1575,125,1700,1700,0,0
1010,2019-01-04,2362,0,2362,188,2550,2550,0,0
1011,2019-01-04,-2362,0,-2362,-188,-2550,-2550,0,0
1012,2019-01-04,1575,0,1575,125,1700,1700,0,0
1013,2019-01-04,1575,0,1575,125,1700,0,1700,0
1014,2019-01-04,362,0,362,28,390,390,0,0
1015,2019-01-04,788,0,788,62,850,850,0,0
1016,2019-01-04,2093,0,2093,167,2260,2260,0,0
1017,2019-01-04,1778,0,1778,142,1920,1920,0,0
1018,2019-01-04,436,0,436,34,470,470,0,0
1019,2019-01-04,5371,0,5371,429,5800,5800,0,0
1020,2019-01-04,389,0,389,31,420,0,420,0
1021,2019-01-04,760,0,760,60,820,820,0,0
1022,2019-01-04,723,0,723,57,780,780,0,0
1023,2019-01-04,741,0,741,59,800,800,0,0
1024,2019-01-04,815,0,815,65,880,880,0,0
1025,2019-01-04,686,0,686,54,740,740,0,0
1026,2019-01-04,741,0,741,59,800,800,0,0
1027,2019-01-04,232,0,232,18,250,250,0,0
1028,2019-01-04,639,0,639,51,690,690,0,0
1029,2019-01-04,1362,0,1362,108,1470,0,1470,0
1030,2019-01-04,806,0,806,64,870,870,0,0
1031,2019-01-04,1343,0,1343,107,1450,1450,0,0
1032,2019-01-04,1232,0,1232,98,1330,1330,0,0
1033,2019-01-04,1325,0,1325,105,1430,1430,0,0
1034,2019-01-04,741,0,741,59,800,800,0,0
1035,2019-01-04,232,0,232,18,250,250,0,0
1036,2019-01-04,1112,0,1112,88,1200,1200,0,0
1037,2019-01-04,612,0,612,48,660,660,0,0
1038,2019-01-04,269,0,269,21,290,0,290,0
1039,2019-01-04,1315,0,1315,105,1420,1420,0,0
1040,2019-01-04,102,0,102,8,110,110,0,0
1041,2019-01-04,278,0,278,22,300,300,0,0
1042,2019-01-04,491,0,491,39,530,530,0,0
1043,2019-01-04,538,0,538,42,580,580,0,0
1044,2019-01-04,1102,0,1102,88,1190,1190,0,0
1045,2019-01-04,649,0,649,51,700,700,0,0
1046,2019-01-04,1806,0,1806,144,1950,1950,0,0
1047,2019-01-04,926,0,926,74,1000,1000,0,0
1048,2019-01-04,797,0,797,63,860,860,0,0
1049,2019-01-04,278,0,278,22,300,300,0,0
1050,2019-01-04,195,0,195,15,210,210,0,0
1051,2019-01-04,2213,0,2213,177,2390,2390,0,0
1052,2019-01-04,751,0,751,59,810,810,0,0
1053,2019-01-04,723,0,723,57,780,780,0,0
1054,2019-01-04,362,0,362,28,390,390,0,0
1055,2019-01-04,269,0,269,21,290,290,0,0
1056,2019-01-04,2070,0,2070,165,2235,2235,0,0
1057,2019-01-04,788,0,788,62,850,850,0,0
1058,2019-01-04,1334,0,1334,106,1440,0,1440,0
1059,2019-01-04,825,0,825,65,890,890,0,0
1060,2019-01-04,588,-63,525,42,567,567,0,0
1061,2019-01-04,565,0,565,45,610,610,0,0
1062,2019-01-04,389,0,389,31,420,420,0,0
1063,2019-01-04,649,0,649,51,700,0,700,0
1064,2019-01-04,862,0,862,68,930,930,0,0
1065,2019-01-04,1038,0,1038,82,1120,1120,0,0
1066,2019-01-04,241,0,241,19,260,260,0,0
1067,2019-01-04,1575,0,1575,125,1700,1700,0,0
1068,2019-01-04,1047,0,1047,83,1130,1130,0,0
1069,2019-01-04,584,0,584,46,630,630,0,0
1070,2019-01-04,584,0,584,46,630,630,0,0
1071,2019-01-04,158,0,158,12,170,170,0,0
1072,2019-01-04,1815,0,1815,145,1960,1960,0,0
1073,2019-01-04,260,0,260,20,280,280,0,0
1074,2019-01-04,695,0,695,55,750,750,0,0
1075,2019-01-04,778,0,778,62,840,840,0,0
1076,2019-01-04,1815,0,1815,145,1960,1960,0,0
1077,2019-01-04,342,0,342,18,360,360,0,0
1078,2019-01-04,1436,0,1436,114,1550,1550,0,0
1079,2019-01-04,667,0,667,53,720,720,0,0
1080,2019-01-04,1194,0,1194,86,1280,1280,0,0
1081,2019-01-04,396,-84,312,24,336,336,0,0
1082,2019-01-04,612,0,612,48,660,660,0,0
1083,2019-01-04,1195,0,1195,95,1290,1290,0,0
1084,2019-01-04,667,0,667,53,720,720,0,0
1085,2019-01-04,612,0,612,48,660,660,0,0
1086,2019-01-04,778,0,778,62,840,840,0,0
1087,2019-01-04,1575,0,1575,125,1700,1700,0,0
1088,2019-01-04,1121,0,1121,89,1210,1210,0,0
1089,2019-01-04,649,0,649,51,700,700,0,0
1090,2019-01-04,1575,0,1575,125,1700,1700,0,0
1091,2019-01-04,-1575,0,-1575,-125,-1700,-1700,0,0
1092,2019-01-04,1612,0,1612,128,1740,1740,0,0
1093,2019-01-04,249,0,249,11,260,260,0,0
1094,2019-01-04,445,0,445,35,480,480,0,0
1095,2019-01-04,1575,0,1575,125,1700,1700,0,0
1096,2019-01-04,473,0,473,37,510,510,0,0
1097,2019-01-04,250,0,250,20,270,270,0,0
1098,2019-01-04,2362,0,2362,188,2550,0,2550,0
1099,2019-01-04,186,0,186,14,200,200,0,0
1100,2019-01-04,334,0,334,26,360,360,0,0
1101,2019-01-04,1778,0,1778,142,1920,1920,0,0
1102,2019-01-04,1880,0,1880,150,2030,2030,0,0
1103,2019-01-04,352,0,352,28,380,380,0,0
1104,2019-01-04,204,0,204,16,220,220,0,0
1105,2019-01-04,149,0,149,11,160,160,0,0
1106,2019-01-04,2712,0,2712,208,2920,2920,0,0
1107,2019-01-04,232,0,232,18,250,250,0,0
1108,2019-01-04,565,0,565,45,610,610,0,0
1109,2019-01-04,1575,0,1575,125,1700,1700,0,0
1110,2019-01-04,472,0,472,28,500,500,0,0
1111,2019-01-04,649,0,649,51,700,700,0,0
1112,2019-01-05,926,0,926,74,1000,1000,0,0
1113,2019-01-05,713,0,713,57,770,770,0,0
1114,2019-01-05,-1056,0,-1056,-84,-1140,-1140,0,0
1115,2019-01-05,1214,-258,956,76,1032,1032,0,0
1116,2019-01-05,797,0,797,63,860,860,0,0
1117,2019-01-05,2380,0,2380,190,2570,2570,0,0
1118,2019-01-05,732,0,732,58,790,790,0,0
1119,2019-01-05,686,0,686,54,740,740,0,0
1120,2019-01-05,917,0,917,73,990,990,0,0
1121,2019-01-05,862,0,862,68,930,930,0,0
1122,2019-01-05,408,0,408,32,440,440,0,0
1123,2019-01-05,1093,0,1093,87,1180,1180,0,0
1124,2019-01-05,945,0,945,75,1020,1020,0,0
1125,2019-01-05,1815,0,1815,145,1960,1960,0,0
1126,2019-01-05,343,0,343,27,370,370,0,0
1127,2019-01-05,1815,0,1815,145,1960,1960,0,0
1128,2019-01-05,908,0,908,72,980,980,0,0
1129,2019-01-05,908,0,908,72,980,980,0,0
1130,2019-01-05,704,0,704,56,760,760,0,0
1131,2019-01-05,908,0,908,72,980,980,0,0
1132,2019-01-05,1056,0,1056,84,1140,1140,0,0
1133,2019-01-05,908,0,908,72,980,980,0,0
1134,2019-01-05,417,0,417,33,450,450,0,0
1135,2019-01-05,343,0,343,27,370,370,0,0
1136,2019-01-05,1815,0,1815,145,1960,1960,0,0
1137,2019-01-05,1778,0,1778,142,1920,1920,0,0
1138,2019-01-05,1297,0,1297,103,1400,1400,0,0
1139,2019-01-05,1815,0,1815,145,1960,1960,0,0
1140,2019-01-05,676,0,676,54,730,730,0,0
1141,2019-01-05,751,0,751,59,810,810,0,0
1142,2019-01-05,223,0,223,17,240,240,0,0
1143,2019-01-05,982,0,982,78,1060,0,1060,0
1144,2019-01-05,2463,0,2463,197,2660,2660,0,0
1145,2019-01-05,1352,0,1352,108,1460,1460,0,0
1146,2019-01-05,1916,0,1916,144,2060,0,2060,0
1147,2019-01-05,232,0,232,18,250,250,0,0
1148,2019-01-05,1815,0,1815,145,1960,1960,0,0
1149,2019-01-05,306,0,306,24,330,330,0,0
1150,2019-01-05,416,0,416,24,440,440,0,0
1151,2019-01-05,1899,0,1899,151,2050,2050,0,0
1152,2019-01-05,1825,0,1825,145,1970,1970,0,0
1153,2019-01-05,1815,0,1815,145,1960,1960,0,0
1154,2019-01-05,862,0,862,68,930,930,0,0
1155,2019-01-05,908,0,908,72,980,980,0,0
1156,2019-01-05,908,0,908,72,980,980,0,0
1157,2019-01-05,1565,0,1565,125,1690,1690,0,0
1158,2019-01-05,213,0,213,17,230,230,0,0
1159,2019-01-05,2073,0,2073,157,2230,2230,0,0
1160,2019-01-05,232,0,232,18,250,250,0,0
1161,2019-01-05,806,0,806,64,870,870,0,0
1162,2019-01-05,1314,0,1314,96,1410,1410,0,0
1163,2019-01-05,362,0,362,28,390,390,0,0
1164,2019-01-05,908,0,908,72,980,980,0,0
1165,2019-01-05,306,0,306,24,330,330,0,0
1166,2019-01-05,741,0,741,59,800,0,800,0
1167,2019-01-05,278,0,278,22,300,300,0,0
1168,2019-01-05,1815,0,1815,145,1960,1960,0,0
1169,2019-01-05,575,0,575,45,620,620,0,0
1170,2019-01-05,1815,0,1815,145,1960,1960,0,0
1171,2019-01-05,1565,0,1565,125,1690,1690,0,0
1172,2019-01-05,149,0,149,11,160,160,0,0
1173,2019-01-05,2334,0,2334,186,2520,2520,0,0
1174,2019-01-05,362,0,362,28,390,390,0,0
1175,2019-01-05,1815,0,1815,145,1960,1960,0,0
1176,2019-01-05,1593,0,1593,127,1720,1720,0,0
1177,2019-01-05,385,0,385,30,415,415,0,0
1178,2019-01-05,1028,0,1028,82,1110,1110,0,0
1179,2019-01-05,1621,0,1621,129,1750,0,1750,0
1180,2019-01-05,306,0,306,24,330,330,0,0
1181,2019-01-05,232,0,232,18,250,250,0,0
1182,2019-01-05,538,0,538,42,580,580,0,0
1183,2019-01-05,973,0,973,77,1050,1050,0,0
1184,2019-01-05,1288,0,1288,102,1390,1390,0,0
1185,2019-01-05,377,-80,297,23,320,320,0,0
1186,2019-01-05,741,0,741,59,800,800,0,0
1187,2019-01-05,325,0,325,25,350,350,0,0
1188,2019-01-05,732,0,732,58,790,790,0,0
1189,2019-01-05,260,0,260,20,280,280,0,0
1190,2019-01-05,1010,0,1010,80,1090,1090,0,0
1191,2019-01-05,519,0,519,41,560,560,0,0
1192,2019-01-05,343,0,343,27,370,370,0,0
1193,2019-01-05,908,0,908,72,980,0,980,0
1194,2019-01-05,491,0,491,39,530,530,0,0
1195,2019-01-05,306,0,306,24,330,330,0,0
1196,2019-01-05,528,0,528,42,570,570,0,0
1197,2019-01-05,399,0,399,31,430,430,0,0
1198,2019-01-05,2102,0,2102,168,2270,2270,0,0
1199,2019-01-05,463,0,463,37,500,500,0,0
1200,2019-01-05,473,0,473,37,510,510,0,0
1201,2019-01-05,2445,0,2445,195,2640,0,2640,0
1202,2019-01-05,2491,0,2491,199,2690,2690,0,0
1203,2019-01-05,528,0,528,42,570,570,0,0
1204,2019-01-05,834,0,834,66,900,900,0,0
1205,2019-01-05,292,0,292,23,315,315,0,0
1206,2019-01-05,343,0,343,27,370,370,0,0
1207,2019-01-05,288,0,288,22,310,310,0,0
1208,2019-01-05,556,0,556,44,600,600,0,0
1209,2019-01-05,139,0,139,11,150,150,0,0
1210,2019-01-05,1195,0,1195,95,1290,1290,0,0
1211,2019-01-05,436,0,436,34,470,470,0,0
1212,2019-01-05,1830,-196,1634,130,1764,1764,0,0
1213,2019-01-05,1556,0,1556,124,1680,1680,0,0
1214,2019-01-05,1815,0,1815,145,1960,1960,0,0
1215,2019-01-05,0,0,0,0,-40,-40,0,0
1216,2019-01-05,1028,0,1028,82,1110,1110,0,0
1217,2019-01-05,862,0,862,68,930,930,0,0
1218,2019-01-05,584,0,584,46,630,630,0,0
1219,2019-01-05,371,0,371,29,400,400,0,0
1220,2019-01-05,1028,0,1028,82,1110,1110,0,0
1221,2019-01-05,232,0,232,18,250,250,0,0
1222,2019-01-05,1788,0,1788,142,1930,1930,0,0
1223,2019-01-05,982,0,982,78,1060,1060,0,0
1224,2019-01-05,315,0,315,25,340,340,0,0
1225,2019-01-05,417,0,417,33,450,450,0,0
1226,2019-01-05,538,0,538,42,580,580,0,0
1227,2019-01-05,463,0,463,37,500,500,0,0
1228,2019-01-05,528,0,528,42,570,570,0,0
1229,2019-01-05,649,0,649,51,700,700,0,0
1230,2019-01-05,260,0,260,20,280,280,0,0
1231,2019-01-05,945,0,945,75,1020,1020,0,0
1232,2019-01-05,1001,0,1001,79,1080,1080,0,0
1233,2019-01-05,834,0,834,66,900,900,0,0
1234,2019-01-05,2362,0,2362,188,2550,2550,0,0
1235,2019-01-05,2362,0,2362,188,2550,2550,0,0
1236,2019-01-05,1065,0,1065,85,1150,1150,0,0
1237,2019-01-05,1604,0,1604,128,1732,1732,0,0
1238,2019-01-05,1852,0,1852,148,2000,2000,0,0
1239,2019-01-05,1575,0,1575,125,1700,1700,0,0
1240,2019-01-05,2001,0,2001,159,2160,2160,0,0
1241,2019-01-05,1621,0,1621,129,1750,1750,0,0
1242,2019-01-05,676,0,676,54,730,730,0,0
1243,2019-01-05,1852,0,1852,148,2000,2000,0,0
1244,2019-01-05,2084,0,2084,166,2250,2250,0,0
1245,2019-01-05,491,0,491,39,530,530,0,0
1246,2019-01-05,723,0,723,57,780,780,0,0
1247,2019-01-05,741,0,741,59,800,800,0,0
1248,2019-01-05,501,0,501,39,540,540,0,0
1249,2019-01-05,139,0,139,11,150,150,0,0
1250,2019-01-05,769,0,769,61,830,830,0,0
1251,2019-01-05,538,0,538,42,580,580,0,0
1252,2019-01-05,510,0,510,40,550,550,0,0
1253,2019-01-05,501,0,501,39,540,540,0,0
1254,2019-01-05,445,0,445,35,480,480,0,0
1255,2019-01-05,260,0,260,20,280,280,0,0
1256,2019-01-05,686,0,686,54,740,740,0,0
1257,2019-01-05,584,0,584,46,630,630,0,0
1258,2019-01-05,510,0,510,40,550,550,0,0
1259,2019-01-05,417,0,417,33,450,450,0,0
1260,2019-01-05,565,0,565,45,610,610,0,0
1261,2019-01-05,269,0,269,21,290,290,0,0
1262,2019-01-05,260,0,260,20,280,280,0,0
1263,2019-01-05,380,0,380,30,410,410,0,0
1264,2019-01-05,436,0,436,34,470,470,0,0
1265,2019-01-05,519,0,519,41,560,560,0,0
1266,2019-01-05,676,0,676,54,730,730,0,0
1267,2019-01-05,408,0,408,32,440,440,0,0
1268,2019-01-05,315,0,315,25,340,340,0,0
1269,2019-01-05,417,0,417,33,450,450,0,0
1270,2019-01-05,288,0,288,22,310,310,0,0
1271,2019-01-05,463,0,463,37,500,500,0,0
1272,2019-01-05,575,0,575,45,620,620,0,0
1273,2019-01-05,389,0,389,31,420,420,0,0
1274,2019-01-05,371,0,371,29,400,400,0,0
1275,2019-01-05,491,0,491,39,530,530,0,0
1276,2019-01-05,806,0,806,64,870,870,0,0
1277,2019-01-05,639,0,639,51,690,690,0,0
1278,2019-01-05,1167,0,1167,93,1260,1260,0,0
1279,2019-01-05,249,0,249,11,260,260,0,0
1280,2019-01-05,620,0,620,40,660,660,0,0
1281,2019-01-05,555,0,555,35,590,590,0,0
1282,2019-01-05,556,0,556,44,600,600,0,0
1283,2019-01-05,584,0,584,46,630,630,0,0
1284,2019-01-05,788,0,788,62,850,850,0,0
1285,2019-01-05,1038,0,1038,82,1120,1120,0,0
1286,2019-01-05,852,0,852,68,920,920,0,0
1287,2019-01-05,436,0,436,34,470,470,0,0
1288,2019-01-05,1454,0,1454,116,1570,1570,0,0
1289,2019-01-05,417,0,417,33,450,450,0,0
1290,2019-01-05,973,0,973,77,1050,1050,0,0
1291,2019-01-05,843,0,843,67,910,910,0,0
1292,2019-01-05,306,0,306,24,330,330,0,0
1293,2019-01-05,1601,0,1601,119,1720,1720,0,0
1294,2019-01-05,473,0,473,37,510,510,0,0
1295,2019-01-05,241,0,241,19,260,260,0,0
1296,2019-01-05,1379,0,1379,101,1480,1480,0,0
1297,2019-01-05,1815,0,1815,145,1960,1960,0,0
1298,2019-01-05,1384,0,1384,66,1450,1450,0,0
1299,2019-01-05,500,0,500,40,540,540,0,0
1300,2019-01-05,417,0,417,33,450,450,0,0
1301,2019-01-05,1760,0,1760,140,1900,1900,0,0
1302,2019-01-05,1788,0,1788,142,1930,1930,0,0
1303,2019-01-05,3982,0,3982,318,4300,4300,0,0
1304,2019-01-05,371,0,371,29,400,400,0,0
1305,2019-01-05,1232,0,1232,98,1330,1330,0,0
1306,2019-01-05,1139,0,1139,91,1230,1230,0,0
1307,2019-01-05,1417,0,1417,113,1530,1530,0,0
1308,2019-01-05,695,0,695,55,750,750,0,0
1309,2019-01-05,2362,0,2362,188,2550,2550,0,0
1310,2019-01-05,649,0,649,51,700,700,0,0
1311,2019-01-05,1009,0,1009,71,1080,1080,0,0
1312,2019-01-05,1908,0,1908,152,2060,2060,0,0
1313,2019-01-05,584,0,584,46,630,630,0,0
1314,2019-01-05,1454,0,1454,116,1570,1570,0,0
1315,2019-01-05,334,0,334,26,360,360,0,0
1316,2019-01-05,371,0,371,29,400,400,0,0
1317,2019-01-05,788,0,788,62,850,850,0,0
1318,2019-01-05,371,0,371,29,400,400,0,0
1319,2019-01-05,361,0,361,19,380,380,0,0
1320,2019-01-05,278,0,278,22,300,300,0,0
1321,2019-01-05,788,0,788,62,850,850,0,0
1322,2019-01-05,269,0,269,21,290,290,0,0
1323,2019-01-05,371,0,371,29,400,400,0,0
1324,2019-01-05,788,0,788,62,850,850,0,0
1325,2019-01-05,889,0,889,71,960,960,0,0
1326,2019-01-05,1575,0,1575,125,1700,1700,0,0
1327,2019-01-05,575,0,575,45,620,620,0,0
1328,2019-01-05,1575,0,1575,125,1700,1700,0,0
1329,2019-01-05,704,0,704,56,760,760,0,0
1330,2019-01-05,713,0,713,57,770,770,0,0
1331,2019-01-06,908,0,908,72,980,980,0,0
1332,2019-01-06,908,0,908,72,980,980,0,0
1333,2019-01-06,908,0,908,72,980,980,0,0
1334,2019-01-06,908,0,908,72,980,980,0,0
1335,2019-01-06,908,0,908,72,980,980,0,0
1336,2019-01-06,908,0,908,72,980,980,0,0
1337,2019-01-06,908,0,908,72,980,980,0,0
1338,2019-01-06,463,0,463,37,500,500,0,0
1339,2019-01-06,408,0,408,32,440,440,0,0
1340,2019-01-06,306,0,306,24,330,330,0,0
1341,2019-01-06,426,0,426,34,460,460,0,0
1342,2019-01-06,408,0,408,32,440,440,0,0
1343,2019-01-06,306,0,306,24,330,330,0,0
1344,2019-01-06,482,0,482,38,520,520,0,0
1345,2019-01-06,371,0,371,29,400,400,0,0
1346,2019-01-06,1445,0,1445,115,1560,1560,0,0
1347,2019-01-06,389,0,389,31,420,420,0,0
1348,2019-01-06,463,0,463,37,500,500,0,0
1349,2019-01-06,908,0,908,72,980,980,0,0
1350,2019-01-06,963,0,963,77,1040,1040,0,0
1351,2019-01-06,626,-67,559,44,603,603,0,0
1352,2019-01-06,417,0,417,33,450,450,0,0
1353,2019-01-06,908,0,908,72,980,980,0,0
1354,2019-01-06,667,0,667,53,720,720,0,0
1355,2019-01-06,538,0,538,42,580,580,0,0
1356,2019-01-06,445,0,445,35,480,480,0,0
1357,2019-01-06,630,0,630,50,680,680,0,0
1358,2019-01-06,686,0,686,54,740,740,0,0
1359,2019-01-06,584,0,584,46,630,630,0,0
1360,2019-01-06,501,0,501,39,540,540,0,0
1361,2019-01-06,815,0,815,65,880,880,0,0
1362,2019-01-06,843,0,843,67,910,910,0,0
1363,2019-01-06,389,0,389,31,420,420,0,0
1364,2019-01-06,306,0,306,24,330,330,0,0
1365,2019-01-06,528,0,528,42,570,570,0,0
1366,2019-01-06,806,0,806,64,870,870,0,0
1367,2019-01-06,352,0,352,28,380,380,0,0
1368,2019-01-06,1352,0,1352,108,1460,1460,0,0
1369,2019-01-06,871,0,871,69,940,940,0,0
1370,2019-01-06,315,0,315,25,340,340,0,0
1371,2019-01-06,269,0,269,21,290,290,0,0
1372,2019-01-06,334,0,334,26,360,360,0,0
1373,2019-01-06,426,0,426,34,460,460,0,0
1374,2019-01-06,982,0,982,78,1060,1060,0,0
1375,2019-01-06,1815,0,1815,145,1960,1960,0,0
1376,2019-01-06,445,0,445,35,480,480,0,0
1377,2019-01-06,278,0,278,22,300,300,0,0
1378,2019-01-06,250,0,250,20,270,270,0,0
1379,2019-01-06,1547,0,1547,123,1670,1670,0,0
1380,2019-01-06,325,0,325,25,350,350,0,0
1381,2019-01-06,908,0,908,72,980,980,0,0
1382,2019-01-06,666,0,666,44,710,710,0,0
1383,2019-01-06,232,0,232,18,250,250,0,0
1384,2019-01-06,788,0,788,62,850,850,0,0
1385,2019-01-06,880,0,880,70,950,950,0,0
1386,2019-01-06,184,-39,145,11,156,156,0,0
1387,2019-01-06,704,0,704,56,760,760,0,0
1388,2019-01-06,399,0,399,31,430,430,0,0
1389,2019-01-06,584,0,584,46,630,630,0,0
1390,2019-01-06,2047,0,2047,163,2210,2210,0,0
1391,2019-01-06,982,0,982,78,1060,1060,0,0
1392,2019-01-06,982,0,982,78,1060,1060,0,0
1393,2019-01-06,630,0,630,50,680,680,0,0
1394,2019-01-06,389,0,389,31,420,420,0,0
1395,2019-01-06,2723,0,2723,217,2940,2940,0,0
1396,2019-01-06,306,0,306,24,330,330,0,0
1397,2019-01-06,741,0,741,59,800,800,0,0
1398,2019-01-06,713,0,713,57,770,770,0,0
1399,2019-01-06,501,0,501,39,540,540,0,0
1400,2019-01-06,325,0,325,25,350,350,0,0
1401,2019-01-06,565,0,565,45,610,610,0,0
1402,2019-01-06,2315,0,2315,185,2500,2500,0,0
1403,2019-01-06,110,0,110,0,110,110,0,0
1404,2019-01-06,1213,0,1213,97,1310,1310,0,0
1405,2019-01-06,102,0,102,8,110,110,0,0
1406,2019-01-06,2723,0,2723,217,2940,2940,0,0
1407,2019-01-06,908,0,908,72,980,980,0,0
1408,2019-01-06,371,0,371,29,400,400,0,0
1409,2019-01-06,908,0,908,72,980,980,0,0
1410,2019-01-06,753,-160,593,47,640,640,0,0
1411,2019-01-06,528,0,528,42,570,570,0,0
1412,2019-01-06,528,0,528,42,570,570,0,0
1413,2019-01-06,1139,0,1139,91,1230,1230,0,0
1414,2019-01-06,1157,0,1157,83,1240,1240,0,0
1415,2019-01-06,852,0,852,68,920,920,0,0
1416,2019-01-06,575,0,575,45,620,620,0,0
1417,2019-01-06,501,0,501,39,540,540,0,0
1418,2019-01-06,436,0,436,34,470,470,0,0
1419,2019-01-06,186,0,186,14,200,200,0,0
1420,2019-01-06,1176,0,1176,94,1270,1270,0,0
1421,2019-01-06,1204,0,1204,96,1300,1300,0,0
1422,2019-01-06,1823,0,1823,137,1960,1960,0,0
1423,2019-01-06,417,0,417,33,450,450,0,0
1424,2019-01-06,704,0,704,56,760,760,0,0
1425,2019-01-06,852,0,852,68,920,920,0,0
1426,2019-01-06,2547,0,2547,203,2750,2750,0,0
1427,2019-01-06,760,0,760,60,820,820,0,0
1428,2019-01-06,667,0,667,53,720,720,0,0
1429,2019-01-06,556,0,556,44,600,600,0,0
1430,2019-01-06,788,0,788,62,850,850,0,0
1431,2019-01-06,232,0,232,18,250,250,0,0
1432,2019-01-06,1778,0,1778,142,1920,1920,0,0
1433,2019-01-06,362,0,362,28,390,390,0,0
1434,2019-01-06,1408,0,1408,112,1520,1520,0,0
1435,2019-01-06,371,0,371,29,400,400,0,0
1436,2019-01-06,371,0,371,29,400,400,0,0
1437,2019-01-06,371,0,371,29,400,400,0,0
1438,2019-01-06,371,0,371,29,400,400,0,0
1439,2019-01-06,371,0,371,29,400,400,0,0
1440,2019-01-06,1065,0,1065,85,1150,1150,0,0
1441,2019-01-06,547,0,547,43,590,590,0,0
1442,2019-01-06,1232,0,1232,98,1330,1330,0,0
1443,2019-01-06,621,0,621,49,670,670,0,0
1444,2019-01-06,843,0,843,67,910,910,0,0
1445,2019-01-06,223,0,223,17,240,240,0,0
1446,2019-01-06,445,0,445,35,480,480,0,0
1447,2019-01-06,1556,0,1556,124,1680,1680,0,0
1448,2019-01-06,538,0,538,42,580,580,0,0
1449,2019-01-06,463,0,463,37,500,500,0,0
1450,2019-01-06,538,0,538,42,580,580,0,0
1451,2019-01-06,278,0,278,22,300,300,0,0
1452,2019-01-06,998,-212,786,62,848,0,848,0
1453,2019-01-06,3121,0,3121,249,3370,3370,0,0
1454,2019-01-06,463,0,463,37,500,500,0,0
1455,2019-01-06,1241,0,1241,99,1340,1340,0,0
1456,2019-01-06,260,0,260,20,280,280,0,0
1457,2019-01-06,1538,0,1538,122,1660,1660,0,0
1458,2019-01-06,926,0,926,74,1000,1000,0,0
1459,2019-01-06,630,0,630,50,680,680,0,0
1460,2019-01-06,260,0,260,20,280,280,0,0
1461,2019-01-06,269,0,269,21,290,290,0,0
1462,2019-01-06,380,0,380,30,410,410,0,0
1463,2019-01-06,695,0,695,55,750,750,0,0
1464,2019-01-06,843,0,843,67,910,910,0,0
1465,2019-01-06,667,0,667,53,720,720,0,0
1466,2019-01-06,629,0,629,41,670,670,0,0
1467,2019-01-06,445,0,445,35,480,480,0,0
1468,2019-01-06,519,0,519,41,560,560,0,0
1469,2019-01-06,908,0,908,72,980,980,0,0
1470,2019-01-06,908,0,908,72,980,980,0,0
1471,2019-01-06,908,0,908,72,980,980,0,0
1472,2019-01-06,788,0,788,62,850,850,0,0
1473,2019-01-06,334,0,334,26,360,360,0,0
1474,2019-01-06,862,0,862,68,930,930,0,0
1475,2019-01-06,241,0,241,19,260,260,0,0
1476,2019-01-06,649,0,649,51,700,700,0,0
1477,2019-01-06,501,0,501,39,540,540,0,0
1478,2019-01-06,491,0,491,39,530,530,0,0
1479,2019-01-06,1815,0,1815,145,1960,1960,0,0
1480,2019-01-06,110,0,110,0,110,110,0,0
1481,2019-01-06,389,0,389,31,420,420,0,0
1482,2019-01-06,760,0,760,60,820,820,0,0
1483,2019-01-06,538,0,538,42,580,580,0,0
1484,2019-01-06,908,0,908,72,980,980,0,0
1485,2019-01-06,1815,0,1815,145,1960,1960,0,0
1486,2019-01-06,362,0,362,28,390,390,0,0
1487,2019-01-06,1463,0,1463,117,1580,1580,0,0
1488,2019-01-06,538,0,538,42,580,580,0,0
1489,2019-01-06,325,0,325,25,350,350,0,0
1490,2019-01-06,649,0,649,51,700,700,0,0
1491,2019-01-06,1621,0,1621,129,1750,1750,0,0
1492,2019-01-06,1326,-142,1184,94,1278,1278,0,0
1493,2019-01-06,1268,0,1268,92,1360,1360,0,0
1494,2019-01-06,963,0,963,77,1040,1040,0,0
1495,2019-01-06,371,0,371,29,400,400,0,0
1496,2019-01-06,232,0,232,18,250,250,0,0
1497,2019-01-06,269,0,269,21,290,290,0,0
1498,2019-01-06,519,0,519,41,560,560,0,0
1499,2019-01-06,454,0,454,36,490,490,0,0
1500,2019-01-06,1482,0,1482,118,1600,1600,0,0
1501,2019-01-06,288,0,288,22,310,310,0,0
1502,2019-01-06,936,0,936,74,1010,1010,0,0
1503,2019-01-06,232,0,232,18,250,250,0,0
1504,2019-01-06,1047,-1000,47,3,50,50,0,0
1505,2019-01-06,751,0,751,59,810,810,0,0
1506,2019-01-06,584,0,584,46,630,630,0,0
1507,2019-01-06,1203,0,1203,87,1290,1290,0,0
1508,2019-01-06,510,0,510,40,550,550,0,0
1509,2019-01-06,1315,0,1315,105,1420,1420,0,0
1510,2019-01-06,723,0,723,57,780,780,0,0
1511,2019-01-06,838,0,838,67,905,905,0,0
1512,2019-01-07,1001,0,1001,79,1080,1080,0,0
1513,2019-01-07,1341,0,1341,89,1430,1430,0,0
1514,2019-01-07,667,0,667,53,720,720,0,0
1515,2019-01-07,2028,0,2028,162,2190,2190,0,0
1516,2019-01-07,963,0,963,77,1040,1040,0,0
1517,2019-01-07,908,0,908,72,980,980,0,0
1518,2019-01-07,852,0,852,68,920,920,0,0
1519,2019-01-07,926,0,926,74,1000,1000,0,0
1520,2019-01-07,473,0,473,37,510,510,0,0
1521,2019-01-07,565,0,565,45,610,610,0,0
1522,2019-01-07,584,0,584,46,630,630,0,0
1523,2019-01-07,1352,0,1352,108,1460,1460,0,0
1524,2019-01-07,825,0,825,65,890,890,0,0
1525,2019-01-07,1815,0,1815,145,1960,1960,0,0
1526,2019-01-07,944,0,944,66,1010,1010,0,0
1527,2019-01-07,408,0,408,32,440,440,0,0
1528,2019-01-07,334,0,334,26,360,360,0,0
1529,2019-01-07,1019,0,1019,81,1100,1100,0,0
1530,2019-01-07,769,0,769,61,830,830,0,0
1531,2019-01-07,251,0,251,19,270,270,0,0
1532,2019-01-07,1991,0,1991,159,2150,2150,0,0
1533,2019-01-07,667,0,667,53,720,720,0,0
1534,2019-01-07,283,-60,223,17,240,240,0,0
1535,2019-01-07,825,0,825,65,890,890,0,0
1536,2019-01-07,1102,0,1102,88,1190,1190,0,0
1537,2019-01-07,463,0,463,37,500,500,0,0
1538,2019-01-07,260,0,260,20,280,280,0,0
1539,2019-01-07,482,0,482,38,520,520,0,0
1540,2019-01-07,2866,-307,2559,204,2763,2763,0,0
1541,2019-01-07,1005,0,1005,80,1085,1085,0,0
1542,2019-01-07,352,0,352,28,380,380,0,0
1543,2019-01-07,343,0,343,27,370,370,0,0
1544,2019-01-07,732,0,732,58,790,790,0,0
1545,2019-01-07,926,0,926,74,1000,1000,0,0
1546,2019-01-07,463,0,463,37,500,500,0,0
1547,2019-01-07,445,0,445,35,480,480,0,0
1548,2019-01-07,823,0,823,57,880,880,0,0
1549,2019-01-07,926,0,926,74,1000,1000,0,0
1550,2019-01-07,380,0,380,30,410,410,0,0
1551,2019-01-07,686,0,686,54,740,740,0,0
1552,2019-01-07,362,0,362,28,390,390,0,0
1553,2019-01-07,362,0,362,28,390,390,0,0
1554,2019-01-07,556,0,556,44,600,600,0,0
1555,2019-01-07,575,0,575,45,620,620,0,0
1556,2019-01-07,908,0,908,72,980,980,0,0
1557,2019-01-07,389,0,389,31,420,420,0,0
1558,2019-01-07,1334,0,1334,106,1440,1440,0,0
1559,2019-01-07,1575,0,1575,125,1700,1700,0,0
1560,2019-01-07,1047,0,1047,83,1130,1130,0,0
1561,2019-01-07,454,0,454,36,490,490,0,0
1562,2019-01-07,788,0,788,62,850,850,0,0
1563,2019-01-07,232,0,232,18,250,250,0,0
1564,2019-01-07,1019,0,1019,81,1100,1100,0,0
1565,2019-01-07,278,0,278,22,300,300,0,0
1566,2019-01-07,1056,0,1056,84,1140,1140,0,0
1567,2019-01-07,612,0,612,48,660,660,0,0
1568,2019-01-07,452,-96,356,28,384,384,0,0
1569,2019-01-07,723,0,723,57,780,780,0,0
1570,2019-01-07,232,0,232,18,250,250,0,0
1571,2019-01-07,112,0,112,8,120,120,0,0
1572,2019-01-07,181,0,181,14,195,195,0,0
1573,2019-01-07,704,0,704,56,760,760,0,0
1574,2019-01-07,223,0,223,17,240,240,0,0
1575,2019-01-07,1130,0,1130,90,1220,1220,0,0
1576,2019-01-07,325,0,325,25,350,350,0,0
1577,2019-01-07,788,0,788,62,850,850,0,0
1578,2019-01-07,463,0,463,37,500,500,0,0
1579,2019-01-07,1408,0,1408,112,1520,1520,0,0
1580,2019-01-07,695,0,695,55,750,750,0,0
1581,2019-01-07,260,0,260,20,280,280,0,0
1582,2019-01-07,862,0,862,68,930,930,0,0
1583,2019-01-07,297,0,297,23,320,320,0,0
1584,2019-01-07,908,0,908,72,980,980,0,0
1585,2019-01-07,232,0,232,18,250,250,0,0
1586,2019-01-07,547,0,547,43,590,590,0,0
1587,2019-01-07,491,0,491,39,530,530,0,0
1588,2019-01-07,1102,0,1102,88,1190,1190,0,0
1589,2019-01-07,908,0,908,72,980,980,0,0
1590,2019-01-07,1815,0,1815,145,1960,1960,0,0
1591,2019-01-07,1232,0,1232,98,1330,1330,0,0
1592,2019-01-07,436,0,436,34,470,470,0,0
1593,2019-01-07,445,0,445,35,480,480,0,0
1594,2019-01-07,1769,0,1769,141,1910,1910,0,0
1595,2019-01-07,862,0,862,68,930,930,0,0
1596,2019-01-07,1084,0,1084,86,1170,1170,0,0
1597,2019-01-07,575,0,575,45,620,620,0,0
1598,2019-01-07,445,0,445,35,480,480,0,0
1599,2019-01-07,1260,0,1260,100,1360,1360,0,0
1600,2019-01-08,269,0,269,21,290,290,0,0
1601,2019-01-08,639,0,639,51,690,690,0,0
1602,2019-01-08,1565,0,1565,125,1690,1690,0,0
1603,2019-01-08,1306,0,1306,104,1410,1410,0,0
1604,2019-01-08,334,0,334,26,360,360,0,0
1605,2019-01-08,306,0,306,24,330,330,0,0
1606,2019-01-08,1278,0,1278,102,1380,1380,0,0
1607,2019-01-08,-463,0,-463,-37,-500,-500,0,0
1608,2019-01-08,389,0,389,31,420,420,0,0
1609,2019-01-08,139,0,139,11,150,150,0,0
1610,2019-01-08,288,0,288,22,310,310,0,0
1611,2019-01-08,232,0,232,18,250,250,0,0
1612,2019-01-08,110,0,110,0,110,110,0,0
1613,2019-01-08,463,0,463,37,500,500,0,0
1614,2019-01-08,167,0,167,13,180,180,0,0
1615,2019-01-08,481,0,481,29,510,510,0,0
1616,2019-01-08,167,0,167,13,180,180,0,0
1617,2019-01-08,963,0,963,77,1040,1040,0,0
1618,2019-01-08,704,0,704,56,760,760,0,0
1619,2019-01-08,538,0,538,42,580,580,0,0
1620,2019-01-08,1167,0,1167,93,1260,1260,0,0
1621,2019-01-08,102,0,102,8,110,110,0,0
1622,2019-01-08,546,0,546,34,580,580,0,0
1623,2019-01-08,408,0,408,32,440,440,0,0
1624,2019-01-08,1843,0,1843,147,1990,0,1990,0
1625,2019-01-08,-408,0,-408,-32,-440,-440,0,0
1626,2019-01-08,273,-58,215,17,232,232,0,0
1627,2019-01-08,213,0,213,17,230,230,0,0
1628,2019-01-08,269,0,269,21,290,290,0,0
1629,2019-01-08,167,0,167,13,180,180,0,0
1630,2019-01-08,408,0,408,32,440,440,0,0
1631,2019-01-09,1556,0,1556,124,1680,1680,0,0
1632,2019-01-09,399,0,399,31,430,430,0,0
1633,2019-01-09,399,0,399,31,430,430,0,0
1634,2019-01-09,926,0,926,74,1000,1000,0,0
1635,2019-01-09,565,0,565,45,610,610,0,0
1636,2019-01-09,436,0,436,34,470,470,0,0
1637,2019-01-09,343,0,343,27,370,370,0,0
1638,2019-01-09,908,0,908,72,980,980,0,0
1639,2019-01-09,445,0,445,35,480,480,0,0
1640,2019-01-09,343,0,343,27,370,370,0,0
1641,2019-01-09,1269,0,1269,101,1370,1370,0,0
1642,2019-01-09,908,0,908,72,980,980,0,0
1643,2019-01-09,908,0,908,72,980,980,0,0
1644,2019-01-09,149,0,149,11,160,160,0,0
1645,2019-01-09,908,0,908,72,980,980,0,0
1646,2019-01-09,149,0,149,11,160,160,0,0
1647,2019-01-09,2093,0,2093,167,2260,2260,0,0
1648,2019-01-09,1001,0,1001,79,1080,1080,0,0
1649,2019-01-09,399,0,399,31,430,430,0,0
1650,2019-01-09,278,0,278,22,300,300,0,0
1651,2019-01-09,936,0,936,74,1010,1010,0,0
1652,2019-01-09,389,0,389,31,420,420,0,0
1653,2019-01-09,463,0,463,37,500,500,0,0
1654,2019-01-09,473,0,473,37,510,510,0,0
1655,2019-01-09,639,0,639,51,690,690,0,0
1656,2019-01-09,288,0,288,22,310,310,0,0
1657,2019-01-09,538,0,538,42,580,580,0,0
1658,2019-01-09,454,0,454,36,490,490,0,0
1659,2019-01-09,149,0,149,11,160,160,0,0
1660,2019-01-09,1815,0,1815,145,1960,0,1960,0
1661,2019-01-09,556,0,556,44,600,600,0,0
1662,2019-01-09,880,0,880,70,950,950,0,0
1663,2019-01-09,917,0,917,73,990,990,0,0
1664,2019-01-09,501,0,501,39,540,540,0,0
1665,2019-01-09,1815,0,1815,145,1960,1960,0,0
1666,2019-01-09,676,0,676,54,730,730,0,0
1667,2019-01-09,149,0,149,11,160,160,0,0
1668,2019-01-09,936,0,936,74,1010,1010,0,0
1669,2019-01-09,528,0,528,42,570,570,0,0
1670,2019-01-09,751,0,751,59,810,810,0,0
1671,2019-01-09,426,0,426,34,460,460,0,0
1672,2019-01-09,751,0,751,59,810,810,0,0
1673,2019-01-09,1139,0,1139,91,1230,1230,0,0
1674,2019-01-09,1001,0,1001,79,1080,1080,0,0
1675,2019-01-09,538,0,538,42,580,580,0,0
1676,2019-01-09,788,0,788,62,850,850,0,0
1677,2019-01-09,213,0,213,17,230,230,0,0
1678,2019-01-09,426,0,426,34,460,460,0,0
1679,2019-01-09,815,0,815,65,880,880,0,0
1680,2019-01-09,-371,0,-371,-29,-400,-400,0,0
1681,2019-01-09,371,0,371,29,400,400,0,0
1682,2019-01-09,528,0,528,42,570,570,0,0
1683,2019-01-09,676,0,676,54,730,730,0,0
1684,2019-01-09,1362,0,1362,108,1470,1470,0,0
1685,2019-01-09,649,0,649,51,700,700,0,0
1686,2019-01-09,1575,0,1575,125,1700,1700,0,0
1687,2019-01-09,1139,0,1139,91,1230,1230,0,0
1688,2019-01-09,666,0,666,44,710,710,0,0
1689,2019-01-09,426,0,426,34,460,460,0,0
1690,2019-01-09,1889,0,1889,151,2040,2040,0,0
1691,2019-01-09,2463,0,2463,197,2660,2660,0,0
1692,2019-01-09,195,0,195,15,210,210,0,0
1693,2019-01-09,806,0,806,64,870,0,870,0
1694,2019-01-09,556,0,556,44,600,600,0,0
1695,2019-01-09,538,0,538,42,580,580,0,0
1696,2019-01-09,352,0,352,28,380,380,0,0
1697,2019-01-09,315,0,315,25,340,340,0,0
1698,2019-01-09,4334,0,4334,346,4680,4680,0,0
1699,2019-01-09,760,0,760,60,820,820,0,0
1700,2019-01-09,232,0,232,18,250,250,0,0
1701,2019-01-09,1389,0,1389,111,1500,1500,0,0
1702,2019-01-09,102,0,102,8,110,110,0,0
1703,2019-01-09,1120,0,1120,80,1200,0,1200,0
1704,2019-01-10,723,0,723,57,780,780,0,0
1705,2019-01-10,713,0,713,57,770,770,0,0
1706,2019-01-10,806,0,806,64,870,870,0,0
1707,2019-01-10,399,0,399,31,430,430,0,0
1708,2019-01-10,621,0,621,49,670,670,0,0
1709,2019-01-10,482,0,482,38,520,520,0,0
1710,2019-01-10,1815,0,1815,145,1960,1960,0,0
1711,2019-01-10,667,0,667,53,720,720,0,0
1712,2019-01-10,167,0,167,13,180,180,0,0
1713,2019-01-10,593,0,593,47,640,640,0,0
1714,2019-01-10,1056,0,1056,84,1140,1140,0,0
1715,2019-01-10,667,0,667,53,720,0,720,0
1716,2019-01-10,1815,0,1815,145,1960,1960,0,0
1717,2019-01-10,445,0,445,35,480,480,0,0
1718,2019-01-10,749,0,749,51,800,800,0,0
1719,2019-01-10,936,0,936,74,1010,1010,0,0
1720,2019-01-10,371,0,371,29,400,400,0,0
1721,2019-01-10,167,0,167,13,180,180,0,0
1722,2019-01-10,658,0,658,52,710,710,0,0
1723,2019-01-10,519,0,519,41,560,560,0,0
1724,2019-01-10,2723,0,2723,217,2940,2940,0,0
1725,2019-01-10,593,0,593,47,640,640,0,0
1726,2019-01-10,2723,0,2723,217,2940,2940,0,0
1727,2019-01-10,963,0,963,77,1040,1040,0,0
1728,2019-01-10,167,0,167,13,180,180,0,0
1729,2019-01-10,445,0,445,35,480,480,0,0
1730,2019-01-10,538,0,538,42,580,580,0,0
1731,2019-01-10,149,0,149,11,160,160,0,0
1732,2019-01-10,371,0,371,29,400,400,0,0
1733,2019-01-10,306,0,306,24,330,330,0,0
1734,2019-01-10,1010,0,1010,80,1090,1090,0,0
1735,2019-01-10,408,0,408,32,440,440,0,0
1736,2019-01-10,1999,0,1999,151,2150,2150,0,0
1737,2019-01-10,334,0,334,26,360,360,0,0
1738,2019-01-10,325,0,325,25,350,350,0,0
1739,2019-01-10,973,0,973,77,1050,1050,0,0
1740,2019-01-10,444,0,444,26,470,470,0,0
1741,2019-01-10,630,0,630,50,680,680,0,0
1742,2019-01-10,973,0,973,77,1050,1050,0,0
1743,2019-01-10,431,0,431,34,465,465,0,0
1744,2019-01-10,278,0,278,22,300,300,0,0
1745,2019-01-10,945,0,945,75,1020,1020,0,0
1746,2019-01-10,343,0,343,27,370,370,0,0
1747,2019-01-10,1167,0,1167,93,1260,1260,0,0
1748,2019-01-10,723,0,723,57,780,780,0,0
1749,2019-01-10,1454,0,1454,116,1570,1570,0,0
1750,2019-01-10,639,0,639,51,690,690,0,0
1751,2019-01-10,306,0,306,24,330,330,0,0
1752,2019-01-10,528,0,528,42,570,570,0,0
1753,2019-01-10,407,0,407,23,430,430,0,0
1754,2019-01-10,501,0,501,39,540,540,0,0
1755,2019-01-10,1737,0,1737,138,1875,1875,0,0
1756,2019-01-10,362,0,362,28,390,390,0,0
1757,2019-01-10,722,0,722,48,770,770,0,0
1758,2019-01-10,760,0,760,60,820,820,0,0
1759,2019-01-10,1815,0,1815,145,1960,1960,0,0
1760,2019-01-10,334,0,334,26,360,360,0,0
1761,2019-01-10,445,0,445,35,480,480,0,0
1762,2019-01-10,908,0,908,72,980,980,0,0
1763,2019-01-10,788,0,788,62,850,850,0,0
1764,2019-01-10,1575,0,1575,125,1700,1700,0,0
1765,2019-01-10,1575,0,1575,125,1700,1700,0,0
1766,2019-01-10,1454,0,1454,116,1570,1570,0,0
1767,2019-01-10,806,0,806,64,870,870,0,0
1768,2019-01-10,575,0,575,45,620,620,0,0
1769,2019-01-10,788,0,788,62,850,850,0,0
1770,2019-01-10,241,0,241,19,260,260,0,0
1771,2019-01-10,416,0,416,24,440,440,0,0
1772,2019-01-10,945,0,945,75,1020,1020,0,0
1773,2019-01-10,325,0,325,25,350,350,0,0
1774,2019-01-10,723,0,723,57,780,780,0,0
1775,2019-01-10,825,0,825,65,890,890,0,0
1776,2019-01-10,357,0,357,28,385,385,0,0
1777,2019-01-10,806,0,806,64,870,870,0,0
1778,2019-01-10,269,0,269,21,290,290,0,0
1779,2019-01-10,139,0,139,11,150,150,0,0
1780,2019-01-10,1207,0,1207,96,1303,1303,0,0
1781,2019-01-10,435,0,435,25,460,460,0,0
1782,2019-01-10,519,0,519,41,560,560,0,0
1783,2019-01-10,315,0,315,25,340,340,0,0
1784,2019-01-10,797,0,797,63,860,860,0,0
1785,2019-01-10,399,0,399,31,430,430,0,0
1786,2019-01-10,676,0,676,54,730,0,730,0
1787,2019-01-10,741,0,741,59,800,800,0,0
1788,2019-01-10,954,0,954,76,1030,1030,0,0
1789,2019-01-10,445,0,445,35,480,480,0,0
1790,2019-01-10,1149,0,1149,91,1240,1240,0,0
1791,2019-01-10,686,0,686,54,740,740,0,0
1792,2019-01-10,751,0,751,59,810,810,0,0
1793,2019-01-10,649,0,649,51,700,700,0,0
1794,2019-01-10,565,0,565,45,610,610,0,0
1795,2019-01-10,862,0,862,68,930,930,0,0
1796,2019-01-10,1056,0,1056,84,1140,1140,0,0
1797,2019-01-10,2075,0,2075,165,2240,2240,0,0
1798,2019-01-10,908,0,908,72,980,980,0,0
1799,2019-01-10,288,0,288,22,310,310,0,0
1800,2019-01-10,908,0,908,72,980,980,0,0
1801,2019-01-10,897,-96,801,63,864,864,0,0
1802,2019-01-10,871,0,871,69,940,940,0,0
1803,2019-01-10,926,0,926,74,1000,1000,0,0
1804,2019-01-10,1102,0,1102,88,1190,1190,0,0
1805,2019-01-10,751,0,751,59,810,810,0,0
1806,2019-01-10,834,0,834,66,900,900,0,0
1807,2019-01-10,139,0,139,11,150,150,0,0
1808,2019-01-10,1343,0,1343,107,1450,1450,0,0
1809,2019-01-10,297,0,297,23,320,320,0,0
1810,2019-01-10,362,0,362,28,390,390,0,0
1811,2019-01-10,454,0,454,36,490,490,0,0
1812,2019-01-10,1186,0,1186,94,1280,1280,0,0
1813,2019-01-10,945,0,945,75,1020,1020,0,0
1814,2019-01-10,473,0,473,37,510,510,0,0
1815,2019-01-10,223,0,223,17,240,240,0,0
1816,2019-01-10,602,0,602,48,650,650,0,0
1817,2019-01-10,1288,0,1288,102,1390,1390,0,0
1818,2019-01-10,1454,0,1454,116,1570,1570,0,0
1819,2019-01-10,463,0,463,37,500,500,0,0
1820,2019-01-11,139,0,139,11,150,150,0,0
1821,2019-01-11,908,0,908,72,980,980,0,0
1822,2019-01-11,1260,0,1260,100,1360,1360,0,0
1823,2019-01-11,1778,0,1778,142,1920,1920,0,0
1824,2019-01-11,730,0,730,40,770,770,0,0
1825,2019-01-11,769,0,769,61,830,830,0,0
1826,2019-01-11,1815,0,1815,145,1960,1960,0,0
1827,2019-01-11,723,0,723,57,780,780,0,0
1828,2019-01-11,906,0,906,54,960,960,0,0
1829,2019-01-11,500,0,500,40,540,540,0,0
1830,2019-01-11,806,0,806,64,870,870,0,0
1831,2019-01-11,278,0,278,22,300,300,0,0
1832,2019-01-11,806,0,806,64,870,870,0,0
1833,2019-01-11,371,0,371,29,400,400,0,0
1834,2019-01-11,1565,0,1565,125,1690,1690,0,0
1835,2019-01-11,621,0,621,49,670,670,0,0
1836,2019-01-11,1695,0,1695,135,1830,1830,0,0
1837,2019-01-11,760,0,760,60,820,820,0,0
1838,2019-01-11,277,0,277,13,290,290,0,0
1839,2019-01-11,713,0,713,57,770,770,0,0
1840,2019-01-11,713,0,713,57,770,770,0,0
1841,2019-01-11,908,0,908,72,980,980,0,0
1842,2019-01-11,1297,0,1297,103,1400,1400,0,0
1843,2019-01-11,806,0,806,64,870,870,0,0
1844,2019-01-11,917,0,917,73,990,990,0,0
1845,2019-01-11,1815,0,1815,145,1960,1960,0,0
1846,2019-01-11,2204,0,2204,176,2380,2380,0,0
1847,2019-01-11,2288,0,2288,182,2470,2470,0,0
1848,2019-01-11,1417,0,1417,113,1530,1530,0,0
1849,2019-01-11,621,0,621,49,670,670,0,0
1850,2019-01-11,575,0,575,45,620,620,0,0
1851,2019-01-11,1436,0,1436,114,1550,1550,0,0
1852,2019-01-11,973,0,973,77,1050,1050,0,0
1853,2019-01-11,362,0,362,28,390,390,0,0
1854,2019-01-11,667,0,667,53,720,720,0,0
1855,2019-01-11,1815,0,1815,145,1960,1960,0,0
1856,2019-01-11,731,0,731,49,780,780,0,0
1857,2019-01-11,2880,0,2880,230,3110,3110,0,0
1858,2019-01-11,232,0,232,18,250,250,0,0
1859,2019-01-11,612,0,612,48,660,660,0,0
1860,2019-01-11,2546,0,2546,194,2740,2740,0,0
1861,2019-01-11,1593,0,1593,127,1720,1720,0,0
1862,2019-01-11,973,0,973,77,1050,1050,0,0
1863,2019-01-11,417,0,417,33,450,450,0,0
1864,2019-01-11,1001,0,1001,79,1080,1080,0,0
1865,2019-01-11,297,0,297,23,320,320,0,0
1866,2019-01-11,1112,0,1112,88,1200,1200,0,0
1867,2019-01-11,1139,0,1139,91,1230,1230,0,0
1868,2019-01-11,908,0,908,72,980,980,0,0
1869,2019-01-11,491,0,491,39,530,530,0,0
1870,2019-01-11,723,0,723,57,780,780,0,0
1871,2019-01-11,139,0,139,11,150,150,0,0
1872,2019-01-11,630,0,630,50,680,680,0,0
1873,2019-01-11,626,0,626,49,675,675,0,0
1874,2019-01-11,362,0,362,28,390,390,0,0
1875,2019-01-11,110,0,110,0,110,110,0,0
1876,2019-01-11,593,0,593,47,640,640,0,0
1877,2019-01-11,417,0,417,33,450,450,0,0
1878,2019-01-11,778,0,778,62,840,840,0,0
1879,2019-01-11,556,0,556,44,600,600,0,0
1880,2019-01-11,269,0,269,21,290,290,0,0
1881,2019-01-11,769,0,769,61,830,830,0,0
1882,2019-01-11,176,0,176,14,190,190,0,0
1883,2019-01-11,760,0,760,60,820,820,0,0
1884,2019-01-11,612,0,612,48,660,660,0,0
1885,2019-01-11,1825,0,1825,145,1970,1970,0,0
1886,2019-01-11,676,0,676,54,730,730,0,0
1887,2019-01-11,769,0,769,61,830,830,0,0
1888,2019-01-11,741,0,741,59,800,800,0,0
1889,2019-01-11,658,0,658,52,710,710,0,0
1890,2019-01-11,1232,0,1232,98,1330,1330,0,0
1891,2019-01-11,954,0,954,76,1030,1030,0,0
1892,2019-01-11,348,0,348,27,375,375,0,0
1893,2019-01-11,852,0,852,68,920,920,0,0
1894,2019-01-11,658,0,658,52,710,710,0,0
1895,2019-01-11,195,0,195,15,210,210,0,0
1896,2019-01-11,1501,0,1501,119,1620,1620,0,0
1897,2019-01-11,1158,0,1158,92,1250,1250,0,0
1898,2019-01-11,676,0,676,54,730,730,0,0
1899,2019-01-11,1815,0,1815,145,1960,1960,0,0
1900,2019-01-11,269,0,269,21,290,290,0,0
1901,2019-01-11,658,0,658,52,710,710,0,0
1902,2019-01-11,186,0,186,14,200,200,0,0
1903,2019-01-11,602,0,602,48,650,650,0,0
1904,2019-01-11,760,0,760,60,820,0,820,0
1905,2019-01-11,1815,0,1815,145,1960,1960,0,0
1906,2019-01-11,1815,0,1815,145,1960,1960,0,0
1907,2019-01-11,362,0,362,28,390,390,0,0
1908,2019-01-11,167,0,167,13,180,180,0,0
1909,2019-01-11,473,0,473,37,510,510,0,0
1910,2019-01-11,315,0,315,25,340,340,0,0
1911,2019-01-11,399,0,399,31,430,430,0,0
1912,2019-01-11,278,0,278,22,300,300,0,0
1913,2019-01-11,908,0,908,72,980,980,0,0
1914,2019-01-11,703,0,703,56,759,759,0,0
1915,2019-01-11,1269,0,1269,101,1370,1370,0,0
1916,2019-01-11,149,0,149,11,160,160,0,0
1917,2019-01-11,2075,0,2075,165,2240,2240,0,0
1918,2019-01-11,1834,0,1834,146,1980,1980,0,0
1919,2019-01-11,278,0,278,22,300,300,0,0
1920,2019-01-11,778,0,778,62,840,840,0,0
1921,2019-01-11,371,0,371,29,400,400,0,0
1922,2019-01-11,269,0,269,21,290,290,0,0
1923,2019-01-11,269,0,269,21,290,290,0,0
1924,2019-01-11,889,0,889,71,960,960,0,0
1925,2019-01-11,630,0,630,50,680,680,0,0
1926,2019-01-11,510,0,510,40,550,550,0,0
1927,2019-01-11,1815,0,1815,145,1960,1960,0,0
1928,2019-01-11,593,0,593,47,640,640,0,0
1929,2019-01-11,1815,0,1815,145,1960,1960,0,0
1930,2019-01-11,1047,0,1047,83,1130,1130,0,0
1931,2019-01-11,889,0,889,71,960,960,0,0
1932,2019-01-11,1000,0,1000,80,1080,1080,0,0
1933,2019-01-11,908,0,908,72,980,980,0,0
1934,2019-01-11,1815,0,1815,145,1960,1960,0,0
1935,2019-01-11,908,0,908,72,980,980,0,0
1936,2019-01-11,612,0,612,48,660,660,0,0
1937,2019-01-11,815,0,815,65,880,880,0,0
1938,2019-01-11,741,0,741,59,800,800,0,0
1939,2019-01-11,834,0,834,66,900,900,0,0
1940,2019-01-11,334,0,334,26,360,360,0,0
1941,2019-01-11,2195,0,2195,175,2370,2370,0,0
1942,2019-01-11,1093,0,1093,87,1180,1180,0,0
1943,2019-01-11,482,0,482,38,520,520,0,0
1944,2019-01-11,251,0,251,19,270,270,0,0
1945,2019-01-11,1797,0,1797,143,1940,1940,0,0
1946,2019-01-11,908,0,908,72,980,980,0,0
1947,2019-01-11,1231,0,1231,89,1320,1320,0,0
1948,2019-01-11,1815,0,1815,145,1960,1960,0,0
1949,2019-01-11,1130,0,1130,90,1220,1220,0,0
1950,2019-01-11,843,0,843,67,910,910,0,0
1951,2019-01-11,463,0,463,37,500,500,0,0
1952,2019-01-11,269,0,269,21,290,290,0,0
1953,2019-01-11,260,0,260,20,280,280,0,0
1954,2019-01-11,1204,0,1204,96,1300,1300,0,0
1955,2019-01-11,463,0,463,37,500,500,0,0
1956,2019-01-11,241,0,241,19,260,260,0,0
1957,2019-01-11,408,0,408,32,440,440,0,0
1958,2019-01-11,1102,0,1102,88,1190,1190,0,0
1959,2019-01-11,362,0,362,28,390,390,0,0
1960,2019-01-11,436,0,436,34,470,470,0,0
1961,2019-01-11,380,0,380,30,410,410,0,0
1962,2019-01-11,713,0,713,57,770,770,0,0
1963,2019-01-11,473,0,473,37,510,510,0,0
1964,2019-01-11,139,0,139,11,150,150,0,0
1965,2019-01-11,908,0,908,72,980,980,0,0
1966,2019-01-11,1306,0,1306,104,1410,1410,0,0
1967,2019-01-11,1815,0,1815,145,1960,1960,0,0
1968,2019-01-11,1445,0,1445,115,1560,1560,0,0
1969,2019-01-11,908,0,908,72,980,980,0,0
1970,2019-01-11,352,0,352,28,380,380,0,0
1971,2019-01-11,2723,0,2723,217,2940,2940,0,0
1972,2019-01-11,232,0,232,18,250,250,0,0
1973,2019-01-11,2055,0,2055,155,2210,2210,0,0
1974,2019-01-11,2723,0,2723,217,2940,2940,0,0
1975,2019-01-11,806,0,806,64,870,870,0,0
1976,2019-01-11,380,0,380,30,410,410,0,0
1977,2019-01-11,260,0,260,20,280,280,0,0
1978,2019-01-11,1815,0,1815,145,1960,1960,0,0
1979,2019-01-11,1815,0,1815,145,1960,1960,0,0
1980,2019-01-11,232,0,232,18,250,250,0,0
1981,2019-01-11,973,0,973,77,1050,1050,0,0
1982,2019-01-11,1815,0,1815,145,1960,1960,0,0
1983,2019-01-11,936,0,936,74,1010,1010,0,0
1984,2019-01-11,667,0,667,53,720,720,0,0
1985,2019-01-11,973,0,973,77,1050,1050,0,0
1986,2019-01-11,408,0,408,32,440,440,0,0
1987,2019-01-11,305,0,305,15,320,320,0,0
1988,2019-01-11,399,0,399,31,430,430,0,0
1989,2019-01-11,371,0,371,29,400,400,0,0
1990,2019-01-11,936,0,936,74,1010,1010,0,0
1991,2019-01-11,1352,0,1352,108,1460,1460,0,0
1992,2019-01-11,1815,0,1815,145,1960,1960,0,0
1993,2019-01-11,1630,0,1630,130,1760,0,1760,0
1994,2019-01-11,482,0,482,38,520,520,0,0
1995,2019-01-11,2047,0,2047,163,2210,2210,0,0
1996,2019-01-11,2621,0,2621,209,2830,2830,0,0
1997,2019-01-11,1158,0,1158,92,1250,1250,0,0
1998,2019-01-11,778,0,778,62,840,840,0,0
1999,2019-01-11,908,0,908,72,980,980,0,0
2000,2019-01-11,908,0,908,72,980,980,0,0
2001,2019-01-11,538,0,538,42,580,580,0,0
2002,2019-01-11,1973,0,1973,157,2130,2130,0,0
2003,2019-01-11,352,0,352,28,380,380,0,0
2004,2019-01-11,519,0,519,41,560,560,0,0
2005,2019-01-11,991,0,991,79,1070,1070,0,0
2006,2019-01-11,417,0,417,33,450,450,0,0
2007,2019-01-11,788,0,788,62,850,850,0,0
2008,2019-01-11,501,0,501,39,540,540,0,0
2009,2019-01-11,260,0,260,20,280,280,0,0
2010,2019-01-11,1213,0,1213,97,1310,1310,0,0
2011,2019-01-11,277,0,277,13,290,290,0,0
2012,2019-01-11,491,0,491,39,530,530,0,0
2013,2019-01-11,445,0,445,35,480,480,0,0
2014,2019-01-11,1408,0,1408,112,1520,1520,0,0
2015,2019-01-11,1176,0,1176,94,1270,1270,0,0
2016,2019-01-11,1278,0,1278,102,1380,1380,0,0
2017,2019-01-11,916,0,916,64,980,980,0,0
2018,2019-01-11,953,0,953,67,1020,1020,0,0
2019,2019-01-11,686,0,686,54,740,740,0,0
2020,2019-01-11,1815,0,1815,145,1960,1960,0,0
2021,2019-01-11,528,0,528,42,570,570,0,0
2022,2019-01-11,186,0,186,14,200,200,0,0
2023,2019-01-11,584,0,584,46,630,630,0,0
2024,2019-01-11,334,0,334,26,360,360,0,0
2025,2019-01-11,556,0,556,44,600,600,0,0
2026,2019-01-12,277,0,277,13,290,290,0,0
2027,2019-01-12,760,0,760,60,820,820,0,0
2028,2019-01-12,954,0,954,76,1030,1030,0,0
2029,2019-01-12,1075,0,1075,85,1160,1160,0,0
2030,2019-01-12,112,0,112,8,120,120,0,0
2031,2019-01-12,954,0,954,76,1030,1030,0,0
2032,2019-01-12,2454,0,2454,196,2650,2650,0,0
2033,2019-01-12,1296,0,1296,94,1390,1390,0,0
2034,2019-01-12,732,0,732,58,790,790,0,0
2035,2019-01-12,426,0,426,34,460,460,0,0
2036,2019-01-12,565,0,565,45,610,610,0,0
2037,2019-01-12,528,0,528,42,570,570,0,0
2038,2019-01-12,2213,0,2213,177,2390,2390,0,0
2039,2019-01-12,528,0,528,42,570,570,0,0
2040,2019-01-12,1352,-500,852,68,920,920,0,0
2041,2019-01-12,602,0,602,48,650,650,0,0
2042,2019-01-12,778,0,778,62,840,840,0,0
2043,2019-01-12,1297,0,1297,103,1400,1400,0,0
2044,2019-01-12,501,0,501,39,540,540,0,0
2045,2019-01-12,1001,0,1001,79,1080,1080,0,0
2046,2019-01-12,639,0,639,51,690,690,0,0
2047,2019-01-12,463,0,463,37,500,500,0,0
2048,2019-01-12,325,0,325,25,350,350,0,0
2049,2019-01-12,565,0,565,45,610,610,0,0
2050,2019-01-12,463,0,463,37,500,500,0,0
2051,2019-01-12,499,0,499,31,530,530,0,0
2052,2019-01-12,519,0,519,41,560,560,0,0
2053,2019-01-12,482,0,482,38,520,520,0,0
2054,2019-01-12,510,0,510,40,550,550,0,0
2055,2019-01-12,435,0,435,25,460,460,0,0
2056,2019-01-12,278,0,278,22,300,300,0,0
2057,2019-01-12,1547,0,1547,123,1670,1670,0,0
2058,2019-01-12,1575,0,1575,125,1700,1700,0,0
2059,2019-01-12,251,0,251,19,270,270,0,0
2060,2019-01-12,2744,-294,2450,196,2646,2646,0,0
2061,2019-01-12,778,0,778,62,840,840,0,0
2062,2019-01-12,-2723,0,-2723,-217,-2940,-2940,0,0
2063,2019-01-12,1241,0,1241,99,1340,1340,0,0
2064,2019-01-12,2435,0,2435,185,2620,2620,0,0
2065,2019-01-12,1112,0,1112,88,1200,1200,0,0
2066,2019-01-12,1538,-500,1038,82,1120,1120,0,0
2067,2019-01-12,908,0,908,72,980,980,0,0
2068,2019-01-12,908,0,908,72,980,980,0,0
2069,2019-01-12,908,0,908,72,980,980,0,0
2070,2019-01-12,269,0,269,21,290,290,0,0
2071,2019-01-12,1167,0,1167,93,1260,1260,0,0
2072,2019-01-12,1815,0,1815,145,1960,1960,0,0
2073,2019-01-12,2130,0,2130,170,2300,2300,0,0
2074,2019-01-12,1815,0,1815,145,1960,1960,0,0
2075,2019-01-12,722,0,722,48,770,770,0,0
2076,2019-01-12,1269,0,1269,101,1370,1370,0,0
2077,2019-01-12,823,0,823,57,880,880,0,0
2078,2019-01-12,2723,0,2723,217,2940,2940,0,0
2079,2019-01-12,815,0,815,65,880,880,0,0
2080,2019-01-12,1815,0,1815,145,1960,1960,0,0
2081,2019-01-12,602,0,602,48,650,650,0,0
2082,2019-01-12,1186,0,1186,94,1280,1280,0,0
2083,2019-01-12,2723,0,2723,217,2940,2940,0,0
2084,2019-01-12,1815,0,1815,145,1960,1960,0,0
2085,2019-01-12,408,0,408,32,440,440,0,0
2086,2019-01-12,621,0,621,49,670,670,0,0
2087,2019-01-12,676,0,676,54,730,730,0,0
2088,2019-01-12,1121,0,1121,89,1210,1210,0,0
2089,2019-01-12,657,0,657,43,700,700,0,0
2090,2019-01-12,1834,0,1834,146,1980,1980,0,0
2091,2019-01-12,945,0,945,75,1020,1020,0,0
2092,2019-01-12,1732,0,1732,138,1870,1870,0,0
2093,2019-01-12,2501,0,2501,199,2700,2700,0,0
2094,2019-01-12,1899,0,1899,151,2050,2050,0,0
2095,2019-01-12,834,-500,334,26,360,360,0,0
2096,2019-01-12,667,0,667,53,720,720,0,0
2097,2019-01-12,1925,0,1925,145,2070,2070,0,0
2098,2019-01-12,1815,0,1815,145,1960,1960,0,0
2099,2019-01-12,667,0,667,53,720,720,0,0
2100,2019-01-12,695,0,695,55,750,750,0,0
2101,2019-01-12,334,0,334,26,360,360,0,0
2102,2019-01-12,417,0,417,33,450,450,0,0
2103,2019-01-12,1130,0,1130,90,1220,1220,0,0
2104,2019-01-12,519,0,519,41,560,560,0,0
2105,2019-01-12,278,0,278,22,300,300,0,0
2106,2019-01-12,426,0,426,34,460,460,0,0
2107,2019-01-12,1908,0,1908,152,2060,0,2060,0
2108,2019-01-12,538,0,538,42,580,580,0,0
2109,2019-01-12,269,0,269,21,290,290,0,0
2110,2019-01-12,491,0,491,39,530,530,0,0
2111,2019-01-12,325,0,325,25,350,350,0,0
2112,2019-01-12,260,0,260,20,280,280,0,0
2113,2019-01-12,723,0,723,57,780,780,0,0
2114,2019-01-12,695,0,695,55,750,750,0,0
2115,2019-01-12,741,0,741,59,800,800,0,0
2116,2019-01-12,843,0,843,67,910,910,0,0
2117,2019-01-12,482,0,482,38,520,520,0,0
2118,2019-01-12,251,0,251,19,270,270,0,0
2119,2019-01-12,491,0,491,39,530,530,0,0
2120,2019-01-12,232,0,232,18,250,250,0,0
2121,2019-01-12,463,0,463,37,500,500,0,0
2122,2019-01-12,926,0,926,74,1000,1000,0,0
2123,2019-01-12,593,0,593,47,640,640,0,0
2124,2019-01-12,788,0,788,62,850,850,0,0
2125,2019-01-12,389,0,389,31,420,420,0,0
2126,2019-01-12,1389,0,1389,111,1500,1500,0,0
2127,2019-01-12,565,0,565,45,610,610,0,0
2128,2019-01-12,732,0,732,58,790,790,0,0
2129,2019-01-12,283,-60,223,17,240,240,0,0
2130,2019-01-12,112,0,112,8,120,120,0,0
2131,2019-01-12,232,0,232,18,250,250,0,0
2132,2019-01-12,1602,0,1602,128,1730,1730,0,0
2133,2019-01-12,556,0,556,44,600,600,0,0
2134,2019-01-12,769,0,769,61,830,830,0,0
2135,2019-01-12,519,0,519,41,560,560,0,0
2136,2019-01-12,2510,0,2510,200,2710,2710,0,0
2137,2019-01-12,380,0,380,30,410,410,0,0
2138,2019-01-12,565,0,565,45,610,610,0,0
2139,2019-01-12,510,0,510,40,550,550,0,0
2140,2019-01-12,908,0,908,72,980,980,0,0
2141,2019-01-12,1112,0,1112,88,1200,1200,0,0
2142,2019-01-12,399,0,399,31,430,430,0,0
2143,2019-01-12,3630,0,3630,290,3920,3920,0,0
2144,2019-01-12,260,0,260,20,280,280,0,0
2145,2019-01-12,232,0,232,18,250,250,0,0
2146,2019-01-12,621,0,621,49,670,670,0,0
2147,2019-01-12,612,0,612,48,660,660,0,0
2148,2019-01-12,501,0,501,39,540,540,0,0
2149,2019-01-12,501,0,501,39,540,540,0,0
2150,2019-01-12,1112,0,1112,88,1200,1200,0,0
2151,2019-01-12,325,0,325,25,350,350,0,0
2152,2019-01-12,565,0,565,45,610,610,0,0
2153,2019-01-12,1602,0,1602,128,1730,1730,0,0
2154,2019-01-12,454,0,454,36,490,490,0,0
2155,2019-01-12,278,0,278,22,300,300,0,0
2156,2019-01-12,538,0,538,42,580,580,0,0
2157,2019-01-12,1130,0,1130,90,1220,1220,0,0
2158,2019-01-12,93,0,93,7,100,100,0,0
2159,2019-01-12,1158,0,1158,92,1250,1250,0,0
2160,2019-01-12,334,0,334,26,360,360,0,0
2161,2019-01-12,704,0,704,56,760,760,0,0
2162,2019-01-12,213,0,213,17,230,230,0,0
2163,2019-01-12,1167,0,1167,93,1260,1260,0,0
2164,2019-01-12,223,0,223,17,240,240,0,0
2165,2019-01-12,1463,0,1463,117,1580,1580,0,0
2166,2019-01-12,630,0,630,50,680,680,0,0
2167,2019-01-12,1954,0,1954,156,2110,2110,0,0
2168,2019-01-12,1343,0,1343,107,1450,1450,0,0
2169,2019-01-12,463,0,463,37,500,500,0,0
2170,2019-01-12,269,0,269,21,290,290,0,0
2171,2019-01-12,193,0,193,15,208,208,0,0
2172,2019-01-12,630,0,630,50,680,680,0,0
2173,2019-01-12,1362,0,1362,108,1470,1470,0,0
2174,2019-01-12,278,0,278,22,300,300,0,0
2175,2019-01-12,880,0,880,70,950,950,0,0
2176,2019-01-12,1038,0,1038,82,1120,1120,0,0
2177,2019-01-12,1028,0,1028,82,1110,1110,0,0
2178,2019-01-12,1556,0,1556,124,1680,1680,0,0
2179,2019-01-12,1815,0,1815,145,1960,1960,0,0
2180,2019-01-12,2723,0,2723,217,2940,2940,0,0
2181,2019-01-12,2723,0,2723,217,2940,0,2940,0
2182,2019-01-12,1334,0,1334,106,1440,1440,0,0
2183,2019-01-12,936,0,936,74,1010,1010,0,0
2184,2019-01-12,667,0,667,53,720,720,0,0
2185,2019-01-12,2362,0,2362,188,2550,2550,0,0
2186,2019-01-12,1130,0,1130,90,1220,1220,0,0
2187,2019-01-12,1592,0,1592,118,1710,0,1710,0
2188,2019-01-12,371,0,371,29,400,400,0,0
2189,2019-01-12,1815,0,1815,145,1960,1960,0,0
2190,2019-01-12,3843,0,3843,307,4150,4150,0,0
2191,2019-01-12,815,0,815,65,880,880,0,0
2192,2019-01-12,528,0,528,42,570,570,0,0
2193,2019-01-12,306,0,306,24,330,330,0,0
2194,2019-01-12,1676,0,1676,134,1810,1810,0,0
2195,2019-01-12,547,0,547,43,590,590,0,0
2196,2019-01-12,139,0,139,11,150,150,0,0
2197,2019-01-12,575,0,575,45,620,620,0,0
2198,2019-01-12,500,0,500,40,540,540,0,0
2199,2019-01-12,1452,0,1452,98,1550,1550,0,0
2200,2019-01-12,723,0,723,57,780,780,0,0
2201,2019-01-12,1815,0,1815,145,1960,1960,0,0
2202,2019-01-12,565,0,565,45,610,610,0,0
2203,2019-01-12,269,0,269,21,290,290,0,0
2204,2019-01-12,732,0,732,58,790,790,0,0
2205,2019-01-12,1130,0,1130,90,1220,1220,0,0
2206,2019-01-12,806,0,806,64,870,870,0,0
2207,2019-01-12,629,0,629,41,670,670,0,0
2208,2019-01-12,1010,0,1010,80,1090,0,1090,0
2209,2019-01-12,788,0,788,62,850,850,0,0
2210,2019-01-12,1352,0,1352,108,1460,0,1460,0
2211,2019-01-12,741,0,741,59,800,800,0,0
2212,2019-01-12,639,0,639,51,690,690,0,0
2213,2019-01-12,334,0,334,26,360,360,0,0
2214,2019-01-12,880,0,880,70,950,950,0,0
2215,2019-01-12,676,0,676,54,730,730,0,0
2216,2019-01-12,880,0,880,70,950,950,0,0
2217,2019-01-12,1065,0,1065,85,1150,1150,0,0
2218,2019-01-12,278,0,278,22,300,300,0,0
2219,2019-01-12,1399,0,1399,111,1510,1510,0,0
2220,2019-01-12,139,0,139,11,150,150,0,0
2221,2019-01-12,1389,0,1389,111,1500,1500,0,0
2222,2019-01-12,167,0,167,13,180,180,0,0
2223,2019-01-12,602,0,602,48,650,650,0,0
2224,2019-01-12,607,0,607,48,655,655,0,0
2225,2019-01-12,1556,0,1556,124,1680,1680,0,0
2226,2019-01-12,491,0,491,39,530,530,0,0
2227,2019-01-12,621,0,621,49,670,670,0,0
2228,2019-01-12,232,0,232,18,250,250,0,0
2229,2019-01-12,112,0,112,8,120,120,0,0
2230,2019-01-12,334,0,334,26,360,0,360,0
2231,2019-01-12,112,0,112,8,120,120,0,0
2232,2019-01-12,204,0,204,16,220,220,0,0
2233,2019-01-12,112,0,112,8,120,120,0,0
2234,2019-01-12,1815,0,1815,145,1960,1960,0,0
2235,2019-01-12,113,-24,89,7,96,96,0,0
2236,2019-01-12,362,0,362,28,390,390,0,0
2237,2019-01-12,278,0,278,22,300,300,0,0
2238,2019-01-12,556,0,556,44,600,600,0,0
2239,2019-01-12,1064,0,1064,76,1140,1140,0,0
2240,2019-01-12,112,0,112,8,120,120,0,0
2241,2019-01-12,394,0,394,31,425,425,0,0
2242,2019-01-12,649,0,649,51,700,700,0,0
2243,2019-01-12,121,0,121,9,130,130,0,0
2244,2019-01-12,163,0,163,12,175,175,0,0
2245,2019-01-12,362,0,362,28,390,390,0,0
2246,2019-01-12,676,0,676,54,730,730,0,0
2247,2019-01-12,362,0,362,28,390,390,0,0
2248,2019-01-12,41889,0,41889,3351,45240,45240,0,0
2249,2019-01-12,723,0,723,57,780,780,0,0
2250,2019-01-12,204,0,204,16,220,220,0,0
2251,2019-01-12,362,0,362,28,390,390,0,0
2252,2019-01-12,834,0,834,66,900,900,0,0
2253,2019-01-12,2436,0,2436,194,2630,2630,0,0
2254,2019-01-12,862,0,862,68,930,930,0,0
2255,2019-01-12,1920,-1920,0,0,0,0,0,0
2256,2019-01-12,1139,0,1139,91,1230,1230,0,0
2257,2019-01-12,621,0,621,49,670,670,0,0
2258,2019-01-12,1399,0,1399,111,1510,1510,0,0
2259,2019-01-12,667,0,667,53,720,720,0,0
2260,2019-01-12,713,0,713,57,770,770,0,0
2261,2019-01-12,871,0,871,69,940,940,0,0
2262,2019-01-12,1815,0,1815,145,1960,1960,0,0
2263,2019-01-12,695,0,695,55,750,750,0,0
2264,2019-01-12,444,0,444,26,470,470,0,0
2265,2019-01-12,362,0,362,28,390,390,0,0
2266,2019-01-12,278,0,278,22,300,300,0,0
2267,2019-01-12,1962,0,1962,148,2110,2110,0,0
2268,2019-01-12,649,0,649,51,700,700,0,0
2269,2019-01-12,797,0,797,63,860,860,0,0
2270,2019-01-12,1519,0,1519,121,1640,1640,0,0
2271,2019-01-12,491,0,491,39,530,530,0,0
2272,2019-01-12,575,0,575,45,620,620,0,0
2273,2019-01-12,1223,0,1223,97,1320,1320,0,0
2274,2019-01-12,278,0,278,22,300,300,0,0
2275,2019-01-12,565,0,565,45,610,610,0,0
2276,2019-01-12,-278,0,-278,-22,-300,-300,0,0
2277,2019-01-12,278,0,278,22,300,300,0,0
2278,2019-01-12,630,0,630,50,680,680,0,0
2279,2019-01-12,2010,-2000,10,0,10,10,0,0
2280,2019-01-12,1112,0,1112,88,1200,1200,0,0
2281,2019-01-12,1268,-135,1133,82,1215,1215,0,0
2282,2019-01-12,908,0,908,72,980,980,0,0
2283,2019-01-12,278,0,278,22,300,300,0,0
2284,2019-01-12,695,0,695,55,750,750,0,0
2285,2019-01-12,519,0,519,41,560,560,0,0
2286,2019-01-12,704,0,704,56,760,760,0,0
2287,2019-01-12,602,0,602,48,650,650,0,0
2288,2019-01-12,630,0,630,50,680,680,0,0
2289,2019-01-12,334,0,334,26,360,360,0,0
2290,2019-01-12,908,0,908,72,980,980,0,0
2291,2019-01-12,612,0,612,48,660,660,0,0
2292,2019-01-12,176,0,176,14,190,190,0,0
2293,2019-01-12,139,0,139,11,150,150,0,0
2294,2019-01-12,2408,0,2408,192,2600,2600,0,0
2295,2019-01-12,1815,0,1815,145,1960,1960,0,0
2296,2019-01-12,945,0,945,75,1020,1020,0,0
2297,2019-01-12,1251,0,1251,99,1350,1350,0,0
2298,2019-01-12,2723,0,2723,217,2940,2940,0,0
2299,2019-01-12,380,0,380,30,410,410,0,0
2300,2019-01-12,371,0,371,29,400,400,0,0
2301,2019-01-12,399,0,399,31,430,430,0,0
2302,2019-01-12,380,0,380,30,410,410,0,0
2303,2019-01-12,862,0,862,68,930,930,0,0
2304,2019-01-12,297,0,297,23,320,320,0,0
2305,2019-01-12,2371,0,2371,189,2560,2560,0,0
2306,2019-01-12,778,0,778,62,840,840,0,0
2307,2019-01-12,713,0,713,57,770,770,0,0
2308,2019-01-12,1751,0,1751,139,1890,1890,0,0
2309,2019-01-12,2112,0,2112,168,2280,2280,0,0
2310,2019-01-12,2473,0,2473,197,2670,2670,0,0
2311,2019-01-12,1158,0,1158,92,1250,1250,0,0
2312,2019-01-12,232,0,232,18,250,250,0,0
2313,2019-01-12,676,0,676,54,730,730,0,0
2314,2019-01-12,538,0,538,42,580,580,0,0
2315,2019-01-12,445,0,445,35,480,480,0,0
2316,2019-01-12,806,0,806,64,870,870,0,0
2317,2019-01-12,519,0,519,41,560,0,560,0
2318,2019-01-12,1482,0,1482,118,1600,1600,0,0
2319,2019-01-12,769,0,769,61,830,830,0,0
2320,2019-01-12,334,0,334,26,360,360,0,0
2321,2019-01-12,1741,0,1741,139,1880,1880,0,0
2322,2019-01-12,834,0,834,66,900,900,0,0
2323,2019-01-12,1139,0,1139,91,1230,1230,0,0
2324,2019-01-12,306,0,306,24,330,330,0,0
2325,2019-01-13,1509,0,1509,111,1620,1620,0,0
2326,2019-01-13,2973,0,2973,237,3210,3210,0,0
2327,2019-01-13,315,0,315,25,340,340,0,0
2328,2019-01-13,343,0,343,27,370,370,0,0
2329,2019-01-13,362,0,362,28,390,390,0,0
2330,2019-01-13,908,0,908,72,980,980,0,0
2331,2019-01-13,380,0,380,30,410,410,0,0
2332,2019-01-13,399,0,399,31,430,430,0,0
2333,2019-01-13,315,0,315,25,340,340,0,0
2334,2019-01-13,1638,0,1638,122,1760,1760,0,0
2335,2019-01-13,797,0,797,63,860,860,0,0
2336,2019-01-13,908,0,908,72,980,980,0,0
2337,2019-01-13,667,0,667,53,720,720,0,0
2338,2019-01-13,490,0,490,30,520,520,0,0
2339,2019-01-13,334,0,334,26,360,360,0,0
2340,2019-01-13,1203,0,1203,87,1290,1290,0,0
2341,2019-01-13,445,0,445,35,480,480,0,0
2342,2019-01-13,612,0,612,48,660,660,0,0
2343,2019-01-13,463,0,463,37,500,500,0,0
2344,2019-01-13,436,0,436,34,470,470,0,0
2345,2019-01-13,908,0,908,72,980,980,0,0
2346,2019-01-13,713,0,713,57,770,770,0,0
2347,2019-01-13,538,0,538,42,580,580,0,0
2348,2019-01-13,849,0,849,41,890,890,0,0
2349,2019-01-13,491,0,491,39,530,530,0,0
2350,2019-01-13,1167,0,1167,93,1260,1260,0,0
2351,2019-01-13,788,0,788,62,850,850,0,0
2352,2019-01-13,889,0,889,71,960,960,0,0
2353,2019-01-13,982,0,982,78,1060,1060,0,0
2354,2019-01-13,2129,0,2129,161,2290,2290,0,0
2355,2019-01-13,862,0,862,68,930,930,0,0
2356,2019-01-13,1593,0,1593,127,1720,1720,0,0
2357,2019-01-13,769,0,769,61,830,830,0,0
2358,2019-01-13,769,0,769,61,830,830,0,0
2359,2019-01-13,686,0,686,54,740,740,0,0
2360,2019-01-13,213,0,213,17,230,230,0,0
2361,2019-01-13,3140,-3000,140,10,150,150,0,0
2362,2019-01-13,3251,0,3251,259,3510,3510,0,0
2363,2019-01-13,834,0,834,66,900,900,0,0
2364,2019-01-13,732,0,732,58,790,790,0,0
2365,2019-01-13,473,0,473,37,510,510,0,0
2366,2019-01-13,5001,0,5001,399,5400,5400,0,0
2367,2019-01-13,908,0,908,72,980,980,0,0
2368,2019-01-13,908,0,908,72,980,980,0,0
2369,2019-01-13,751,0,751,59,810,810,0,0
2370,2019-01-13,834,0,834,66,900,900,0,0
2371,2019-01-13,311,-66,245,19,264,264,0,0
2372,2019-01-13,838,-178,660,52,712,712,0,0
2373,2019-01-13,176,0,176,14,190,190,0,0
2374,2019-01-13,139,0,139,11,150,150,0,0
2375,2019-01-13,56,0,56,4,60,60,0,0
2376,2019-01-13,501,0,501,39,540,540,0,0
2377,2019-01-13,139,0,139,11,150,150,0,0
2378,2019-01-13,1083,0,1083,77,1160,1160,0,0
2379,2019-01-13,564,0,564,36,600,600,0,0
2380,2019-01-13,602,0,602,48,650,650,0,0
2381,2019-01-13,1834,0,1834,146,1980,1980,0,0
2382,2019-01-13,1121,0,1121,89,1210,1210,0,0
2383,2019-01-13,334,0,334,26,360,360,0,0
2384,2019-01-13,2723,0,2723,217,2940,2940,0,0
2385,2019-01-13,584,0,584,46,630,630,0,0
2386,2019-01-13,899,0,899,71,970,970,0,0
2387,2019-01-13,676,0,676,54,730,730,0,0
2388,2019-01-13,288,0,288,22,310,310,0,0
2389,2019-01-13,565,0,565,45,610,610,0,0
2390,2019-01-13,371,0,371,29,400,400,0,0
2391,2019-01-13,658,0,658,52,710,710,0,0
2392,2019-01-13,778,0,778,62,840,840,0,0
2393,2019-01-13,1038,0,1038,82,1120,1120,0,0
2394,2019-01-13,408,0,408,32,440,440,0,0
2395,2019-01-13,93,0,93,7,100,100,0,0
2396,2019-01-13,260,0,260,20,280,280,0,0
2397,2019-01-13,556,0,556,44,600,600,0,0
2398,2019-01-13,501,0,501,39,540,540,0,0
2399,2019-01-13,362,0,362,28,390,390,0,0
2400,2019-01-13,1815,0,1815,145,1960,1960,0,0
2401,2019-01-13,426,0,426,34,460,0,460,0
2402,2019-01-13,329,0,329,26,355,355,0,0
2403,2019-01-13,519,0,519,41,560,560,0,0
2404,2019-01-13,676,0,676,54,730,730,0,0
2405,2019-01-13,167,0,167,13,180,180,0,0
2406,2019-01-13,806,0,806,64,870,870,0,0
2407,2019-01-13,1815,0,1815,145,1960,1960,0,0
2408,2019-01-13,334,0,334,26,360,360,0,0
2409,2019-01-13,259,0,259,11,270,270,0,0
2410,2019-01-13,482,0,482,38,520,520,0,0
2411,2019-01-13,593,0,593,47,640,640,0,0
2412,2019-01-13,908,0,908,72,980,980,0,0
2413,2019-01-13,278,0,278,22,300,300,0,0
2414,2019-01-13,380,0,380,30,410,410,0,0
2415,2019-01-13,297,0,297,23,320,320,0,0
2416,2019-01-13,139,0,139,11,150,150,0,0
2417,2019-01-13,908,0,908,72,980,980,0,0
2418,2019-01-13,908,0,908,72,980,980,0,0
2419,2019-01-13,56,0,56,4,60,60,0,0
2420,2019-01-13,315,0,315,25,340,340,0,0
2421,2019-01-13,1815,0,1815,145,1960,1960,0,0
2422,2019-01-13,667,0,667,53,720,720,0,0
2423,2019-01-13,186,0,186,14,200,200,0,0
2424,2019-01-13,630,0,630,50,680,680,0,0
2425,2019-01-13,186,0,186,14,200,200,0,0
2426,2019-01-13,167,0,167,13,180,180,0,0
2427,2019-01-13,53815,0,53815,4305,58120,58120,0,0
2428,2019-01-13,1575,0,1575,125,1700,1700,0,0
2429,2019-01-13,2362,0,2362,188,2550,2550,0,0
2430,2019-01-13,3704,0,3704,296,4000,4000,0,0
2431,2019-01-13,1380,0,1380,110,1490,1490,0,0
2432,2019-01-13,1575,0,1575,125,1700,1700,0,0
2433,2019-01-13,2223,0,2223,177,2400,2400,0,0
2434,2019-01-13,788,0,788,62,850,850,0,0
2435,2019-01-13,788,0,788,62,850,850,0,0
2436,2019-01-13,788,0,788,62,850,850,0,0
2437,2019-01-13,788,0,788,62,850,850,0,0
2438,2019-01-13,139,0,139,11,150,150,0,0
2439,2019-01-13,408,0,408,32,440,440,0,0
2440,2019-01-13,936,0,936,74,1010,1010,0,0
2441,2019-01-13,1575,0,1575,125,1700,1700,0,0
2442,2019-01-13,788,0,788,62,850,850,0,0
2443,2019-01-13,186,0,186,14,200,200,0,0
2444,2019-01-13,1732,0,1732,138,1870,1870,0,0
2445,2019-01-13,954,0,954,76,1030,1030,0,0
2446,2019-01-13,1389,0,1389,111,1500,1500,0,0
2447,2019-01-13,362,0,362,28,390,390,0,0
2448,2019-01-13,269,0,269,21,290,290,0,0
2449,2019-01-13,936,0,936,74,1010,1010,0,0
2450,2019-01-13,806,0,806,64,870,870,0,0
2451,2019-01-13,1584,0,1584,126,1710,1710,0,0
2452,2019-01-13,232,0,232,18,250,250,0,0
2453,2019-01-13,426,0,426,34,460,460,0,0
2454,2019-01-13,186,0,186,14,200,200,0,0
2455,2019-01-13,667,0,667,53,720,720,0,0
2456,2019-01-13,186,0,186,14,200,200,0,0
2457,2019-01-13,269,0,269,21,290,290,0,0
2458,2019-01-13,186,0,186,14,200,200,0,0
2459,2019-01-13,204,0,204,16,220,220,0,0
2460,2019-01-13,463,0,463,37,500,500,0,0
2461,2019-01-13,1176,0,1176,94,1270,1270,0,0
2462,2019-01-13,741,0,741,59,800,800,0,0
2463,2019-01-13,325,0,325,25,350,350,0,0
2464,2019-01-13,236,-50,186,14,200,200,0,0
2465,2019-01-13,371,0,371,29,400,400,0,0
2466,2019-01-13,501,0,501,39,540,540,0,0
2467,2019-01-13,806,0,806,64,870,870,0,0
2468,2019-01-13,1065,0,1065,85,1150,1150,0,0
2469,2019-01-13,1112,0,1112,88,1200,1200,0,0
2470,2019-01-13,1334,0,1334,106,1440,1440,0,0
2471,2019-01-13,269,0,269,21,290,290,0,0
2472,2019-01-13,399,0,399,31,430,430,0,0
2473,2019-01-13,1186,0,1186,94,1280,1280,0,0
2474,2019-01-13,1158,0,1158,92,1250,1250,0,0
2475,2019-01-13,1084,0,1084,86,1170,1170,0,0
2476,2019-01-13,815,0,815,65,880,880,0,0
2477,2019-01-13,834,0,834,66,900,900,0,0
2478,2019-01-13,834,0,834,66,900,900,0,0
2479,2019-01-13,704,0,704,56,760,760,0,0
2480,2019-01-13,306,0,306,24,330,330,0,0
2481,2019-01-13,908,0,908,72,980,980,0,0
2482,2019-01-13,436,0,436,34,470,470,0,0
2483,2019-01-13,1556,0,1556,124,1680,1680,0,0
2484,2019-01-13,1408,0,1408,112,1520,1520,0,0
2485,2019-01-13,602,0,602,48,650,650,0,0
2486,2019-01-13,1852,0,1852,148,2000,2000,0,0
2487,2019-01-13,204,0,204,16,220,220,0,0
2488,2019-01-13,1936,0,1936,154,2090,2090,0,0
2489,2019-01-13,1260,0,1260,100,1360,1360,0,0
2490,2019-01-13,500,0,500,40,540,540,0,0
2491,2019-01-13,908,0,908,72,980,980,0,0
2492,2019-01-13,749,0,749,51,800,800,0,0
2493,2019-01-13,269,0,269,21,290,290,0,0
2494,2019-01-13,575,0,575,45,620,620,0,0
2495,2019-01-13,675,0,675,45,720,720,0,0
2496,2019-01-13,1546,0,1546,114,1660,1660,0,0
2497,2019-01-13,463,0,463,37,500,500,0,0
2498,2019-01-13,1306,0,1306,104,1410,1410,0,0
2499,2019-01-13,1564,0,1564,116,1680,1680,0,0
2500,2019-01-13,1278,0,1278,102,1380,1380,0,0
2501,2019-01-13,788,0,788,62,850,850,0,0
2502,2019-01-13,371,0,371,29,400,400,0,0
2503,2019-01-13,278,0,278,22,300,300,0,0
2504,2019-01-13,1575,0,1575,125,1700,1700,0,0
2505,2019-01-13,1436,0,1436,114,1550,1550,0,0
2506,2019-01-13,575,0,575,45,620,620,0,0
2507,2019-01-13,991,0,991,79,1070,1070,0,0
2508,2019-01-13,232,0,232,18,250,250,0,0
2509,2019-01-13,1871,0,1871,149,2020,2020,0,0
2510,2019-01-13,426,0,426,34,460,460,0,0
2511,2019-01-13,788,0,788,62,850,850,0,0
2512,2019-01-13,723,0,723,57,780,780,0,0
2513,2019-01-13,139,0,139,11,150,150,0,0
2514,2019-01-13,551,0,551,44,595,595,0,0
2515,2019-01-13,1075,0,1075,85,1160,1160,0,0
2516,2019-01-13,788,0,788,62,850,850,0,0
2517,2019-01-14,1028,0,1028,82,1110,1110,0,0
2518,2019-01-14,667,0,667,53,720,720,0,0
2519,2019-01-14,1278,0,1278,102,1380,1380,0,0
2520,2019-01-14,297,0,297,23,320,320,0,0
2521,2019-01-14,1815,0,1815,145,1960,1960,0,0
2522,2019-01-14,334,0,334,26,360,360,0,0
2523,2019-01-14,565,0,565,45,610,610,0,0
2524,2019-01-14,788,0,788,62,850,850,0,0
2525,2019-01-14,639,0,639,51,690,690,0,0
2526,2019-01-14,547,0,547,43,590,590,0,0
2527,2019-01-14,1213,0,1213,97,1310,1310,0,0
2528,2019-01-14,1325,0,1325,105,1430,1430,0,0
2529,2019-01-14,788,0,788,62,850,850,0,0
2530,2019-01-14,908,0,908,72,980,980,0,0
2531,2019-01-14,741,0,741,59,800,800,0,0
2532,2019-01-14,908,0,908,72,980,980,0,0
2533,2019-01-14,249,0,249,11,260,260,0,0
2534,2019-01-14,908,0,908,72,980,980,0,0
2535,2019-01-14,908,0,908,72,980,980,0,0
2536,2019-01-14,917,0,917,73,990,990,0,0
2537,2019-01-14,416,0,416,24,440,0,440,0
2538,2019-01-14,723,0,723,57,780,780,0,0
2539,2019-01-14,676,0,676,54,730,730,0,0
2540,2019-01-14,732,0,732,58,790,790,0,0
2541,2019-01-14,260,0,260,20,280,280,0,0
2542,2019-01-14,575,0,575,45,620,620,0,0
2543,2019-01-14,713,0,713,57,770,770,0,0
2544,2019-01-14,547,0,547,43,590,590,0,0
2545,2019-01-14,908,0,908,72,980,980,0,0
2546,2019-01-14,565,0,565,45,610,610,0,0
2547,2019-01-14,315,0,315,25,340,340,0,0
2548,2019-01-14,1102,0,1102,88,1190,1190,0,0
2549,2019-01-14,2936,0,2936,234,3170,3170,0,0
2550,2019-01-14,2723,0,2723,217,2940,2940,0,0
2551,2019-01-14,908,0,908,72,980,980,0,0
2552,2019-01-14,769,0,769,61,830,830,0,0
2553,2019-01-14,1130,0,1130,90,1220,1220,0,0
2554,2019-01-14,232,0,232,18,250,250,0,0
2555,2019-01-14,723,0,723,57,780,780,0,0
2556,2019-01-14,926,0,926,74,1000,1000,0,0
2557,2019-01-14,991,0,991,79,1070,1070,0,0
2558,2019-01-14,1686,0,1686,134,1820,1820,0,0
2559,2019-01-14,1137,0,1137,73,1210,1210,0,0
2560,2019-01-14,371,0,371,29,400,400,0,0
2561,2019-01-14,704,0,704,56,760,760,0,0
2562,2019-01-14,575,0,575,45,620,620,0,0
2563,2019-01-14,167,0,167,13,180,180,0,0
2564,2019-01-14,454,0,454,36,490,490,0,0
2565,2019-01-14,639,0,639,51,690,690,0,0
2566,2019-01-14,1815,0,1815,145,1960,1960,0,0
2567,2019-01-14,908,0,908,72,980,980,0,0
2568,2019-01-14,621,0,621,49,670,670,0,0
2569,2019-01-14,334,0,334,26,360,360,0,0
2570,2019-01-14,1047,0,1047,83,1130,1130,0,0
2571,2019-01-14,556,0,556,44,600,600,0,0
2572,2019-01-14,1584,0,1584,126,1710,1710,0,0
2573,2019-01-14,1547,0,1547,123,1670,1670,0,0
2574,2019-01-14,223,0,223,17,240,240,0,0
2575,2019-01-14,362,0,362,28,390,390,0,0
2576,2019-01-14,139,0,139,11,150,150,0,0
2577,2019-01-14,495,-53,442,35,477,477,0,0
2578,2019-01-14,399,0,399,31,430,430,0,0
2579,2019-01-14,-361,0,-361,-29,-390,-390,0,0
2580,2019-01-14,1389,0,1389,111,1500,1500,0,0
2581,2019-01-14,954,0,954,76,1030,1030,0,0
2582,2019-01-14,982,0,982,78,1060,1060,0,0
2583,2019-01-14,676,0,676,54,730,730,0,0
2584,2019-01-14,436,0,436,34,470,470,0,0
2585,2019-01-14,1723,0,1723,137,1860,1860,0,0
2586,2019-01-14,825,0,825,65,890,890,0,0
2587,2019-01-14,1121,0,1121,89,1210,1210,0,0
2588,2019-01-14,139,0,139,11,150,150,0,0
2589,2019-01-14,741,0,741,59,800,800,0,0
2590,2019-01-14,241,0,241,19,260,260,0,0
2591,2019-01-14,621,0,621,49,670,670,0,0
2592,2019-01-14,667,0,667,53,720,720,0,0
2593,2019-01-14,593,0,593,47,640,640,0,0
2594,2019-01-14,371,0,371,29,400,400,0,0
2595,2019-01-14,371,0,371,29,400,400,0,0
2596,2019-01-14,834,0,834,66,900,900,0,0
2597,2019-01-14,1815,0,1815,145,1960,1960,0,0
2598,2019-01-14,334,0,334,26,360,360,0,0
2599,2019-01-14,565,0,565,45,610,610,0,0
2600,2019-01-14,741,0,741,59,800,800,0,0
2601,2019-01-14,297,0,297,23,320,320,0,0
2602,2019-01-14,1241,0,1241,99,1340,1340,0,0
2603,2019-01-14,741,0,741,59,800,800,0,0
2604,2019-01-14,593,0,593,47,640,640,0,0
2605,2019-01-14,926,0,926,74,1000,1000,0,0
2606,2019-01-14,306,0,306,24,330,330,0,0
2607,2019-01-14,686,0,686,54,740,740,0,0
2608,2019-01-14,593,0,593,47,640,640,0,0
2609,2019-01-14,1371,0,1371,109,1480,1480,0,0
2610,2019-01-14,880,0,880,70,950,950,0,0
2611,2019-01-14,575,0,575,45,620,620,0,0
2612,2019-01-14,723,0,723,57,780,780,0,0
2613,2019-01-14,1075,0,1075,85,1160,1160,0,0
2614,2019-01-14,519,0,519,41,560,560,0,0
2615,2019-01-14,519,0,519,41,560,560,0,0
2616,2019-01-14,389,0,389,31,420,420,0,0
2617,2019-01-14,982,0,982,78,1060,1060,0,0
2618,2019-01-14,815,0,815,65,880,880,0,0
2619,2019-01-14,760,0,760,60,820,820,0,0
2620,2019-01-14,823,0,823,57,880,880,0,0
2621,2019-01-14,751,0,751,59,810,810,0,0
2622,2019-01-15,639,0,639,51,690,690,0,0
2623,2019-01-15,482,0,482,38,520,520,0,0
2624,2019-01-15,621,0,621,49,670,670,0,0
2625,2019-01-15,463,0,463,37,500,500,0,0
2626,2019-01-15,47,0,47,3,50,50,0,0
2627,2019-01-15,1204,0,1204,96,1300,1300,0,0
2628,2019-01-15,163,0,163,12,175,175,0,0
2629,2019-01-15,741,0,741,59,800,800,0,0
2630,2019-01-15,139,0,139,11,150,150,0,0
2631,2019-01-15,371,0,371,29,400,0,400,0
2632,2019-01-15,352,0,352,28,380,380,0,0
2633,2019-01-15,371,0,371,29,400,400,0,0
2634,2019-01-15,269,0,269,21,290,290,0,0
2635,2019-01-15,825,0,825,65,890,890,0,0
2636,2019-01-15,348,0,348,27,375,375,0,0
2637,2019-01-15,825,0,825,65,890,890,0,0
2638,2019-01-15,1186,0,1186,94,1280,1280,0,0
2639,2019-01-16,302,-64,238,18,256,256,0,0
2640,2019-01-16,473,0,473,37,510,510,0,0
2641,2019-01-16,908,0,908,72,980,980,0,0
2642,2019-01-16,519,0,519,41,560,560,0,0
2643,2019-01-16,704,0,704,56,760,760,0,0
2644,2019-01-16,593,0,593,47,640,640,0,0
2645,2019-01-16,963,0,963,77,1040,1040,0,0
2646,2019-01-16,908,0,908,72,980,980,0,0
2647,2019-01-16,334,0,334,26,360,360,0,0
2648,2019-01-16,1139,0,1139,91,1230,1230,0,0
2649,2019-01-16,639,0,639,51,690,690,0,0
2650,2019-01-16,250,0,250,20,270,270,0,0
2651,2019-01-16,501,0,501,39,540,540,0,0
2652,2019-01-16,1223,0,1223,97,1320,1320,0,0
2653,2019-01-16,538,0,538,42,580,580,0,0
2654,2019-01-16,2157,-231,1926,153,2079,2079,0,0
2655,2019-01-16,389,0,389,31,420,420,0,0
2656,2019-01-16,899,0,899,71,970,970,0,0
2657,2019-01-16,1399,0,1399,111,1510,1510,0,0
2658,2019-01-16,797,0,797,63,860,860,0,0
2659,2019-01-16,982,0,982,78,1060,1060,0,0
2660,2019-01-16,547,0,547,43,590,590,0,0
2661,2019-01-16,315,0,315,25,340,340,0,0
2662,2019-01-16,510,0,510,40,550,550,0,0
2663,2019-01-16,593,0,593,47,640,640,0,0
2664,2019-01-16,371,0,371,29,400,400,0,0
2665,2019-01-16,862,0,862,68,930,930,0,0
2666,2019-01-16,232,0,232,18,250,250,0,0
2667,2019-01-16,815,0,815,65,880,880,0,0
2668,2019-01-16,473,0,473,37,510,510,0,0
2669,2019-01-16,1139,0,1139,91,1230,1230,0,0
2670,2019-01-16,778,0,778,62,840,840,0,0
2671,2019-01-16,259,0,259,11,270,270,0,0
2672,2019-01-16,241,0,241,19,260,260,0,0
2673,2019-01-16,269,0,269,21,290,290,0,0
2674,2019-01-16,899,0,899,71,970,970,0,0
2675,2019-01-16,1288,0,1288,102,1390,0,1390,0
2676,2019-01-16,426,0,426,34,460,460,0,0
2677,2019-01-16,445,0,445,35,480,480,0,0
2678,2019-01-16,852,0,852,68,920,920,0,0
2679,2019-01-16,399,0,399,31,430,430,0,0
2680,2019-01-16,889,0,889,71,960,960,0,0
2681,2019-01-16,389,0,389,31,420,420,0,0
2682,2019-01-16,1112,0,1112,88,1200,0,1200,0
2683,2019-01-16,186,0,186,14,200,200,0,0
2684,2019-01-16,473,0,473,37,510,510,0,0
2685,2019-01-16,528,0,528,42,570,570,0,0
2686,2019-01-16,547,0,547,43,590,590,0,0
2687,2019-01-16,749,0,749,51,800,800,0,0
2688,2019-01-16,463,0,463,37,500,500,0,0
2689,2019-01-16,788,0,788,62,850,850,0,0
2690,2019-01-16,593,0,593,47,640,640,0,0
2691,2019-01-16,482,0,482,38,520,520,0,0
2692,2019-01-16,1065,0,1065,85,1150,1150,0,0
2693,2019-01-16,556,0,556,44,600,600,0,0
2694,2019-01-16,343,0,343,27,370,370,0,0
2695,2019-01-16,1121,0,1121,89,1210,1210,0,0
2696,2019-01-16,1852,0,1852,148,2000,2000,0,0
2697,2019-01-16,926,0,926,74,1000,1000,0,0
2698,2019-01-16,167,0,167,13,180,180,0,0
2699,2019-01-16,788,0,788,62,850,850,0,0
2700,2019-01-16,760,0,760,60,820,820,0,0
2701,2019-01-16,528,0,528,42,570,570,0,0
2702,2019-01-16,482,0,482,38,520,520,0,0
2703,2019-01-16,584,0,584,46,630,630,0,0
2704,2019-01-16,695,0,695,55,750,750,0,0
2705,2019-01-16,612,0,612,48,660,660,0,0
2706,2019-01-16,908,0,908,72,980,980,0,0
2707,2019-01-16,908,0,908,72,980,980,0,0
2708,2019-01-16,510,0,510,40,550,550,0,0
2709,2019-01-16,426,0,426,34,460,460,0,0
2710,2019-01-16,862,0,862,68,930,930,0,0
2711,2019-01-16,278,0,278,22,300,300,0,0
2712,2019-01-16,2000,0,2000,160,2160,2160,0,0
2713,2019-01-16,1477,0,1477,118,1595,1595,0,0
2714,2019-01-16,1158,0,1158,92,1250,1250,0,0
2715,2019-01-16,913,-194,719,57,776,776,0,0
2716,2019-01-16,1195,0,1195,95,1290,1290,0,0
2717,2019-01-16,149,0,149,11,160,160,0,0
2718,2019-01-17,288,0,288,22,310,310,0,0
2719,2019-01-17,232,0,232,18,250,250,0,0
2720,2019-01-17,602,0,602,48,650,650,0,0
2721,2019-01-17,908,0,908,72,980,980,0,0
2722,2019-01-17,306,0,306,24,330,330,0,0
2723,2019-01-17,269,0,269,21,290,290,0,0
2724,2019-01-17,389,0,389,31,420,420,0,0
2725,2019-01-17,556,0,556,44,600,600,0,0
2726,2019-01-17,945,0,945,75,1020,1020,0,0
2727,2019-01-17,1815,0,1815,145,1960,1960,0,0
2728,2019-01-17,1815,0,1815,145,1960,1960,0,0
2729,2019-01-17,825,0,825,65,890,890,0,0
2730,2019-01-17,463,0,463,37,500,500,0,0
2731,2019-01-17,1042,0,1042,83,1125,1125,0,0
2732,2019-01-17,1815,0,1815,145,1960,1960,0,0
2733,2019-01-17,251,0,251,19,270,270,0,0
2734,2019-01-17,954,0,954,76,1030,1030,0,0
2735,2019-01-17,213,0,213,17,230,230,0,0
2736,2019-01-17,260,0,260,20,280,280,0,0
2737,2019-01-17,1815,0,1815,145,1960,1960,0,0
2738,2019-01-17,788,0,788,62,850,850,0,0
2739,2019-01-17,908,0,908,72,980,980,0,0
2740,2019-01-17,1175,0,1175,85,1260,1260,0,0
2741,2019-01-17,908,0,908,72,980,980,0,0
2742,2019-01-17,399,0,399,31,430,430,0,0
2743,2019-01-17,1612,0,1612,128,1740,1740,0,0
2744,2019-01-17,806,0,806,64,870,870,0,0
2745,2019-01-17,1158,0,1158,92,1250,1250,0,0
2746,2019-01-17,352,0,352,28,380,380,0,0
2747,2019-01-17,371,0,371,29,400,400,0,0
2748,2019-01-17,667,0,667,53,720,720,0,0
2749,2019-01-17,1288,0,1288,102,1390,1390,0,0
2750,2019-01-17,352,0,352,28,380,380,0,0
2751,2019-01-17,491,0,491,39,530,530,0,0
2752,2019-01-17,102,0,102,8,110,110,0,0
2753,2019-01-17,436,0,436,34,470,470,0,0
2754,2019-01-17,260,0,260,20,280,280,0,0
2755,2019-01-17,593,0,593,47,640,640,0,0
2756,2019-01-17,2251,0,2251,179,2430,2430,0,0
2757,2019-01-17,649,0,649,51,700,700,0,0
2758,2019-01-17,612,0,612,48,660,660,0,0
2759,2019-01-17,204,0,204,16,220,220,0,0
2760,2019-01-17,658,0,658,52,710,710,0,0
2761,2019-01-17,1815,0,1815,145,1960,1960,0,0
2762,2019-01-17,454,0,454,36,490,490,0,0
2763,2019-01-17,602,0,602,48,650,650,0,0
2764,2019-01-17,417,0,417,33,450,450,0,0
2765,2019-01-17,1481,0,1481,109,1590,1590,0,0
2766,2019-01-17,519,0,519,41,560,560,0,0
2767,2019-01-17,908,0,908,72,980,980,0,0
2768,2019-01-17,751,0,751,59,810,810,0,0
2769,2019-01-17,806,0,806,64,870,870,0,0
2770,2019-01-17,426,0,426,34,460,0,460,0
2771,2019-01-17,788,0,788,62,850,850,0,0
2772,2019-01-17,788,0,788,62,850,850,0,0
2773,2019-01-17,788,0,788,62,850,850,0,0
2774,2019-01-17,1065,0,1065,85,1150,1150,0,0
2775,2019-01-17,862,0,862,68,930,930,0,0
2776,2019-01-17,463,0,463,37,500,500,0,0
2777,2019-01-17,370,0,370,20,390,390,0,0
2778,2019-01-17,741,0,741,59,800,800,0,0
2779,2019-01-17,482,0,482,38,520,520,0,0
2780,2019-01-17,339,-72,267,21,288,288,0,0
2781,2019-01-17,352,0,352,28,380,380,0,0
2782,2019-01-17,315,0,315,25,340,340,0,0
2783,2019-01-17,1936,0,1936,154,2090,2090,0,0
2784,2019-01-17,1047,0,1047,83,1130,1130,0,0
2785,2019-01-17,925,0,925,65,990,990,0,0
2786,2019-01-17,482,0,482,38,520,520,0,0
2787,2019-01-17,232,0,232,18,250,250,0,0
2788,2019-01-17,990,0,990,70,1060,1060,0,0
2789,2019-01-17,371,0,371,29,400,400,0,0
2790,2019-01-17,547,0,547,43,590,590,0,0
2791,2019-01-17,973,0,973,77,1050,1050,0,0
2792,2019-01-17,583,0,583,37,620,620,0,0
2793,2019-01-17,445,0,445,35,480,480,0,0
2794,2019-01-17,788,0,788,62,850,850,0,0
2795,2019-01-17,788,0,788,62,850,850,0,0
2796,2019-01-17,323,0,323,17,340,340,0,0
2797,2019-01-17,510,0,510,40,550,550,0,0
2798,2019-01-17,501,0,501,39,540,540,0,0
2799,2019-01-17,1065,0,1065,85,1150,1150,0,0
2800,2019-01-17,908,0,908,72,980,980,0,0
2801,2019-01-17,592,0,592,38,630,630,0,0
2802,2019-01-17,843,0,843,67,910,910,0,0
2803,2019-01-17,2723,0,2723,217,2940,2940,0,0
2804,2019-01-17,306,0,306,24,330,330,0,0
2805,2019-01-17,556,0,556,44,600,600,0,0
2806,2019-01-17,343,0,343,27,370,370,0,0
2807,2019-01-17,1297,0,1297,103,1400,0,1400,0
2808,2019-01-17,621,0,621,49,670,670,0,0
2809,2019-01-17,1973,0,1973,157,2130,2130,0,0
2810,2019-01-17,1093,0,1093,87,1180,1180,0,0
2811,2019-01-17,1001,0,1001,79,1080,1080,0,0
2812,2019-01-17,334,0,334,26,360,360,0,0
2813,2019-01-17,667,0,667,53,720,720,0,0
2814,2019-01-17,1084,0,1084,86,1170,1170,0,0
2815,2019-01-17,325,0,325,25,350,350,0,0
2816,2019-01-17,1111,0,1111,79,1190,1190,0,0
2817,2019-01-17,306,0,306,24,330,330,0,0
2818,2019-01-17,1518,0,1518,112,1630,0,1630,0
2819,2019-01-17,167,0,167,13,180,180,0,0
2820,2019-01-17,473,0,473,37,510,510,0,0
2821,2019-01-17,843,0,843,67,910,910,0,0
2822,2019-01-18,176,0,176,14,190,190,0,0
2823,2019-01-18,1815,0,1815,145,1960,1960,0,0
2824,2019-01-18,371,0,371,29,400,400,0,0
2825,2019-01-18,769,0,769,61,830,830,0,0
2826,2019-01-18,945,0,945,75,1020,1020,0,0
2827,2019-01-18,176,0,176,14,190,190,0,0
2828,2019-01-18,805,0,805,55,860,860,0,0
2829,2019-01-18,695,0,695,55,750,750,0,0
2830,2019-01-18,389,0,389,31,420,420,0,0
2831,2019-01-18,1436,0,1436,114,1550,1550,0,0
2832,2019-01-18,371,0,371,29,400,400,0,0
2833,2019-01-18,399,0,399,31,430,430,0,0
2834,2019-01-18,1686,0,1686,134,1820,1820,0,0
2835,2019-01-18,538,0,538,42,580,580,0,0
2836,2019-01-18,1247,0,1247,73,1320,1320,0,0
2837,2019-01-18,612,0,612,48,660,660,0,0
2838,2019-01-18,1871,0,1871,149,2020,2020,0,0
2839,2019-01-18,1167,0,1167,93,1260,1260,0,0
2840,2019-01-18,723,0,723,57,780,780,0,0
2841,2019-01-18,408,0,408,32,440,440,0,0
2842,2019-01-18,806,0,806,64,870,870,0,0
2843,2019-01-18,1075,0,1075,85,1160,1160,0,0
2844,2019-01-18,1352,0,1352,108,1460,1460,0,0
2845,2019-01-18,1463,0,1463,117,1580,1580,0,0
2846,2019-01-18,1815,0,1815,145,1960,1960,0,0
2847,2019-01-18,1695,0,1695,135,1830,1830,0,0
2848,2019-01-18,547,0,547,43,590,590,0,0
2849,2019-01-18,1815,0,1815,145,1960,1960,0,0
2850,2019-01-18,1815,0,1815,145,1960,1960,0,0
2851,2019-01-18,149,0,149,11,160,160,0,0
2852,2019-01-18,167,0,167,13,180,180,0,0
2853,2019-01-18,1028,0,1028,82,1110,1110,0,0
2854,2019-01-18,250,0,250,20,270,270,0,0
2855,2019-01-18,473,0,473,37,510,510,0,0
2856,2019-01-18,288,0,288,22,310,310,0,0
2857,2019-01-18,732,0,732,58,790,790,0,0
2858,2019-01-18,2251,0,2251,179,2430,2430,0,0
2859,2019-01-18,278,0,278,22,300,300,0,0
2860,2019-01-18,1584,0,1584,126,1710,1710,0,0
2861,2019-01-18,538,0,538,42,580,580,0,0
2862,2019-01-18,806,0,806,64,870,870,0,0
2863,2019-01-18,417,0,417,33,450,450,0,0
2864,2019-01-18,260,0,260,20,280,280,0,0
2865,2019-01-18,713,0,713,57,770,770,0,0
2866,2019-01-18,713,0,713,57,770,770,0,0
2867,2019-01-18,554,0,554,26,580,580,0,0
2868,2019-01-18,945,0,945,75,1020,1020,0,0
2869,2019-01-18,862,0,862,68,930,930,0,0
2870,2019-01-18,2093,0,2093,167,2260,2260,0,0
2871,2019-01-18,1047,0,1047,83,1130,1130,0,0
2872,2019-01-18,278,0,278,22,300,300,0,0
2873,2019-01-18,380,0,380,30,410,410,0,0
2874,2019-01-18,936,0,936,74,1010,1010,0,0
2875,2019-01-18,1223,0,1223,97,1320,1320,0,0
2876,2019-01-18,936,0,936,74,1010,1010,0,0
2877,2019-01-18,232,0,232,18,250,250,0,0
2878,2019-01-18,1064,0,1064,76,1140,1140,0,0
2879,2019-01-18,277,0,277,13,290,290,0,0
2880,2019-01-18,751,0,751,59,810,810,0,0
2881,2019-01-18,852,0,852,68,920,920,0,0
2882,2019-01-18,519,0,519,41,560,560,0,0
2883,2019-01-18,704,0,704,56,760,760,0,0
2884,2019-01-18,713,0,713,57,770,770,0,0
2885,2019-01-18,491,0,491,39,530,530,0,0
2886,2019-01-18,676,0,676,54,730,730,0,0
2887,2019-01-18,371,0,371,29,400,400,0,0
2888,2019-01-18,565,0,565,45,610,610,0,0
2889,2019-01-18,908,0,908,72,980,980,0,0
2890,2019-01-18,908,0,908,72,980,980,0,0
2891,2019-01-18,473,0,473,37,510,510,0,0
2892,2019-01-18,1028,0,1028,82,1110,1110,0,0
2893,2019-01-18,399,0,399,31,430,430,0,0
2894,2019-01-18,1667,0,1667,133,1800,1800,0,0
2895,2019-01-18,408,0,408,32,440,440,0,0
2896,2019-01-18,1334,0,1334,106,1440,1440,0,0
2897,2019-01-18,1732,0,1732,138,1870,1870,0,0
2898,2019-01-18,667,0,667,53,720,720,0,0
2899,2019-01-18,528,0,528,42,570,570,0,0
2900,2019-01-18,426,0,426,34,460,460,0,0
2901,2019-01-18,871,0,871,69,940,940,0,0
2902,2019-01-18,862,0,862,68,930,930,0,0
2903,2019-01-18,1280,-272,1008,80,1088,1088,0,0
2904,2019-01-18,232,0,232,18,250,250,0,0
2905,2019-01-18,1713,0,1713,137,1850,1850,0,0
2906,2019-01-18,1575,0,1575,125,1700,1700,0,0
2907,2019-01-18,436,0,436,34,470,470,0,0
2908,2019-01-18,1575,0,1575,125,1700,1700,0,0
2909,2019-01-18,1528,0,1528,122,1650,1650,0,0
2910,2019-01-18,1127,0,1127,63,1190,1190,0,0
2911,2019-01-18,926,0,926,74,1000,1000,0,0
2912,2019-01-18,269,0,269,21,290,290,0,0
2913,2019-01-18,788,0,788,62,850,850,0,0
2914,2019-01-18,149,0,149,11,160,160,0,0
2915,2019-01-18,460,0,460,10,470,470,0,0
2916,2019-01-18,232,0,232,18,250,250,0,0
2917,2019-01-18,278,0,278,22,300,300,0,0
2918,2019-01-18,288,0,288,22,310,310,0,0
2919,2019-01-18,232,0,232,18,250,250,0,0
2920,2019-01-18,628,0,628,32,660,660,0,0
2921,2019-01-18,408,0,408,32,440,440,0,0
2922,2019-01-18,639,0,639,51,690,690,0,0
2923,2019-01-18,422,0,422,33,455,455,0,0
2924,2019-01-18,649,0,649,51,700,700,0,0
2925,2019-01-18,889,0,889,71,960,960,0,0
2926,2019-01-18,1121,0,1121,89,1210,1210,0,0
2927,2019-01-18,1121,0,1121,89,1210,1210,0,0
2928,2019-01-18,760,0,760,60,820,820,0,0
2929,2019-01-18,747,-80,667,53,720,720,0,0
2930,2019-01-18,389,0,389,31,420,420,0,0
2931,2019-01-18,269,0,269,21,290,290,0,0
2932,2019-01-18,788,0,788,62,850,850,0,0
2933,2019-01-18,741,0,741,59,800,800,0,0
2934,2019-01-18,1065,0,1065,85,1150,1150,0,0
2935,2019-01-18,149,0,149,11,160,160,0,0
2936,2019-01-18,547,0,547,43,590,590,0,0
2937,2019-01-18,704,0,704,56,760,760,0,0
2938,2019-01-18,186,0,186,14,200,200,0,0
2939,2019-01-18,2593,0,2593,207,2800,2800,0,0
2940,2019-01-18,1176,0,1176,94,1270,1270,0,0
2941,2019-01-18,538,0,538,42,580,580,0,0
2942,2019-01-18,1232,0,1232,98,1330,1330,0,0
2943,2019-01-18,686,0,686,54,740,740,0,0
2944,2019-01-18,695,0,695,55,750,750,0,0
2945,2019-01-18,1815,0,1815,145,1960,1960,0,0
2946,2019-01-18,926,0,926,74,1000,1000,0,0
2947,2019-01-18,149,0,149,11,160,160,0,0
2948,2019-01-18,-788,0,-788,-62,-850,-850,0,0
2949,2019-01-18,112,0,112,8,120,120,0,0
2950,2019-01-18,380,0,380,30,410,410,0,0
2951,2019-01-18,1149,0,1149,91,1240,1240,0,0
2952,2019-01-18,769,0,769,61,830,830,0,0
2953,2019-01-18,362,0,362,28,390,390,0,0
2954,2019-01-18,334,0,334,26,360,360,0,0
2955,2019-01-18,1575,0,1575,125,1700,1700,0,0
2956,2019-01-18,1575,0,1575,125,1700,1700,0,0
2957,2019-01-18,788,0,788,62,850,850,0,0
2958,2019-01-18,1306,0,1306,104,1410,1410,0,0
2959,2019-01-18,1575,0,1575,125,1700,1700,0,0
2960,2019-01-18,1213,0,1213,97,1310,1310,0,0
2961,2019-01-18,371,0,371,29,400,400,0,0
2962,2019-01-18,686,0,686,54,740,740,0,0
2963,2019-01-18,675,0,675,45,720,720,0,0
2964,2019-01-18,547,0,547,43,590,590,0,0
2965,2019-01-18,1649,0,1649,131,1780,1780,0,0
2966,2019-01-18,222,0,222,8,230,230,0,0
2967,2019-01-18,1815,0,1815,145,1960,0,1960,0
2968,2019-01-18,491,0,491,39,530,530,0,0
2969,2019-01-18,1065,0,1065,85,1150,1150,0,0
2970,2019-01-19,352,0,352,28,380,380,0,0
2971,2019-01-19,463,0,463,37,500,500,0,0
2972,2019-01-19,584,0,584,46,630,630,0,0
2973,2019-01-19,815,0,815,65,880,880,0,0
2974,2019-01-19,510,0,510,40,550,550,0,0
2975,2019-01-19,1499,0,1499,111,1610,1610,0,0
2976,2019-01-19,167,0,167,13,180,180,0,0
2977,2019-01-19,556,0,556,44,600,600,0,0
2978,2019-01-19,1815,0,1815,145,1960,1960,0,0
2979,2019-01-19,426,0,426,34,460,460,0,0
2980,2019-01-19,1676,0,1676,134,1810,1810,0,0
2981,2019-01-19,556,0,556,44,600,600,0,0
2982,2019-01-19,908,0,908,72,980,980,0,0
2983,2019-01-19,222,0,222,8,230,230,0,0
2984,2019-01-19,879,0,879,61,940,940,0,0
2985,2019-01-19,1417,0,1417,113,1530,1530,0,0
2986,2019-01-19,945,0,945,75,1020,1020,0,0
2987,2019-01-19,519,0,519,41,560,560,0,0
2988,2019-01-19,871,0,871,69,940,940,0,0
2989,2019-01-19,908,0,908,72,980,980,0,0
2990,2019-01-19,278,0,278,22,300,300,0,0
2991,2019-01-19,834,0,834,66,900,900,0,0
2992,2019-01-19,528,0,528,42,570,570,0,0
2993,2019-01-19,1010,0,1010,80,1090,1090,0,0
2994,2019-01-19,149,0,149,11,160,160,0,0
2995,2019-01-19,908,0,908,72,980,980,0,0
2996,2019-01-19,1815,0,1815,145,1960,1960,0,0
2997,2019-01-19,1815,0,1815,145,1960,1960,0,0
2998,2019-01-19,834,0,834,66,900,900,0,0
2999,2019-01-19,825,0,825,65,890,890,0,0
3000,2019-01-19,491,0,491,39,530,530,0,0
3001,2019-01-19,1223,0,1223,97,1320,1320,0,0
3002,2019-01-19,167,0,167,13,180,180,0,0
3003,2019-01-19,370,0,370,20,390,390,0,0
3004,2019-01-19,1815,0,1815,145,1960,1960,0,0
3005,2019-01-19,269,0,269,21,290,290,0,0
3006,2019-01-19,908,0,908,72,980,980,0,0
3007,2019-01-19,908,0,908,72,980,980,0,0
3008,2019-01-19,945,0,945,75,1020,1020,0,0
3009,2019-01-19,139,0,139,11,150,150,0,0
3010,2019-01-19,112,0,112,8,120,120,0,0
3011,2019-01-19,982,0,982,78,1060,1060,0,0
3012,2019-01-19,686,0,686,54,740,740,0,0
3013,2019-01-19,260,0,260,20,280,280,0,0
3014,2019-01-19,260,0,260,20,280,280,0,0
3015,2019-01-19,1399,0,1399,111,1510,1510,0,0
3016,2019-01-19,102,0,102,8,110,110,0,0
3017,2019-01-19,723,0,723,57,780,780,0,0
3018,2019-01-19,277,0,277,13,290,290,0,0
3019,2019-01-19,1519,0,1519,121,1640,1640,0,0
3020,2019-01-19,510,0,510,40,550,550,0,0
3021,2019-01-19,167,0,167,13,180,180,0,0
3022,2019-01-19,741,0,741,59,800,800,0,0
3023,2019-01-19,232,0,232,18,250,250,0,0
3024,2019-01-19,565,0,565,45,610,610,0,0
3025,2019-01-19,704,0,704,56,760,760,0,0
3026,2019-01-19,445,0,445,35,480,480,0,0
3027,2019-01-19,278,0,278,22,300,300,0,0
3028,2019-01-19,269,0,269,21,290,290,0,0
3029,2019-01-19,843,0,843,67,910,910,0,0
3030,2019-01-19,1306,0,1306,104,1410,1410,0,0
3031,2019-01-19,1121,0,1121,89,1210,1210,0,0
3032,2019-01-19,278,0,278,22,300,300,0,0
3033,2019-01-19,371,0,371,29,400,400,0,0
3034,2019-01-19,-371,0,-371,-29,-400,-400,0,0
3035,2019-01-19,417,0,417,33,450,450,0,0
3036,2019-01-19,658,0,658,52,710,710,0,0
3037,2019-01-19,683,0,683,37,720,720,0,0
3038,2019-01-19,2722,0,2722,218,2940,0,2940,0
3039,2019-01-19,723,0,723,57,780,780,0,0
3040,2019-01-19,713,0,713,57,770,770,0,0
3041,2019-01-19,241,0,241,19,260,260,0,0
3042,2019-01-19,278,0,278,22,300,300,0,0
3043,2019-01-19,575,0,575,45,620,620,0,0
3044,2019-01-19,2010,0,2010,160,2170,2170,0,0
3045,2019-01-19,371,0,371,29,400,400,0,0
3046,2019-01-19,1277,0,1277,93,1370,1370,0,0
3047,2019-01-19,2685,0,2685,205,2890,2890,0,0
3048,2019-01-19,908,0,908,72,980,980,0,0
3049,2019-01-19,936,0,936,74,1010,1010,0,0
3050,2019-01-19,1408,0,1408,112,1520,1520,0,0
3051,2019-01-19,982,0,982,78,1060,1060,0,0
3052,2019-01-19,463,0,463,37,500,500,0,0
3053,2019-01-19,167,0,167,13,180,180,0,0
3054,2019-01-19,732,0,732,58,790,790,0,0
3055,2019-01-19,408,0,408,32,440,440,0,0
3056,2019-01-19,1815,0,1815,145,1960,1960,0,0
3057,2019-01-19,602,0,602,48,650,650,0,0
3058,2019-01-19,704,0,704,56,760,760,0,0
3059,2019-01-19,667,0,667,53,720,720,0,0
3060,2019-01-19,713,0,713,57,770,770,0,0
3061,2019-01-19,260,0,260,20,280,280,0,0
3062,2019-01-19,269,0,269,21,290,290,0,0
3063,2019-01-19,408,0,408,32,440,440,0,0
3064,2019-01-19,426,0,426,34,460,460,0,0
3065,2019-01-19,788,0,788,62,850,850,0,0
3066,2019-01-19,741,0,741,59,800,800,0,0
3067,2019-01-19,945,0,945,75,1020,1020,0,0
3068,2019-01-19,538,0,538,42,580,580,0,0
3069,2019-01-19,121,0,121,9,130,130,0,0
3070,2019-01-19,1232,0,1232,98,1330,1330,0,0
3071,2019-01-19,667,0,667,53,720,720,0,0
3072,2019-01-19,973,0,973,77,1050,1050,0,0
3073,2019-01-19,973,0,973,77,1050,1050,0,0
3074,2019-01-19,616,0,616,14,630,630,0,0
3075,2019-01-19,667,0,667,53,720,720,0,0
3076,2019-01-19,436,0,436,34,470,470,0,0
3077,2019-01-19,408,0,408,32,440,440,0,0
3078,2019-01-19,371,0,371,29,400,400,0,0
3079,2019-01-19,1491,0,1491,119,1610,0,1610,0
3080,2019-01-19,612,0,612,48,660,660,0,0
3081,2019-01-19,334,0,334,26,360,360,0,0
3082,2019-01-19,278,0,278,22,300,300,0,0
3083,2019-01-19,352,0,352,28,380,380,0,0
3084,2019-01-19,667,0,667,53,720,720,0,0
3085,2019-01-19,917,0,917,73,990,990,0,0
3086,2019-01-19,389,0,389,31,420,420,0,0
3087,2019-01-19,167,0,167,13,180,180,0,0
3088,2019-01-19,426,0,426,34,460,460,0,0
3089,2019-01-19,1575,0,1575,125,1700,1700,0,0
3090,2019-01-19,1241,0,1241,99,1340,1340,0,0
3091,2019-01-19,519,0,519,41,560,560,0,0
3092,2019-01-19,612,0,612,48,660,660,0,0
3093,2019-01-19,269,0,269,21,290,290,0,0
3094,2019-01-19,445,0,445,35,480,480,0,0
3095,2019-01-19,1047,0,1047,83,1130,1130,0,0
3096,2019-01-19,519,0,519,41,560,560,0,0
3097,2019-01-19,1389,0,1389,111,1500,0,1500,0
3098,2019-01-19,1667,0,1667,133,1800,1800,0,0
3099,2019-01-19,630,0,630,50,680,680,0,0
3100,2019-01-19,797,0,797,63,860,860,0,0
3101,2019-01-19,621,0,621,49,670,670,0,0
3102,2019-01-19,1371,0,1371,109,1480,1480,0,0
3103,2019-01-19,1371,0,1371,109,1480,1480,0,0
3104,2019-01-19,862,0,862,68,930,930,0,0
3105,2019-01-19,612,0,612,48,660,660,0,0
3106,2019-01-19,334,0,334,26,360,360,0,0
3107,2019-01-19,1815,0,1815,145,1960,1960,0,0
3108,2019-01-19,778,0,778,62,840,840,0,0
3109,2019-01-19,788,0,788,62,850,850,0,0
3110,2019-01-19,732,0,732,58,790,790,0,0
3111,2019-01-19,399,0,399,31,430,430,0,0
3112,2019-01-19,630,0,630,50,680,680,0,0
3113,2019-01-19,1334,0,1334,106,1440,1440,0,0
3114,2019-01-19,1334,0,1334,106,1440,1440,0,0
3115,2019-01-19,241,0,241,19,260,260,0,0
3116,2019-01-19,1852,0,1852,148,2000,2000,0,0
3117,2019-01-19,1306,0,1306,104,1410,1410,0,0
3118,2019-01-19,880,0,880,70,950,950,0,0
3119,2019-01-19,788,0,788,62,850,850,0,0
3120,2019-01-19,788,0,788,62,850,850,0,0
3121,2019-01-19,788,0,788,62,850,850,0,0
3122,2019-01-19,788,0,788,62,850,850,0,0
3123,2019-01-19,788,0,788,62,850,850,0,0
3124,2019-01-19,482,0,482,38,520,520,0,0
3125,2019-01-19,1575,0,1575,125,1700,1700,0,0
3126,2019-01-19,695,0,695,55,750,750,0,0
3127,2019-01-19,1852,0,1852,148,2000,2000,0,0
3128,2019-01-19,1575,0,1575,125,1700,1700,0,0
3129,2019-01-19,1334,0,1334,106,1440,1440,0,0
3130,2019-01-19,501,0,501,39,540,540,0,0
3131,2019-01-19,1065,0,1065,85,1150,0,1150,0
3132,2019-01-20,445,0,445,35,480,480,0,0
3133,2019-01-20,908,0,908,72,980,980,0,0
3134,2019-01-20,288,0,288,22,310,310,0,0
3135,2019-01-20,501,0,501,39,540,540,0,0
3136,2019-01-20,371,0,371,29,400,400,0,0
3137,2019-01-20,186,0,186,14,200,200,0,0
3138,2019-01-20,954,0,954,76,1030,1030,0,0
3139,2019-01-20,213,0,213,17,230,230,0,0
3140,2019-01-20,260,0,260,20,280,280,0,0
3141,2019-01-20,908,0,908,72,980,980,0,0
3142,2019-01-20,417,0,417,33,450,450,0,0
3143,2019-01-20,491,0,491,39,530,530,0,0
3144,2019-01-20,584,0,584,46,630,630,0,0
3145,2019-01-20,1797,0,1797,143,1940,1940,0,0
3146,2019-01-20,260,0,260,20,280,280,0,0
3147,2019-01-20,302,-64,238,18,256,256,0,0
3148,2019-01-20,1519,0,1519,121,1640,1640,0,0
3149,2019-01-20,315,0,315,25,340,340,0,0
3150,2019-01-20,667,0,667,53,720,720,0,0
3151,2019-01-20,408,0,408,32,440,440,0,0
3152,2019-01-20,2019,0,2019,161,2180,2180,0,0
3153,2019-01-20,1204,0,1204,96,1300,1300,0,0
3154,2019-01-20,1815,0,1815,145,1960,1960,0,0
3155,2019-01-20,399,0,399,31,430,430,0,0
3156,2019-01-20,371,0,371,29,400,400,0,0
3157,2019-01-20,334,0,334,26,360,360,0,0
3158,2019-01-20,760,0,760,60,820,820,0,0
3159,2019-01-20,1112,0,1112,88,1200,1200,0,0
3160,2019-01-20,751,0,751,59,810,810,0,0
3161,2019-01-20,213,0,213,17,230,230,0,0
3162,2019-01-20,288,0,288,22,310,310,0,0
3163,2019-01-20,778,0,778,62,840,840,0,0
3164,2019-01-20,482,0,482,38,520,520,0,0
3165,2019-01-20,936,0,936,74,1010,1010,0,0
3166,2019-01-20,667,0,667,53,720,720,0,0
3167,2019-01-20,723,0,723,57,780,780,0,0
3168,2019-01-20,139,0,139,11,150,150,0,0
3169,2019-01-20,667,0,667,53,720,720,0,0
3170,2019-01-20,1167,0,1167,93,1260,1260,0,0
3171,2019-01-20,2399,0,2399,191,2590,2590,0,0
3172,2019-01-20,1047,0,1047,83,1130,1130,0,0
3173,2019-01-20,870,0,870,60,930,930,0,0
3174,2019-01-20,1815,0,1815,145,1960,1960,0,0
3175,2019-01-20,1102,0,1102,88,1190,1190,0,0
3176,2019-01-20,973,0,973,77,1050,1050,0,0
3177,2019-01-20,2223,0,2223,177,2400,2400,0,0
3178,2019-01-20,510,0,510,40,550,550,0,0
3179,2019-01-20,102,0,102,8,110,110,0,0
3180,2019-01-20,158,0,158,12,170,170,0,0
3181,2019-01-20,510,0,510,40,550,550,0,0
3182,2019-01-20,908,0,908,72,980,980,0,0
3183,2019-01-20,1954,0,1954,156,2110,2110,0,0
3184,2019-01-20,908,0,908,72,980,980,0,0
3185,2019-01-20,899,0,899,71,970,970,0,0
3186,2019-01-20,269,0,269,21,290,290,0,0
3187,2019-01-20,1417,0,1417,113,1530,1530,0,0
3188,2019-01-20,1815,0,1815,145,1960,1960,0,0
3189,2019-01-20,612,0,612,48,660,660,0,0
3190,2019-01-20,371,0,371,29,400,400,0,0
3191,2019-01-20,417,0,417,33,450,0,450,0
3192,2019-01-20,612,0,612,48,660,660,0,0
3193,2019-01-20,843,0,843,67,910,910,0,0
3194,2019-01-20,204,0,204,16,220,220,0,0
3195,2019-01-20,343,0,343,27,370,370,0,0
3196,2019-01-20,167,0,167,13,180,180,0,0
3197,2019-01-20,167,0,167,13,180,180,0,0
3198,2019-01-20,2102,0,2102,168,2270,2270,0,0
3199,2019-01-20,899,0,899,71,970,970,0,0
3200,2019-01-20,334,0,334,26,360,360,0,0
3201,2019-01-20,167,0,167,13,180,180,0,0
3202,2019-01-20,510,0,510,40,550,550,0,0
3203,2019-01-20,1278,0,1278,102,1380,1380,0,0
3204,2019-01-20,862,0,862,68,930,930,0,0
3205,2019-01-20,213,0,213,17,230,230,0,0
3206,2019-01-20,325,0,325,25,350,350,0,0
3207,2019-01-20,362,0,362,28,390,390,0,0
3208,2019-01-20,325,0,325,25,350,350,0,0
3209,2019-01-20,195,0,195,15,210,210,0,0
3210,2019-01-20,260,0,260,20,280,280,0,0
3211,2019-01-20,1112,0,1112,88,1200,1200,0,0
3212,2019-01-20,380,0,380,30,410,410,0,0
3213,2019-01-20,417,0,417,33,450,450,0,0
3214,2019-01-20,371,0,371,29,400,400,0,0
3215,2019-01-20,260,0,260,20,280,280,0,0
3216,2019-01-20,1251,0,1251,99,1350,1350,0,0
3217,2019-01-20,760,0,760,60,820,820,0,0
3218,2019-01-20,473,0,473,37,510,510,0,0
3219,2019-01-20,499,-106,393,31,424,424,0,0
3220,2019-01-20,658,0,658,52,710,710,0,0
3221,2019-01-20,260,0,260,20,280,280,0,0
3222,2019-01-20,870,0,870,60,930,930,0,0
3223,2019-01-20,847,-180,667,53,720,720,0,0
3224,2019-01-20,676,0,676,54,730,730,0,0
3225,2019-01-20,260,0,260,20,280,280,0,0
3226,2019-01-20,593,0,593,47,640,640,0,0
3227,2019-01-20,232,0,232,18,250,250,0,0
3228,2019-01-20,991,0,991,79,1070,1070,0,0
3229,2019-01-20,788,0,788,62,850,850,0,0
3230,2019-01-20,612,0,612,48,660,660,0,0
3231,2019-01-20,556,0,556,44,600,600,0,0
3232,2019-01-20,417,0,417,33,450,450,0,0
3233,2019-01-20,232,0,232,18,250,250,0,0
3234,2019-01-20,1575,0,1575,125,1700,1700,0,0
3235,2019-01-20,528,0,528,42,570,570,0,0
3236,2019-01-20,362,0,362,28,390,390,0,0
3237,2019-01-20,908,0,908,72,980,980,0,0
3238,2019-01-20,1213,0,1213,97,1310,1310,0,0
3239,2019-01-20,426,0,426,34,460,460,0,0
3240,2019-01-20,788,0,788,62,850,850,0,0
3241,2019-01-20,112,0,112,8,120,120,0,0
3242,2019-01-20,130,0,130,10,140,140,0,0
3243,2019-01-20,908,0,908,72,980,980,0,0
3244,2019-01-20,408,0,408,32,440,440,0,0
3245,2019-01-20,158,0,158,12,170,170,0,0
3246,2019-01-20,1306,0,1306,104,1410,1410,0,0
3247,2019-01-20,667,0,667,53,720,720,0,0
3248,2019-01-20,1417,0,1417,113,1530,1530,0,0
3249,2019-01-20,732,0,732,58,790,790,0,0
3250,2019-01-20,1600,-340,1260,100,1360,1360,0,0
3251,2019-01-20,788,0,788,62,850,850,0,0
3252,2019-01-20,788,0,788,62,850,850,0,0
3253,2019-01-20,788,0,788,62,850,850,0,0
3254,2019-01-21,1352,0,1352,108,1460,1460,0,0
3255,2019-01-21,1815,0,1815,145,1960,1960,0,0
3256,2019-01-21,1343,0,1343,107,1450,1450,0,0
3257,2019-01-21,296,0,296,14,310,310,0,0
3258,2019-01-21,538,0,538,42,580,580,0,0
3259,2019-01-21,825,0,825,65,890,890,0,0
3260,2019-01-21,223,0,223,17,240,240,0,0
3261,2019-01-21,426,0,426,34,460,460,0,0
3262,2019-01-21,408,0,408,32,440,440,0,0
3263,2019-01-21,1592,0,1592,118,1710,1710,0,0
3264,2019-01-21,732,0,732,58,790,790,0,0
3265,2019-01-21,547,0,547,43,590,590,0,0
3266,2019-01-21,167,0,167,13,180,180,0,0
3267,2019-01-21,463,0,463,37,500,500,0,0
3268,2019-01-21,1982,0,1982,158,2140,2140,0,0
3269,2019-01-21,880,0,880,70,950,950,0,0
3270,2019-01-21,1149,0,1149,91,1240,1240,0,0
3271,2019-01-21,343,0,343,27,370,370,0,0
3272,2019-01-21,510,0,510,40,550,550,0,0
3273,2019-01-21,371,0,371,29,400,400,0,0
3274,2019-01-21,371,0,371,29,400,400,0,0
3275,2019-01-21,399,0,399,31,430,430,0,0
3276,2019-01-21,916,0,916,64,980,980,0,0
3277,2019-01-21,260,0,260,20,280,280,0,0
3278,2019-01-21,260,0,260,20,280,280,0,0
3279,2019-01-21,334,0,334,26,360,360,0,0
3280,2019-01-21,325,0,325,25,350,350,0,0
3281,2019-01-21,121,0,121,9,130,130,0,0
3282,2019-01-21,195,0,195,15,210,210,0,0
3283,2019-01-21,-195,0,-195,-15,-210,-210,0,0
3284,2019-01-21,982,0,982,78,1060,1060,0,0
3285,2019-01-21,334,0,334,26,360,360,0,0
3286,2019-01-21,602,0,602,48,650,650,0,0
3287,2019-01-21,232,0,232,18,250,250,0,0
3288,2019-01-21,362,0,362,28,390,390,0,0
3289,2019-01-21,269,0,269,21,290,290,0,0
3290,2019-01-21,325,0,325,25,350,350,0,0
3291,2019-01-21,649,0,649,51,700,700,0,0
3292,2019-01-21,769,0,769,61,830,830,0,0
3293,2019-01-21,1010,0,1010,80,1090,1090,0,0
3294,2019-01-21,195,0,195,15,210,210,0,0
3295,2019-01-21,389,0,389,31,420,420,0,0
3296,2019-01-21,149,0,149,11,160,160,0,0
3297,2019-01-21,602,0,602,48,650,650,0,0
3298,2019-01-21,630,0,630,50,680,680,0,0
3299,2019-01-21,741,0,741,59,800,800,0,0
3300,2019-01-21,112,0,112,8,120,120,0,0
3301,2019-01-21,408,0,408,32,440,440,0,0
3302,2019-01-21,1213,0,1213,97,1310,1310,0,0
3303,2019-01-21,167,0,167,13,180,180,0,0
3304,2019-01-21,519,0,519,41,560,560,0,0
3305,2019-01-21,778,0,778,62,840,840,0,0
3306,2019-01-21,269,0,269,21,290,290,0,0
3307,2019-01-21,630,0,630,50,680,680,0,0
3308,2019-01-21,630,0,630,50,680,680,0,0
3309,2019-01-21,575,0,575,45,620,620,0,0
3310,2019-01-21,639,0,639,51,690,690,0,0
3311,2019-01-21,454,0,454,36,490,490,0,0
3312,2019-01-21,565,0,565,45,610,610,0,0
3313,2019-01-21,1482,0,1482,118,1600,1600,0,0
3314,2019-01-21,602,0,602,48,650,650,0,0
3315,2019-01-21,741,0,741,59,800,800,0,0
3316,2019-01-21,889,0,889,71,960,960,0,0
3317,2019-01-21,269,0,269,21,290,290,0,0
3318,2019-01-21,1852,0,1852,148,2000,2000,0,0
3319,2019-01-21,2130,0,2130,170,2300,2300,0,0
3320,2019-01-21,426,0,426,34,460,460,0,0
3321,2019-01-21,399,0,399,31,430,430,0,0
3322,2019-01-21,1343,0,1343,107,1450,1450,0,0
3323,2019-01-21,1176,0,1176,94,1270,1270,0,0
3324,2019-01-21,389,0,389,31,420,420,0,0
3325,2019-01-21,1815,0,1815,145,1960,1960,0,0
3326,2019-01-21,334,0,334,26,360,360,0,0
3327,2019-01-21,538,0,538,42,580,580,0,0
3328,2019-01-21,1408,0,1408,112,1520,1520,0,0
3329,2019-01-21,602,0,602,48,650,650,0,0
3330,2019-01-21,990,0,990,70,1060,1060,0,0
3331,2019-01-21,518,-110,408,32,440,440,0,0
3332,2019-01-21,1889,0,1889,151,2040,2040,0,0
3333,2019-01-21,47,0,47,3,50,50,0,0
3334,2019-01-21,788,0,788,62,850,0,850,0
3335,2019-01-21,445,0,445,35,480,480,0,0
3336,2019-01-21,542,-58,484,38,522,522,0,0
3337,2019-01-21,899,0,899,71,970,970,0,0
3338,2019-01-21,139,0,139,11,150,150,0,0
3339,2019-01-21,2954,0,2954,236,3190,3190,0,0
3340,2019-01-21,630,0,630,50,680,680,0,0
3341,2019-01-21,47,0,47,3,50,50,0,0
3342,2019-01-22,815,0,815,65,880,880,0,0
3343,2019-01-22,843,0,843,67,910,910,0,0
3344,2019-01-22,436,0,436,34,470,470,0,0
3345,2019-01-22,260,0,260,20,280,280,0,0
3346,2019-01-22,213,0,213,17,230,230,0,0
3347,2019-01-22,241,0,241,19,260,260,0,0
3348,2019-01-22,286,0,286,14,300,300,0,0
3349,2019-01-22,436,0,436,34,470,470,0,0
3350,2019-01-22,491,0,491,39,530,530,0,0
3351,2019-01-22,269,0,269,21,290,290,0,0
3352,2019-01-22,482,0,482,38,520,520,0,0
3353,2019-01-22,1102,0,1102,88,1190,1190,0,0
3354,2019-01-22,176,0,176,14,190,190,0,0
3355,2019-01-22,1213,0,1213,97,1310,1310,0,0
3356,2019-01-22,630,0,630,50,680,680,0,0
3357,2019-01-22,649,0,649,51,700,700,0,0
3358,2019-01-22,575,0,575,45,620,620,0,0
3359,2019-01-22,3463,0,3463,277,3740,3740,0,0
3360,2019-01-22,769,0,769,61,830,830,0,0
3361,2019-01-23,1990,-1990,0,0,0,0,0,0
3362,2019-01-23,621,0,621,49,670,670,0,0
3363,2019-01-23,482,0,482,38,520,520,0,0
3364,2019-01-23,908,0,908,72,980,980,0,0
3365,2019-01-23,908,0,908,72,980,980,0,0
3366,2019-01-23,908,0,908,72,980,980,0,0
3367,2019-01-23,908,0,908,72,980,980,0,0
3368,2019-01-23,741,0,741,59,800,800,0,0
3369,2019-01-23,657,0,657,43,700,700,0,0
3370,2019-01-23,167,0,167,13,180,180,0,0
3371,2019-01-23,896,0,896,54,950,950,0,0
3372,2019-01-23,509,0,509,31,540,540,0,0
3373,2019-01-23,2278,0,2278,182,2460,2460,0,0
3374,2019-01-23,593,0,593,47,640,640,0,0
3375,2019-01-23,334,0,334,26,360,360,0,0
3376,2019-01-23,1667,0,1667,133,1800,1800,0,0
3377,2019-01-23,602,0,602,48,650,650,0,0
3378,2019-01-23,741,0,741,59,800,800,0,0
3379,2019-01-23,1315,0,1315,105,1420,1420,0,0
3380,2019-01-23,732,0,732,58,790,790,0,0
3381,2019-01-23,380,0,380,30,410,410,0,0
3382,2019-01-23,899,0,899,71,970,970,0,0
3383,2019-01-23,-538,0,-538,-42,-580,-580,0,0
3384,2019-01-23,732,0,732,58,790,790,0,0
3385,2019-01-23,519,0,519,41,560,560,0,0
3386,2019-01-23,538,0,538,42,580,580,0,0
3387,2019-01-23,686,0,686,54,740,740,0,0
3388,2019-01-23,510,0,510,40,550,550,0,0
3389,2019-01-23,908,0,908,72,980,980,0,0
3390,2019-01-23,954,0,954,76,1030,1030,0,0
3391,2019-01-23,176,0,176,14,190,190,0,0
3392,2019-01-23,908,0,908,72,980,980,0,0
3393,2019-01-23,306,0,306,24,330,330,0,0
3394,2019-01-23,667,0,667,53,720,720,0,0
3395,2019-01-23,982,0,982,78,1060,1060,0,0
3396,2019-01-23,741,0,741,59,800,800,0,0
3397,2019-01-23,315,0,315,25,340,340,0,0
3398,2019-01-23,1482,0,1482,118,1600,1600,0,0
3399,2019-01-23,547,0,547,43,590,590,0,0
3400,2019-01-23,334,0,334,26,360,360,0,0
3401,2019-01-23,621,0,621,49,670,670,0,0
3402,2019-01-23,139,0,139,11,150,150,0,0
3403,2019-01-23,1575,0,1575,125,1700,1700,0,0
3404,2019-01-23,788,0,788,62,850,0,850,0
3405,2019-01-23,1084,0,1084,86,1170,1170,0,0
3406,2019-01-23,788,0,788,62,850,850,0,0
3407,2019-01-23,278,0,278,22,300,300,0,0
3408,2019-01-23,436,0,436,34,470,470,0,0
3409,2019-01-23,889,0,889,71,960,960,0,0
3410,2019-01-23,630,0,630,50,680,680,0,0
3411,2019-01-23,371,0,371,29,400,400,0,0
3412,2019-01-23,1575,0,1575,125,1700,1700,0,0
3413,2019-01-23,334,0,334,26,360,360,0,0
3414,2019-01-23,1232,0,1232,98,1330,1330,0,0
3415,2019-01-23,1575,0,1575,125,1700,1700,0,0
3416,2019-01-23,630,0,630,50,680,680,0,0
3417,2019-01-23,538,0,538,42,580,580,0,0
3418,2019-01-23,834,0,834,66,900,900,0,0
3419,2019-01-23,538,0,538,42,580,580,0,0
3420,2019-01-23,1575,0,1575,125,1700,1700,0,0
3421,2019-01-23,269,0,269,21,290,290,0,0
3422,2019-01-23,575,0,575,45,620,620,0,0
3423,2019-01-23,1565,0,1565,125,1690,1690,0,0
3424,2019-01-23,288,0,288,22,310,310,0,0
3425,2019-01-23,1121,0,1121,89,1210,1210,0,0
3426,2019-01-23,473,0,473,37,510,510,0,0
3427,2019-01-23,769,0,769,61,830,0,830,0
3428,2019-01-23,1056,0,1056,84,1140,1140,0,0
3429,2019-01-23,1038,0,1038,82,1120,1120,0,0
3430,2019-01-23,1815,0,1815,145,1960,1960,0,0
3431,2019-01-23,889,0,889,71,960,960,0,0
3432,2019-01-23,334,0,334,26,360,360,0,0
3433,2019-01-23,306,0,306,24,330,330,0,0
3434,2019-01-23,1815,0,1815,145,1960,1960,0,0
3435,2019-01-23,149,0,149,11,160,160,0,0
3436,2019-01-23,473,0,473,37,510,510,0,0
3437,2019-01-23,278,0,278,22,300,300,0,0
3438,2019-01-23,1880,0,1880,150,2030,2030,0,0
3439,2019-01-24,306,0,306,24,330,330,0,0
3440,2019-01-24,695,0,695,55,750,750,0,0
3441,2019-01-24,149,0,149,11,160,160,0,0
3442,2019-01-24,908,0,908,72,980,980,0,0
3443,2019-01-24,1685,0,1685,125,1810,1810,0,0
3444,2019-01-24,908,0,908,72,980,980,0,0
3445,2019-01-24,686,0,686,54,740,740,0,0
3446,2019-01-24,232,0,232,18,250,250,0,0
3447,2019-01-24,528,0,528,42,570,570,0,0
3448,2019-01-24,908,0,908,72,980,980,0,0
3449,2019-01-24,1399,0,1399,111,1510,1510,0,0
3450,2019-01-24,806,0,806,64,870,870,0,0
3451,2019-01-24,334,0,334,26,360,360,0,0
3452,2019-01-24,774,0,774,61,835,835,0,0
3453,2019-01-24,732,0,732,58,790,790,0,0
3454,2019-01-24,806,0,806,64,870,870,0,0
3455,2019-01-24,889,0,889,71,960,960,0,0
3456,2019-01-24,167,0,167,13,180,180,0,0
3457,2019-01-24,630,0,630,50,680,680,0,0
3458,2019-01-24,1760,0,1760,140,1900,1900,0,0
3459,2019-01-24,908,0,908,72,980,980,0,0
3460,2019-01-24,269,0,269,21,290,290,0,0
3461,2019-01-24,232,0,232,18,250,250,0,0
3462,2019-01-24,1028,0,1028,82,1110,1110,0,0
3463,2019-01-24,538,0,538,42,580,580,0,0
3464,2019-01-24,584,0,584,46,630,630,0,0
3465,2019-01-24,408,0,408,32,440,440,0,0
3466,2019-01-24,334,0,334,26,360,360,0,0
3467,2019-01-24,583,0,583,37,620,620,0,0
3468,2019-01-24,1815,0,1815,145,1960,1960,0,0
3469,2019-01-24,269,0,269,21,290,290,0,0
3470,2019-01-24,769,0,769,61,830,830,0,0
3471,2019-01-24,436,0,436,34,470,470,0,0
3472,2019-01-24,436,0,436,34,470,470,0,0
3473,2019-01-24,593,0,593,47,640,640,0,0
3474,2019-01-24,408,0,408,32,440,440,0,0
3475,2019-01-24,1222,0,1222,88,1310,1310,0,0
3476,2019-01-24,260,0,260,20,280,280,0,0
3477,2019-01-24,362,0,362,28,390,0,390,0
3478,2019-01-24,547,0,547,43,590,590,0,0
3479,2019-01-24,751,0,751,59,810,810,0,0
3480,2019-01-24,973,0,973,77,1050,1050,0,0
3481,2019-01-24,251,0,251,19,270,270,0,0
3482,2019-01-24,556,0,556,44,600,600,0,0
3483,2019-01-24,862,0,862,68,930,930,0,0
3484,2019-01-24,778,0,778,62,840,840,0,0
3485,2019-01-24,908,0,908,72,980,980,0,0
3486,2019-01-24,908,0,908,72,980,980,0,0
3487,2019-01-24,973,0,973,77,1050,1050,0,0
3488,2019-01-24,908,0,908,72,980,980,0,0
3489,2019-01-24,1796,0,1796,134,1930,1930,0,0
3490,2019-01-24,491,0,491,39,530,530,0,0
3491,2019-01-24,380,0,380,30,410,410,0,0
3492,2019-01-24,1121,0,1121,89,1210,1210,0,0
3493,2019-01-24,667,0,667,53,720,720,0,0
3494,2019-01-24,1019,0,1019,81,1100,1100,0,0
3495,2019-01-24,2130,0,2130,170,2300,2300,0,0
3496,2019-01-24,538,0,538,42,580,580,0,0
3497,2019-01-24,843,0,843,67,910,910,0,0
3498,2019-01-24,713,0,713,57,770,770,0,0
3499,2019-01-24,436,0,436,34,470,470,0,0
3500,2019-01-24,908,0,908,72,980,980,0,0
3501,2019-01-24,1501,0,1501,119,1620,1620,0,0
3502,2019-01-24,269,0,269,21,290,290,0,0
3503,2019-01-24,751,0,751,59,810,810,0,0
3504,2019-01-24,1213,0,1213,97,1310,1310,0,0
3505,2019-01-24,954,0,954,76,1030,1030,0,0
3506,2019-01-24,389,0,389,31,420,420,0,0
3507,2019-01-24,389,0,389,31,420,420,0,0
3508,2019-01-24,306,0,306,24,330,330,0,0
3509,2019-01-24,509,0,509,31,540,540,0,0
3510,2019-01-24,785,0,785,45,830,830,0,0
3511,2019-01-24,575,0,575,45,620,620,0,0
3512,2019-01-24,1334,0,1334,106,1440,1440,0,0
3513,2019-01-24,954,0,954,76,1030,1030,0,0
3514,2019-01-24,269,0,269,21,290,290,0,0
3515,2019-01-24,788,0,788,62,850,850,0,0
3516,2019-01-24,825,0,825,65,890,890,0,0
3517,2019-01-24,556,0,556,44,600,600,0,0
3518,2019-01-24,862,0,862,68,930,930,0,0
3519,2019-01-24,704,0,704,56,760,760,0,0
3520,2019-01-24,306,0,306,24,330,330,0,0
3521,2019-01-24,2249,0,2249,171,2420,2420,0,0
3522,2019-01-24,908,0,908,72,980,980,0,0
3523,2019-01-24,334,0,334,26,360,360,0,0
3524,2019-01-24,482,0,482,38,520,520,0,0
3525,2019-01-24,528,0,528,42,570,570,0,0
3526,2019-01-24,788,0,788,62,850,850,0,0
3527,2019-01-24,167,0,167,13,180,180,0,0
3528,2019-01-24,639,0,639,51,690,690,0,0
3529,2019-01-24,1213,0,1213,97,1310,1310,0,0
3530,2019-01-24,565,0,565,45,610,610,0,0
3531,2019-01-24,713,0,713,57,770,770,0,0
3532,2019-01-24,649,0,649,51,700,700,0,0
3533,2019-01-24,1186,0,1186,94,1280,1280,0,0
3534,2019-01-24,778,0,778,62,840,840,0,0
3535,2019-01-24,1587,-170,1417,113,1530,1530,0,0
3536,2019-01-24,777,0,777,53,830,830,0,0
3537,2019-01-24,825,0,825,65,890,890,0,0
3538,2019-01-24,602,0,602,48,650,650,0,0
3539,2019-01-24,885,-188,697,55,752,752,0,0
3540,2019-01-24,1334,0,1334,106,1440,1440,0,0
3541,2019-01-24,584,0,584,46,630,630,0,0
3542,2019-01-25,139,0,139,11,150,150,0,0
3543,2019-01-25,288,0,288,22,310,310,0,0
3544,2019-01-25,788,0,788,62,850,850,0,0
3545,2019-01-25,436,0,436,34,470,470,0,0
3546,2019-01-25,945,0,945,75,1020,1020,0,0
3547,2019-01-25,1167,0,1167,93,1260,1260,0,0
3548,2019-01-25,815,0,815,65,880,880,0,0
3549,2019-01-25,1186,0,1186,94,1280,1280,0,0
3550,2019-01-25,1065,0,1065,85,1150,1150,0,0
3551,2019-01-25,251,0,251,19,270,270,0,0
3552,2019-01-25,371,0,371,29,400,400,0,0
3553,2019-01-25,473,0,473,37,510,510,0,0
3554,2019-01-25,769,0,769,61,830,830,0,0
3555,2019-01-25,334,0,334,26,360,360,0,0
3556,2019-01-25,1635,0,1635,130,1765,1765,0,0
3557,2019-01-25,658,0,658,52,710,710,0,0
3558,2019-01-25,487,0,487,38,525,525,0,0
3559,2019-01-25,908,0,908,72,980,980,0,0
3560,2019-01-25,1288,0,1288,102,1390,0,1390,0
3561,2019-01-25,1815,0,1815,145,1960,1960,0,0
3562,2019-01-25,3417,0,3417,273,3690,0,3690,0
3563,2019-01-25,2547,0,2547,203,2750,2750,0,0
3564,2019-01-25,741,0,741,59,800,800,0,0
3565,2019-01-25,417,0,417,33,450,450,0,0
3566,2019-01-25,149,0,149,11,160,160,0,0
3567,2019-01-25,2723,0,2723,217,2940,2940,0,0
3568,2019-01-25,583,0,583,37,620,620,0,0
3569,2019-01-25,408,0,408,32,440,440,0,0
3570,2019-01-25,241,0,241,19,260,260,0,0
3571,2019-01-25,825,0,825,65,890,890,0,0
3572,2019-01-25,3112,0,3112,248,3360,0,3360,0
3573,2019-01-25,1751,0,1751,139,1890,1890,0,0
3574,2019-01-25,352,0,352,28,380,380,0,0
3575,2019-01-25,519,0,519,41,560,560,0,0
3576,2019-01-25,722,0,722,48,770,770,0,0
3577,2019-01-25,241,0,241,19,260,260,0,0
3578,2019-01-25,565,0,565,45,610,610,0,0
3579,2019-01-25,713,0,713,57,770,770,0,0
3580,2019-01-25,232,0,232,18,250,250,0,0
3581,2019-01-25,769,0,769,61,830,830,0,0
3582,2019-01-25,741,0,741,59,800,800,0,0
3583,2019-01-25,723,0,723,57,780,780,0,0
3584,2019-01-25,112,0,112,8,120,120,0,0
3585,2019-01-25,528,0,528,42,570,570,0,0
3586,2019-01-25,232,0,232,18,250,250,0,0
3587,2019-01-25,555,0,555,35,590,590,0,0
3588,2019-01-25,371,0,371,29,400,400,0,0
3589,2019-01-25,815,0,815,65,880,880,0,0
3590,2019-01-25,575,0,575,45,620,620,0,0
3591,2019-01-25,851,0,851,59,910,910,0,0
3592,2019-01-25,399,0,399,31,430,430,0,0
3593,2019-01-25,445,0,445,35,480,480,0,0
3594,2019-01-25,862,0,862,68,930,930,0,0
3595,2019-01-25,362,0,362,28,390,390,0,0
3596,2019-01-25,1528,0,1528,122,1650,1650,0,0
3597,2019-01-25,908,0,908,72,980,980,0,0
3598,2019-01-25,788,0,788,62,850,850,0,0
3599,2019-01-25,362,0,362,28,390,390,0,0
3600,2019-01-25,334,0,334,26,360,360,0,0
3601,2019-01-25,630,0,630,50,680,680,0,0
3602,2019-01-25,167,0,167,13,180,180,0,0
3603,2019-01-25,630,0,630,50,680,680,0,0
3604,2019-01-25,741,0,741,59,800,800,0,0
3605,2019-01-25,991,0,991,79,1070,1070,0,0
3606,2019-01-25,862,0,862,68,930,930,0,0
3607,2019-01-25,408,0,408,32,440,0,440,0
3608,2019-01-25,1593,0,1593,127,1720,1720,0,0
3609,2019-01-25,260,0,260,20,280,280,0,0
3610,2019-01-25,982,0,982,78,1060,1060,0,0
3611,2019-01-25,1815,0,1815,145,1960,1960,0,0
3612,2019-01-25,380,0,380,30,410,410,0,0
3613,2019-01-25,473,0,473,37,510,510,0,0
3614,2019-01-25,491,0,491,39,530,530,0,0
3615,2019-01-25,2723,0,2723,217,2940,2940,0,0
3616,2019-01-25,1325,0,1325,105,1430,1430,0,0
3617,2019-01-25,426,0,426,34,460,460,0,0
3618,2019-01-25,612,0,612,48,660,660,0,0
3619,2019-01-25,1954,0,1954,156,2110,2110,0,0
3620,2019-01-25,1065,0,1065,85,1150,1150,0,0
3621,2019-01-25,2362,0,2362,188,2550,2550,0,0
3622,2019-01-25,639,0,639,51,690,690,0,0
3623,2019-01-25,1065,0,1065,85,1150,1150,0,0
3624,2019-01-25,859,0,859,51,910,910,0,0
3625,2019-01-25,176,0,176,14,190,190,0,0
3626,2019-01-25,389,0,389,31,420,420,0,0
3627,2019-01-25,1195,0,1195,95,1290,1290,0,0
3628,2019-01-25,788,0,788,62,850,850,0,0
3629,2019-01-25,959,0,959,76,1035,1035,0,0
3630,2019-01-25,463,0,463,37,500,500,0,0
3631,2019-01-25,690,0,690,55,745,745,0,0
3632,2019-01-25,963,-500,463,37,500,500,0,0
3633,2019-01-25,788,0,788,62,850,850,0,0
3634,2019-01-25,325,0,325,25,350,350,0,0
3635,2019-01-25,926,0,926,74,1000,1000,0,0
3636,2019-01-25,482,0,482,38,520,520,0,0
3637,2019-01-25,2723,0,2723,217,2940,2940,0,0
3638,2019-01-25,260,0,260,20,280,280,0,0
3639,2019-01-25,769,0,769,61,830,830,0,0
3640,2019-01-25,991,0,991,79,1070,1070,0,0
3641,2019-01-25,788,0,788,62,850,850,0,0
3642,2019-01-25,538,0,538,42,580,580,0,0
3643,2019-01-25,389,0,389,31,420,420,0,0
3644,2019-01-25,834,0,834,66,900,900,0,0
3645,2019-01-25,260,0,260,20,280,280,0,0
3646,2019-01-25,306,0,306,24,330,330,0,0
3647,2019-01-25,936,0,936,74,1010,1010,0,0
3648,2019-01-25,871,0,871,69,940,940,0,0
3649,2019-01-25,612,0,612,48,660,660,0,0
3650,2019-01-25,834,0,834,66,900,900,0,0
3651,2019-01-25,386,-82,304,24,328,328,0,0
3652,2019-01-25,510,0,510,40,550,550,0,0
3653,2019-01-25,1945,0,1945,155,2100,2100,0,0
3654,2019-01-25,1112,0,1112,88,1200,1200,0,0
3655,2019-01-25,408,0,408,32,440,440,0,0
3656,2019-01-25,1528,0,1528,122,1650,1650,0,0
3657,2019-01-25,1093,0,1093,87,1180,1180,0,0
3658,2019-01-25,2056,0,2056,164,2220,0,2220,0
3659,2019-01-25,899,0,899,71,970,970,0,0
3660,2019-01-25,1815,0,1815,145,1960,1960,0,0
3661,2019-01-25,1158,0,1158,92,1250,1250,0,0
3662,2019-01-25,510,0,510,40,550,550,0,0
3663,2019-01-25,288,0,288,22,310,310,0,0
3664,2019-01-25,501,0,501,39,540,540,0,0
3665,2019-01-25,593,0,593,47,640,640,0,0
3666,2019-01-25,362,0,362,28,390,390,0,0
3667,2019-01-25,936,0,936,74,1010,1010,0,0
3668,2019-01-25,713,0,713,57,770,770,0,0
3669,2019-01-25,806,0,806,64,870,870,0,0
3670,2019-01-25,584,0,584,46,630,630,0,0
3671,2019-01-25,639,0,639,51,690,690,0,0
3672,2019-01-25,1861,0,1861,139,2000,2000,0,0
3673,2019-01-25,463,0,463,37,500,500,0,0
3674,2019-01-25,1741,0,1741,139,1880,1880,0,0
3675,2019-01-25,1556,0,1556,124,1680,1680,0,0
3676,2019-01-25,1019,0,1019,81,1100,1100,0,0
3677,2019-01-25,1686,0,1686,134,1820,1820,0,0
3678,2019-01-25,1064,0,1064,76,1140,1140,0,0
3679,2019-01-25,1834,0,1834,146,1980,1980,0,0
3680,2019-01-25,2723,0,2723,217,2940,2940,0,0
3681,2019-01-25,1407,0,1407,103,1510,1510,0,0
3682,2019-01-25,908,0,908,72,980,980,0,0
3683,2019-01-25,260,0,260,20,280,280,0,0
3684,2019-01-25,538,0,538,42,580,580,0,0
3685,2019-01-25,1815,0,1815,145,1960,1960,0,0
3686,2019-01-25,797,0,797,63,860,860,0,0
3687,2019-01-25,2001,0,2001,159,2160,2160,0,0
3688,2019-01-25,463,0,463,37,500,500,0,0
3689,2019-01-25,1251,0,1251,99,1350,1350,0,0
3690,2019-01-25,362,0,362,28,390,390,0,0
3691,2019-01-26,241,0,241,19,260,260,0,0
3692,2019-01-26,630,0,630,50,680,680,0,0
3693,2019-01-26,1815,0,1815,145,1960,1960,0,0
3694,2019-01-26,4538,0,4538,362,4900,4900,0,0
3695,2019-01-26,2075,0,2075,165,2240,2240,0,0
3696,2019-01-26,519,0,519,41,560,560,0,0
3697,2019-01-26,639,0,639,51,690,690,0,0
3698,2019-01-26,908,0,908,72,980,980,0,0
3699,2019-01-26,658,0,658,52,710,710,0,0
3700,2019-01-26,602,0,602,48,650,650,0,0
3701,2019-01-26,611,0,611,39,650,650,0,0
3702,2019-01-26,620,0,620,40,660,660,0,0
3703,2019-01-26,547,0,547,43,590,590,0,0
3704,2019-01-26,426,0,426,34,460,460,0,0
3705,2019-01-26,908,0,908,72,980,980,0,0
3706,2019-01-26,630,0,630,50,680,680,0,0
3707,2019-01-26,1815,0,1815,145,1960,1960,0,0
3708,2019-01-26,389,0,389,31,420,420,0,0
3709,2019-01-26,973,0,973,77,1050,1050,0,0
3710,2019-01-26,612,0,612,48,660,660,0,0
3711,2019-01-26,399,0,399,31,430,430,0,0
3712,2019-01-26,2352,0,2352,188,2540,2540,0,0
3713,2019-01-26,2274,-242,2032,146,2178,2178,0,0
3714,2019-01-26,908,0,908,72,980,980,0,0
3715,2019-01-26,612,0,612,48,660,660,0,0
3716,2019-01-26,760,0,760,60,820,820,0,0
3717,2019-01-26,1695,0,1695,135,1830,1830,0,0
3718,2019-01-26,352,0,352,28,380,380,0,0
3719,2019-01-26,1852,0,1852,148,2000,2000,0,0
3720,2019-01-26,519,0,519,41,560,560,0,0
3721,2019-01-26,2649,0,2649,211,2860,2860,0,0
3722,2019-01-26,1658,0,1658,132,1790,1790,0,0
3723,2019-01-26,510,0,510,40,550,550,0,0
3724,2019-01-26,2723,0,2723,217,2940,2940,0,0
3725,2019-01-26,2723,0,2723,217,2940,0,2940,0
3726,2019-01-26,1815,0,1815,145,1960,1960,0,0
3727,2019-01-26,639,0,639,51,690,0,690,0
3728,2019-01-26,1546,0,1546,114,1660,1660,0,0
3729,2019-01-26,1788,0,1788,142,1930,1930,0,0
3730,2019-01-26,648,0,648,42,690,690,0,0
3731,2019-01-26,654,-70,584,46,630,630,0,0
3732,2019-01-26,1204,0,1204,96,1300,1300,0,0
3733,2019-01-26,288,0,288,22,310,310,0,0
3734,2019-01-26,1612,0,1612,128,1740,1740,0,0
3735,2019-01-26,454,0,454,36,490,490,0,0
3736,2019-01-26,630,0,630,50,680,680,0,0
3737,2019-01-26,1621,0,1621,129,1750,1750,0,0
3738,2019-01-26,1010,0,1010,80,1090,1090,0,0
3739,2019-01-26,621,0,621,49,670,670,0,0
3740,2019-01-26,491,0,491,39,530,530,0,0
3741,2019-01-26,491,0,491,39,530,530,0,0
3742,2019-01-26,843,0,843,67,910,910,0,0
3743,2019-01-26,362,0,362,28,390,390,0,0
3744,2019-01-26,371,0,371,29,400,400,0,0
3745,2019-01-26,778,0,778,62,840,840,0,0
3746,2019-01-26,-371,0,-371,-29,-400,-400,0,0
3747,2019-01-26,704,0,704,56,760,760,0,0
3748,2019-01-26,436,0,436,34,470,470,0,0
3749,2019-01-26,362,0,362,28,390,390,0,0
3750,2019-01-26,862,0,862,68,930,930,0,0
3751,2019-01-26,936,0,936,74,1010,1010,0,0
3752,2019-01-26,825,0,825,65,890,890,0,0
3753,2019-01-26,232,0,232,18,250,250,0,0
3754,2019-01-26,908,0,908,72,980,980,0,0
3755,2019-01-26,362,0,362,28,390,390,0,0
3756,2019-01-26,176,0,176,14,190,190,0,0
3757,2019-01-26,852,0,852,68,920,920,0,0
3758,2019-01-26,389,0,389,31,420,420,0,0
3759,2019-01-26,139,0,139,11,150,150,0,0
3760,2019-01-26,315,0,315,25,340,340,0,0
3761,2019-01-26,389,0,389,31,420,420,0,0
3762,2019-01-26,871,0,871,69,940,940,0,0
3763,2019-01-26,676,0,676,54,730,730,0,0
3764,2019-01-26,676,0,676,54,730,730,0,0
3765,2019-01-26,436,0,436,34,470,470,0,0
3766,2019-01-26,2065,0,2065,165,2230,2230,0,0
3767,2019-01-26,1260,0,1260,100,1360,1360,0,0
3768,2019-01-26,149,0,149,11,160,160,0,0
3769,2019-01-26,1010,0,1010,80,1090,1090,0,0
3770,2019-01-26,501,0,501,39,540,540,0,0
3771,2019-01-26,112,0,112,8,120,120,0,0
3772,2019-01-26,612,0,612,48,660,660,0,0
3773,2019-01-26,232,0,232,18,250,250,0,0
3774,2019-01-26,575,0,575,45,620,620,0,0
3775,2019-01-26,1667,0,1667,133,1800,0,1800,0
3776,2019-01-26,399,0,399,31,430,430,0,0
3777,2019-01-26,760,0,760,60,820,820,0,0
3778,2019-01-26,1491,0,1491,119,1610,1610,0,0
3779,2019-01-26,251,0,251,19,270,270,0,0
3780,2019-01-26,778,0,778,62,840,840,0,0
3781,2019-01-26,380,0,380,30,410,410,0,0
3782,2019-01-26,436,0,436,34,470,470,0,0
3783,2019-01-26,973,0,973,77,1050,1050,0,0
3784,2019-01-26,741,0,741,59,800,800,0,0
3785,2019-01-26,908,0,908,72,980,980,0,0
3786,2019-01-26,1575,0,1575,125,1700,1700,0,0
3787,2019-01-26,1362,0,1362,108,1470,1470,0,0
3788,2019-01-26,584,0,584,46,630,630,0,0
3789,2019-01-26,2797,0,2797,223,3020,3020,0,0
3790,2019-01-26,695,0,695,55,750,750,0,0
3791,2019-01-26,825,0,825,65,890,890,0,0
3792,2019-01-26,778,0,778,62,840,840,0,0
3793,2019-01-26,1575,0,1575,125,1700,0,1700,0
3794,2019-01-26,139,0,139,11,150,150,0,0
3795,2019-01-26,343,0,343,27,370,370,0,0
3796,2019-01-26,788,0,788,62,850,850,0,0
3797,2019-01-26,1575,0,1575,125,1700,1700,0,0
3798,2019-01-26,788,0,788,62,850,850,0,0
3799,2019-01-26,788,0,788,62,850,850,0,0
3800,2019-01-26,1575,0,1575,125,1700,1700,0,0
3801,2019-01-26,1575,0,1575,125,1700,1700,0,0
3802,2019-01-26,769,0,769,61,830,830,0,0
3803,2019-01-26,788,0,788,62,850,850,0,0
3804,2019-01-26,788,0,788,62,850,850,0,0
3805,2019-01-26,112,0,112,8,120,120,0,0
3806,2019-01-26,445,0,445,35,480,480,0,0
3807,2019-01-26,371,0,371,29,400,400,0,0
3808,2019-01-26,269,0,269,21,290,290,0,0
3809,2019-01-26,399,0,399,31,430,430,0,0
3810,2019-01-26,2167,0,2167,173,2340,2340,0,0
3811,2019-01-26,880,0,880,70,950,950,0,0
3812,2019-01-26,220,0,220,0,220,220,0,0
3813,2019-01-26,454,0,454,36,490,490,0,0
3814,2019-01-26,1223,0,1223,97,1320,1320,0,0
3815,2019-01-26,473,0,473,37,510,510,0,0
3816,2019-01-26,862,0,862,68,930,930,0,0
3817,2019-01-26,547,0,547,43,590,590,0,0
3818,2019-01-26,612,0,612,48,660,660,0,0
3819,2019-01-26,491,0,491,39,530,530,0,0
3820,2019-01-26,473,0,473,37,510,510,0,0
3821,2019-01-26,834,0,834,66,900,0,900,0
3822,2019-01-26,1112,0,1112,88,1200,1200,0,0
3823,2019-01-26,602,0,602,48,650,650,0,0
3824,2019-01-26,463,0,463,37,500,500,0,0
3825,2019-01-26,482,0,482,38,520,520,0,0
3826,2019-01-26,371,0,371,29,400,400,0,0
3827,2019-01-26,862,0,862,68,930,930,0,0
3828,2019-01-26,602,0,602,48,650,650,0,0
3829,2019-01-26,538,0,538,42,580,580,0,0
3830,2019-01-26,260,0,260,20,280,280,0,0
3831,2019-01-26,1954,0,1954,156,2110,2110,0,0
3832,2019-01-26,732,0,732,58,790,790,0,0
3833,2019-01-26,973,0,973,77,1050,1050,0,0
3834,2019-01-26,612,0,612,48,660,660,0,0
3835,2019-01-26,612,0,612,48,660,660,0,0
3836,2019-01-26,797,0,797,63,860,860,0,0
3837,2019-01-26,1047,0,1047,83,1130,1130,0,0
3838,2019-01-26,815,0,815,65,880,880,0,0
3839,2019-01-26,1223,0,1223,97,1320,1320,0,0
3840,2019-01-26,463,0,463,37,500,500,0,0
3841,2019-01-26,899,0,899,71,970,0,970,0
3842,2019-01-26,1139,0,1139,91,1230,1230,0,0
3843,2019-01-26,686,0,686,54,740,740,0,0
3844,2019-01-26,306,0,306,24,330,330,0,0
3845,2019-01-26,149,0,149,11,160,160,0,0
3846,2019-01-26,149,0,149,11,160,160,0,0
3847,2019-01-26,139,0,139,11,150,150,0,0
3848,2019-01-26,501,0,501,39,540,540,0,0
3849,2019-01-26,399,0,399,31,430,430,0,0
3850,2019-01-26,649,0,649,51,700,700,0,0
3851,2019-01-26,297,0,297,23,320,320,0,0
3852,2019-01-26,908,0,908,72,980,980,0,0
3853,2019-01-26,1130,0,1130,90,1220,1220,0,0
3854,2019-01-26,917,0,917,73,990,990,0,0
3855,2019-01-26,593,0,593,47,640,640,0,0
3856,2019-01-26,2621,0,2621,209,2830,2830,0,0
3857,2019-01-26,1001,0,1001,79,1080,1080,0,0
3858,2019-01-26,1417,0,1417,113,1530,1530,0,0
3859,2019-01-26,788,0,788,62,850,850,0,0
3860,2019-01-26,788,0,788,62,850,850,0,0
3861,2019-01-26,843,0,843,67,910,910,0,0
3862,2019-01-26,2362,0,2362,188,2550,2550,0,0
3863,2019-01-26,611,0,611,39,650,650,0,0
3864,2019-01-26,1575,0,1575,125,1700,1700,0,0
3865,2019-01-26,306,0,306,24,330,330,0,0
3866,2019-01-26,1241,0,1241,99,1340,1340,0,0
3867,2019-01-26,1575,0,1575,125,1700,1700,0,0
3868,2019-01-26,630,0,630,50,680,680,0,0
3869,2019-01-26,788,0,788,62,850,850,0,0
3870,2019-01-26,667,0,667,53,720,720,0,0
3871,2019-01-26,1462,0,1462,108,1570,1570,0,0
3872,2019-01-26,982,0,982,78,1060,1060,0,0
3873,2019-01-26,269,0,269,21,290,290,0,0
3874,2019-01-26,463,0,463,37,500,500,0,0
3875,2019-01-26,704,0,704,56,760,760,0,0
3876,2019-01-26,2917,0,2917,233,3150,3150,0,0
3877,2019-01-26,723,0,723,57,780,780,0,0
3878,2019-01-27,158,0,158,12,170,170,0,0
3879,2019-01-27,1593,0,1593,127,1720,1720,0,0
3880,2019-01-27,686,0,686,54,740,740,0,0
3881,2019-01-27,454,0,454,36,490,490,0,0
3882,2019-01-27,797,0,797,63,860,860,0,0
3883,2019-01-27,1815,0,1815,145,1960,1960,0,0
3884,2019-01-27,220,0,220,0,220,220,0,0
3885,2019-01-27,482,0,482,38,520,520,0,0
3886,2019-01-27,1149,0,1149,91,1240,0,1240,0
3887,2019-01-27,676,0,676,54,730,730,0,0
3888,2019-01-27,306,0,306,24,330,330,0,0
3889,2019-01-27,908,0,908,72,980,980,0,0
3890,2019-01-27,482,0,482,38,520,520,0,0
3891,2019-01-27,602,0,602,48,650,650,0,0
3892,2019-01-27,1213,0,1213,97,1310,1310,0,0
3893,2019-01-27,1436,0,1436,114,1550,0,1550,0
3894,2019-01-27,686,0,686,54,740,740,0,0
3895,2019-01-27,675,0,675,45,720,720,0,0
3896,2019-01-27,908,0,908,72,980,980,0,0
3897,2019-01-27,1047,0,1047,83,1130,1130,0,0
3898,2019-01-27,204,0,204,16,220,220,0,0
3899,2019-01-27,463,0,463,37,500,500,0,0
3900,2019-01-27,1528,0,1528,122,1650,1650,0,0
3901,2019-01-27,565,0,565,45,610,610,0,0
3902,2019-01-27,1463,0,1463,117,1580,1580,0,0
3903,2019-01-27,260,0,260,20,280,280,0,0
3904,2019-01-27,778,0,778,62,840,840,0,0
3905,2019-01-27,908,0,908,72,980,980,0,0
3906,2019-01-27,269,0,269,21,290,290,0,0
3907,2019-01-27,630,0,630,50,680,680,0,0
3908,2019-01-27,399,0,399,31,430,430,0,0
3909,2019-01-27,1223,0,1223,97,1320,1320,0,0
3910,2019-01-27,436,0,436,34,470,470,0,0
3911,2019-01-27,306,0,306,24,330,330,0,0
3912,2019-01-27,630,0,630,50,680,680,0,0
3913,2019-01-27,908,0,908,72,980,980,0,0
3914,2019-01-27,278,0,278,22,300,300,0,0
3915,2019-01-27,1380,0,1380,110,1490,1490,0,0
3916,2019-01-27,306,0,306,24,330,330,0,0
3917,2019-01-27,769,0,769,61,830,830,0,0
3918,2019-01-27,954,0,954,76,1030,1030,0,0
3919,2019-01-27,723,0,723,57,780,780,0,0
3920,2019-01-27,973,0,973,77,1050,1050,0,0
3921,2019-01-27,1260,0,1260,100,1360,1360,0,0
3922,2019-01-27,732,0,732,58,790,790,0,0
3923,2019-01-27,1575,0,1575,125,1700,1700,0,0
3924,2019-01-27,426,0,426,34,460,460,0,0
3925,2019-01-27,1278,0,1278,102,1380,1380,0,0
3926,2019-01-27,788,0,788,62,850,850,0,0
3927,2019-01-27,362,0,362,28,390,390,0,0
3928,2019-01-27,112,0,112,8,120,120,0,0
3929,2019-01-27,491,0,491,39,530,530,0,0
3930,2019-01-27,704,0,704,56,760,760,0,0
3931,2019-01-27,167,0,167,13,180,180,0,0
3932,2019-01-27,445,0,445,35,480,480,0,0
3933,2019-01-27,352,0,352,28,380,380,0,0
3934,2019-01-27,547,0,547,43,590,590,0,0
3935,2019-01-27,473,0,473,37,510,510,0,0
3936,2019-01-27,454,0,454,36,490,490,0,0
3937,2019-01-27,121,0,121,9,130,130,0,0
3938,2019-01-27,723,0,723,57,780,780,0,0
3939,2019-01-27,223,0,223,17,240,240,0,0
3940,2019-01-27,1815,0,1815,145,1960,1960,0,0
3941,2019-01-27,1575,0,1575,125,1700,0,1700,0
3942,2019-01-27,362,0,362,28,390,390,0,0
3943,2019-01-27,1741,0,1741,139,1880,1880,0,0
3944,2019-01-27,1575,0,1575,125,1700,1700,0,0
3945,2019-01-27,908,0,908,72,980,980,0,0
3946,2019-01-27,278,0,278,22,300,300,0,0
3947,2019-01-27,908,0,908,72,980,980,0,0
3948,2019-01-27,741,0,741,59,800,800,0,0
3949,2019-01-27,3630,0,3630,290,3920,3920,0,0
3950,2019-01-27,269,0,269,21,290,290,0,0
3951,2019-01-27,584,0,584,46,630,630,0,0
3952,2019-01-27,445,0,445,35,480,480,0,0
3953,2019-01-27,251,0,251,19,270,270,0,0
3954,2019-01-27,1167,-1000,167,13,180,180,0,0
3955,2019-01-27,973,0,973,77,1050,0,1050,0
3956,2019-01-27,110,0,110,0,110,110,0,0
3957,2019-01-27,491,0,491,39,530,530,0,0
3958,2019-01-27,334,0,334,26,360,360,0,0
3959,2019-01-27,936,0,936,74,1010,1010,0,0
3960,2019-01-27,788,0,788,62,850,850,0,0
3961,2019-01-27,538,0,538,42,580,580,0,0
3962,2019-01-27,491,0,491,39,530,530,0,0
3963,2019-01-27,741,0,741,59,800,800,0,0
3964,2019-01-27,1556,0,1556,124,1680,1680,0,0
3965,2019-01-28,426,0,426,34,460,460,0,0
3966,2019-01-28,501,0,501,39,540,540,0,0
3967,2019-01-28,658,0,658,52,710,710,0,0
3968,2019-01-28,1815,0,1815,145,1960,1960,0,0
3969,2019-01-28,334,0,334,26,360,0,360,0
3970,2019-01-28,695,0,695,55,750,750,0,0
3971,2019-01-28,908,0,908,72,980,980,0,0
3972,2019-01-28,704,0,704,56,760,760,0,0
3973,2019-01-28,667,0,667,53,720,720,0,0
3974,2019-01-28,732,0,732,58,790,790,0,0
3975,2019-01-28,908,0,908,72,980,980,0,0
3976,2019-01-28,1815,0,1815,145,1960,1960,0,0
3977,2019-01-28,908,0,908,72,980,980,0,0
3978,2019-01-28,334,0,334,26,360,360,0,0
3979,2019-01-28,908,0,908,72,980,980,0,0
3980,2019-01-28,445,0,445,35,480,480,0,0
3981,2019-01-28,908,0,908,72,980,980,0,0
3982,2019-01-28,334,0,334,26,360,360,0,0
3983,2019-01-28,704,0,704,56,760,760,0,0
3984,2019-01-28,213,0,213,17,230,230,0,0
3985,2019-01-28,788,0,788,62,850,850,0,0
3986,2019-01-28,1880,0,1880,150,2030,2030,0,0
3987,2019-01-28,676,0,676,54,730,730,0,0
3988,2019-01-28,744,-158,586,46,632,632,0,0
3989,2019-01-28,362,0,362,28,390,390,0,0
3990,2019-01-28,936,0,936,74,1010,1010,0,0
3991,2019-01-28,232,0,232,18,250,250,0,0
3992,2019-01-28,704,0,704,56,760,760,0,0
3993,2019-01-28,1362,0,1362,108,1470,1470,0,0
3994,2019-01-28,1000,0,1000,80,1080,1080,0,0
3995,2019-01-28,834,0,834,66,900,900,0,0
3996,2019-01-28,389,0,389,31,420,420,0,0
3997,2019-01-28,195,0,195,15,210,210,0,0
3998,2019-01-28,973,0,973,77,1050,1050,0,0
3999,2019-01-28,556,0,556,44,600,600,0,0
4000,2019-01-28,186,0,186,14,200,200,0,0
4001,2019-01-28,760,0,760,60,820,820,0,0
4002,2019-01-28,167,0,167,13,180,180,0,0
4003,2019-01-28,167,0,167,13,180,180,0,0
4004,2019-01-28,167,0,167,13,180,180,0,0
4005,2019-01-28,522,0,522,41,563,563,0,0
4006,2019-01-28,869,0,869,69,938,938,0,0
4007,2019-01-28,398,0,398,22,420,420,0,0
4008,2019-01-28,510,0,510,40,550,550,0,0
4009,2019-01-28,741,0,741,59,800,800,0,0
4010,2019-01-28,612,0,612,48,660,660,0,0
4011,2019-01-28,741,0,741,59,800,800,0,0
4012,2019-01-28,575,0,575,45,620,620,0,0
4013,2019-01-28,528,0,528,42,570,570,0,0
4014,2019-01-28,369,0,369,21,390,390,0,0
4015,2019-01-28,482,0,482,38,520,520,0,0
4016,2019-01-28,908,0,908,72,980,980,0,0
4017,2019-01-28,1815,0,1815,145,1960,1960,0,0
4018,2019-01-28,1815,0,1815,145,1960,1960,0,0
4019,2019-01-28,389,0,389,31,420,420,0,0
4020,2019-01-28,352,0,352,28,380,380,0,0
4021,2019-01-28,482,0,482,38,520,520,0,0
4022,2019-01-28,584,0,584,46,630,630,0,0
4023,2019-01-28,732,0,732,58,790,790,0,0
4024,2019-01-28,139,0,139,11,150,150,0,0
4025,2019-01-28,371,0,371,29,400,400,0,0
4026,2019-01-28,426,0,426,34,460,460,0,0
4027,2019-01-28,629,0,629,41,670,670,0,0
4028,2019-01-28,1158,0,1158,92,1250,1250,0,0
4029,2019-01-28,658,0,658,52,710,710,0,0
4030,2019-01-28,213,0,213,17,230,230,0,0
4031,2019-01-28,250,0,250,20,270,270,0,0
4032,2019-01-28,630,0,630,50,680,680,0,0
4033,2019-01-28,491,0,491,39,530,530,0,0
4034,2019-01-28,936,0,936,74,1010,1010,0,0
4035,2019-01-28,973,0,973,77,1050,1050,0,0
4036,2019-01-28,686,-500,186,14,200,200,0,0
4037,2019-01-28,399,0,399,31,430,430,0,0
4038,2019-01-28,445,0,445,35,480,480,0,0
4039,2019-01-28,139,0,139,11,150,150,0,0
4040,2019-01-28,973,0,973,77,1050,1050,0,0
4041,2019-01-28,139,0,139,11,150,150,0,0
4042,2019-01-28,251,0,251,19,270,270,0,0
4043,2019-01-28,602,0,602,48,650,650,0,0
4044,2019-01-28,121,0,121,9,130,130,0,0
4045,2019-01-28,593,0,593,47,640,640,0,0
4046,2019-01-28,463,0,463,37,500,500,0,0
4047,2019-01-28,667,0,667,53,720,720,0,0
4048,2019-01-28,288,0,288,22,310,310,0,0
4049,2019-01-28,815,0,815,65,880,880,0,0
4050,2019-01-28,676,0,676,54,730,730,0,0
4051,2019-01-28,1139,0,1139,91,1230,1230,0,0
4052,2019-01-28,704,0,704,56,760,760,0,0
4053,2019-01-28,667,0,667,53,720,720,0,0
4054,2019-01-28,639,0,639,51,690,0,690,0
4055,2019-01-28,371,0,371,29,400,400,0,0
4056,2019-01-28,797,0,797,63,860,860,0,0
4057,2019-01-28,741,0,741,59,800,800,0,0
4058,2019-01-28,1241,0,1241,99,1340,1340,0,0
4059,2019-01-28,510,0,510,40,550,550,0,0
4060,2019-01-28,352,0,352,28,380,380,0,0
4061,2019-01-28,167,0,167,13,180,180,0,0
4062,2019-01-28,1517,0,1517,103,1620,1620,0,0
4063,2019-01-28,297,0,297,23,320,320,0,0
4064,2019-01-28,676,0,676,54,730,730,0,0
4065,2019-01-28,538,0,538,42,580,580,0,0
4066,2019-01-28,500,0,500,40,540,540,0,0
4067,2019-01-28,722,0,722,48,770,770,0,0
4068,2019-01-28,232,0,232,18,250,250,0,0
4069,2019-01-28,1315,0,1315,105,1420,1420,0,0
4070,2019-01-28,1815,0,1815,145,1960,1960,0,0
4071,2019-01-28,139,0,139,11,150,150,0,0
4072,2019-01-28,982,-500,482,38,520,520,0,0
4073,2019-01-28,1575,0,1575,125,1700,1700,0,0
4074,2019-01-28,621,0,621,49,670,670,0,0
4075,2019-01-28,519,0,519,41,560,560,0,0
4076,2019-01-28,473,0,473,37,510,510,0,0
4077,2019-01-28,288,0,288,22,310,310,0,0
4078,2019-01-28,695,0,695,55,750,750,0,0
4079,2019-01-28,306,0,306,24,330,330,0,0
4080,2019-01-28,1213,0,1213,97,1310,1310,0,0
4081,2019-01-28,1204,0,1204,96,1300,1300,0,0
4082,2019-01-28,972,0,972,68,1040,1040,0,0
4083,2019-01-28,232,0,232,18,250,250,0,0
4084,2019-01-29,334,0,334,26,360,360,0,0
4085,2019-01-29,510,0,510,40,550,550,0,0
4086,2019-01-29,676,0,676,54,730,730,0,0
4087,2019-01-29,288,0,288,22,310,310,0,0
4088,2019-01-29,630,0,630,50,680,680,0,0
4089,2019-01-29,56,0,56,4,60,60,0,0
4090,2019-01-29,463,0,463,37,500,500,0,0
4091,2019-01-29,1315,0,1315,105,1420,1420,0,0
4092,2019-01-29,426,0,426,34,460,460,0,0
4093,2019-01-29,408,0,408,32,440,440,0,0
4094,2019-01-29,371,0,371,29,400,400,0,0
4095,2019-01-29,251,0,251,19,270,270,0,0
4096,2019-01-29,565,0,565,45,610,610,0,0
4097,2019-01-29,547,0,547,43,590,590,0,0
4098,2019-01-29,2399,0,2399,191,2590,2590,0,0
4099,2019-01-29,556,0,556,44,600,600,0,0
4100,2019-01-29,547,0,547,43,590,590,0,0
4101,2019-01-29,2001,0,2001,159,2160,2160,0,0
4102,2019-01-30,880,0,880,70,950,950,0,0
4103,2019-01-30,908,0,908,72,980,980,0,0
4104,2019-01-30,908,0,908,72,980,980,0,0
4105,2019-01-30,315,0,315,25,340,340,0,0
4106,2019-01-30,713,0,713,57,770,770,0,0
4107,2019-01-30,741,0,741,59,800,800,0,0
4108,2019-01-30,501,0,501,39,540,540,0,0
4109,2019-01-30,334,0,334,26,360,360,0,0
4110,2019-01-30,241,0,241,19,260,260,0,0
4111,2019-01-30,593,0,593,47,640,640,0,0
4112,2019-01-30,167,0,167,13,180,180,0,0
4113,2019-01-30,1602,0,1602,128,1730,1730,0,0
4114,2019-01-30,769,0,769,61,830,830,0,0
4115,2019-01-30,1445,0,1445,115,1560,1560,0,0
4116,2019-01-30,408,0,408,32,440,440,0,0
4117,2019-01-30,1241,0,1241,99,1340,1340,0,0
4118,2019-01-30,1556,0,1556,124,1680,1680,0,0
4119,2019-01-30,371,0,371,29,400,400,0,0
4120,2019-01-30,908,0,908,72,980,980,0,0
4121,2019-01-30,232,0,232,18,250,250,0,0
4122,2019-01-30,519,0,519,41,560,560,0,0
4123,2019-01-30,723,0,723,57,780,780,0,0
4124,2019-01-30,352,0,352,28,380,380,0,0
4125,2019-01-30,806,0,806,64,870,870,0,0
4126,2019-01-30,815,0,815,65,880,880,0,0
4127,2019-01-30,371,0,371,29,400,400,0,0
4128,2019-01-30,510,0,510,40,550,550,0,0
4129,2019-01-30,584,0,584,46,630,630,0,0
4130,2019-01-30,713,0,713,57,770,770,0,0
4131,2019-01-30,315,0,315,25,340,340,0,0
4132,2019-01-30,713,0,713,57,770,770,0,0
4133,2019-01-30,666,0,666,44,710,710,0,0
4134,2019-01-30,646,0,646,34,680,680,0,0
4135,2019-01-30,908,0,908,72,980,980,0,0
4136,2019-01-30,463,0,463,37,500,0,500,0
4137,2019-01-30,908,0,908,72,980,980,0,0
4138,2019-01-30,806,0,806,64,870,870,0,0
4139,2019-01-30,575,0,575,45,620,620,0,0
4140,2019-01-30,991,0,991,79,1070,1070,0,0
4141,2019-01-30,639,0,639,51,690,690,0,0
4142,2019-01-30,825,0,825,65,890,890,0,0
4143,2019-01-30,482,0,482,38,520,520,0,0
4144,2019-01-30,1980,0,1980,140,2120,2120,0,0
4145,2019-01-30,315,0,315,25,340,340,0,0
4146,2019-01-30,778,0,778,62,840,840,0,0
4147,2019-01-30,778,0,778,62,840,840,0,0
4148,2019-01-30,1065,0,1065,85,1150,1150,0,0
4149,2019-01-30,1797,0,1797,143,1940,1940,0,0
4150,2019-01-30,1112,0,1112,88,1200,1200,0,0
4151,2019-01-30,249,0,249,11,260,260,0,0
4152,2019-01-30,510,0,510,40,550,550,0,0
4153,2019-01-30,1482,0,1482,118,1600,1600,0,0
4154,2019-01-30,4084,0,4084,326,4410,0,4410,0
4155,2019-01-30,788,0,788,62,850,850,0,0
4156,2019-01-30,444,0,444,26,470,470,0,0
4157,2019-01-30,538,0,538,42,580,580,0,0
4158,2019-01-30,1371,0,1371,109,1480,1480,0,0
4159,2019-01-30,834,0,834,66,900,900,0,0
4160,2019-01-30,639,0,639,51,690,690,0,0
4161,2019-01-30,306,0,306,24,330,330,0,0
4162,2019-01-30,1954,0,1954,156,2110,2110,0,0
4163,2019-01-30,741,0,741,59,800,800,0,0
4164,2019-01-30,1112,0,1112,88,1200,1200,0,0
4165,2019-01-30,232,0,232,18,250,250,0,0
4166,2019-01-30,343,0,343,27,370,370,0,0
4167,2019-01-30,889,0,889,71,960,960,0,0
4168,2019-01-30,1815,0,1815,145,1960,1960,0,0
4169,2019-01-30,741,-500,241,19,260,260,0,0
4170,2019-01-30,213,0,213,17,230,230,0,0
4171,2019-01-30,352,0,352,28,380,380,0,0
4172,2019-01-30,723,0,723,57,780,780,0,0
4173,2019-01-30,302,-64,238,18,256,256,0,0
4174,2019-01-30,473,0,473,37,510,510,0,0
4175,2019-01-30,1139,0,1139,91,1230,1230,0,0
4176,2019-01-30,482,0,482,38,520,520,0,0
4177,2019-01-30,1056,0,1056,84,1140,1140,0,0
4178,2019-01-30,834,0,834,66,900,0,900,0
4179,2019-01-30,1112,0,1112,88,1200,1200,0,0
4180,2019-01-30,297,0,297,23,320,320,0,0
4181,2019-01-31,510,0,510,40,550,550,0,0
4182,2019-01-31,399,0,399,31,430,430,0,0
4183,2019-01-31,908,0,908,72,980,980,0,0
4184,2019-01-31,908,0,908,72,980,980,0,0
4185,2019-01-31,908,0,908,72,980,980,0,0
4186,2019-01-31,315,0,315,25,340,340,0,0
4187,2019-01-31,575,0,575,45,620,620,0,0
4188,2019-01-31,908,0,908,72,980,980,0,0
4189,2019-01-31,862,0,862,68,930,930,0,0
4190,2019-01-31,1102,0,1102,88,1190,1190,0,0
4191,2019-01-31,1556,0,1556,124,1680,1680,0,0
4192,2019-01-31,778,0,778,62,840,840,0,0
4193,2019-01-31,768,0,768,52,820,820,0,0
4194,2019-01-31,538,0,538,42,580,580,0,0
4195,2019-01-31,908,0,908,72,980,980,0,0
4196,2019-01-31,908,0,908,72,980,980,0,0
4197,2019-01-31,176,0,176,14,190,190,0,0
4198,2019-01-31,278,0,278,22,300,300,0,0
4199,2019-01-31,547,0,547,43,590,590,0,0
4200,2019-01-31,408,0,408,32,440,440,0,0
4201,2019-01-31,713,0,713,57,770,770,0,0
4202,2019-01-31,186,0,186,14,200,200,0,0
4203,2019-01-31,1130,0,1130,90,1220,1220,0,0
4204,2019-01-31,538,0,538,42,580,580,0,0
4205,2019-01-31,445,0,445,35,480,480,0,0
4206,2019-01-31,1371,0,1371,109,1480,1480,0,0
4207,2019-01-31,463,0,463,37,500,500,0,0
4208,2019-01-31,1075,0,1075,85,1160,1160,0,0
4209,2019-01-31,334,0,334,26,360,360,0,0
4210,2019-01-31,575,0,575,45,620,620,0,0
4211,2019-01-31,686,0,686,54,740,740,0,0
4212,2019-01-31,806,0,806,64,870,870,0,0
4213,2019-01-31,547,0,547,43,590,590,0,0
4214,2019-01-31,925,0,925,65,990,990,0,0
4215,2019-01-31,908,0,908,72,980,980,0,0
4216,2019-01-31,352,0,352,28,380,380,0,0
4217,2019-01-31,377,-80,297,23,320,0,320,0
4218,2019-01-31,880,0,880,70,950,950,0,0
4219,2019-01-31,852,0,852,68,920,920,0,0
4220,2019-01-31,306,0,306,24,330,330,0,0
4221,2019-01-31,112,0,112,8,120,120,0,0
4222,2019-01-31,908,0,908,72,980,0,980,0
4223,2019-01-31,889,0,889,71,960,960,0,0
4224,2019-01-31,834,0,834,66,900,900,0,0
4225,2019-01-31,1223,0,1223,97,1320,1320,0,0
4226,2019-01-31,788,0,788,62,850,850,0,0
4227,2019-01-31,788,0,788,62,850,850,0,0
4228,2019-01-31,769,0,769,61,830,830,0,0
4229,2019-01-31,102,0,102,8,110,110,0,0
4230,2019-01-31,501,0,501,39,540,540,0,0
4231,2019-01-31,788,0,788,62,850,850,0,0
4232,2019-01-31,306,0,306,24,330,330,0,0
4233,2019-01-31,1065,0,1065,85,1150,1150,0,0
4234,2019-01-31,315,0,315,25,340,340,0,0
4235,2019-01-31,2760,0,2760,220,2980,2980,0,0
4236,2019-01-31,991,0,991,79,1070,1070,0,0
4237,2019-01-31,630,0,630,50,680,680,0,0
4238,2019-01-31,723,0,723,57,780,780,0,0
4239,2019-01-31,766,-82,684,54,738,738,0,0
4240,2019-01-31,1454,0,1454,116,1570,0,1570,0
4241,2019-01-31,380,0,380,30,410,410,0,0
4242,2019-01-31,649,0,649,51,700,700,0,0
4243,2019-01-31,519,0,519,41,560,560,0,0
4244,2019-01-31,1065,0,1065,85,1150,1150,0,0
4245,2019-01-31,1575,0,1575,125,1700,1700,0,0
4246,2019-01-31,2268,0,2268,172,2440,2440,0,0
4247,2019-01-31,501,0,501,39,540,540,0,0
4248,2019-01-31,1501,0,1501,119,1620,1620,0,0
4249,2019-01-31,908,0,908,72,980,980,0,0
4250,2019-01-31,1371,0,1371,109,1480,1480,0,0
4251,2019-01-31,482,0,482,38,520,520,0,0
4252,2019-01-31,908,0,908,72,980,980,0,0
4253,2019-01-31,686,0,686,54,740,740,0,0
4254,2019-01-31,712,0,712,48,760,760,0,0
4255,2019-01-31,852,0,852,68,920,920,0,0
4256,2019-01-31,1325,0,1325,105,1430,1430,0,0
4257,2019-01-31,519,0,519,41,560,560,0,0
4258,2019-01-31,357,0,357,28,385,385,0,0
4259,2019-01-31,602,0,602,48,650,650,0,0
4260,2019-01-31,232,0,232,18,250,250,0,0
4261,2019-01-31,1778,0,1778,142,1920,1920,0,0
4262,2019-01-31,982,0,982,78,1060,1060,0,0
4263,2019-01-31,463,0,463,37,500,500,0,0
4264,2019-01-31,473,0,473,37,510,510,0,0
4265,2019-02-01,676,0,676,54,730,730,0,0
4266,2019-02-01,778,0,778,62,840,840,0,0
4267,2019-02-01,547,0,547,43,590,590,0,0
4268,2019-02-01,723,0,723,57,780,780,0,0
4269,2019-02-01,501,0,501,39,540,540,0,0
4270,2019-02-01,1815,0,1815,145,1960,1960,0,0
4271,2019-02-01,695,0,695,55,750,750,0,0
4272,2019-02-01,371,0,371,29,400,400,0,0
4273,2019-02-01,121,0,121,9,130,130,0,0
4274,2019-02-01,908,0,908,72,980,980,0,0
4275,2019-02-01,1038,0,1038,82,1120,1120,0,0
4276,2019-02-01,1130,0,1130,90,1220,1220,0,0
4277,2019-02-01,1093,0,1093,87,1180,1180,0,0
4278,2019-02-01,676,0,676,54,730,730,0,0
4279,2019-02-01,491,0,491,39,530,530,0,0
4280,2019-02-01,1815,0,1815,145,1960,1960,0,0
4281,2019-02-01,2213,0,2213,177,2390,2390,0,0
4282,2019-02-01,260,0,260,20,280,280,0,0
4283,2019-02-01,334,0,334,26,360,360,0,0
4284,2019-02-01,325,0,325,25,350,350,0,0
4285,2019-02-01,482,0,482,38,520,520,0,0
4286,2019-02-01,408,0,408,32,440,440,0,0
4287,2019-02-01,301,0,301,24,325,325,0,0
4288,2019-02-01,278,0,278,22,300,300,0,0
4289,2019-02-01,936,0,936,74,1010,1010,0,0
4290,2019-02-01,908,0,908,72,980,980,0,0
4291,2019-02-01,908,0,908,72,980,980,0,0
4292,2019-02-01,908,0,908,72,980,980,0,0
4293,2019-02-01,-908,0,-908,-72,-980,-980,0,0
4294,2019-02-01,620,0,620,40,660,660,0,0
4295,2019-02-01,334,0,334,26,360,360,0,0
4296,2019-02-01,2046,0,2046,154,2200,2200,0,0
4297,2019-02-01,908,0,908,72,980,980,0,0
4298,2019-02-01,110,0,110,0,110,110,0,0
4299,2019-02-01,1806,0,1806,144,1950,1950,0,0
4300,2019-02-01,306,0,306,24,330,330,0,0
4301,2019-02-01,1139,0,1139,91,1230,1230,0,0
4302,2019-02-01,889,0,889,71,960,960,0,0
4303,2019-02-01,260,0,260,20,280,280,0,0
4304,2019-02-01,954,0,954,76,1030,1030,0,0
4305,2019-02-01,686,0,686,54,740,740,0,0
4306,2019-02-01,704,0,704,56,760,760,0,0
4307,2019-02-01,167,0,167,13,180,180,0,0
4308,2019-02-01,649,0,649,51,700,700,0,0
4309,2019-02-01,1325,0,1325,105,1430,1430,0,0
4310,2019-02-01,362,0,362,28,390,390,0,0
4311,2019-02-01,491,0,491,39,530,530,0,0
4312,2019-02-01,405,0,405,32,437,437,0,0
4313,2019-02-01,649,0,649,51,700,700,0,0
4314,2019-02-01,760,0,760,60,820,820,0,0
4315,2019-02-01,658,0,658,52,710,710,0,0
4316,2019-02-01,908,0,908,72,980,980,0,0
4317,2019-02-01,917,0,917,73,990,990,0,0
4318,2019-02-01,834,0,834,66,900,900,0,0
4319,2019-02-01,778,0,778,62,840,840,0,0
4320,2019-02-01,621,0,621,49,670,670,0,0
4321,2019-02-01,1973,0,1973,157,2130,2130,0,0
4322,2019-02-01,658,0,658,52,710,710,0,0
4323,2019-02-01,1223,0,1223,97,1320,1320,0,0
4324,2019-02-01,463,0,463,37,500,500,0,0
4325,2019-02-01,1001,0,1001,79,1080,1080,0,0
4326,2019-02-01,862,0,862,68,930,930,0,0
4327,2019-02-01,945,0,945,75,1020,1020,0,0
4328,2019-02-01,1315,0,1315,105,1420,1420,0,0
4329,2019-02-01,741,0,741,59,800,800,0,0
4330,2019-02-01,510,0,510,40,550,550,0,0
4331,2019-02-01,788,0,788,62,850,850,0,0
4332,2019-02-01,278,0,278,22,300,300,0,0
4333,2019-02-01,1416,0,1416,104,1520,1520,0,0
4334,2019-02-01,1399,0,1399,111,1510,1510,0,0
4335,2019-02-01,862,0,862,68,930,930,0,0
4336,2019-02-01,1362,0,1362,108,1470,1470,0,0
4337,2019-02-01,1735,-366,1369,95,1464,1464,0,0
4338,2019-02-01,908,0,908,72,980,980,0,0
4339,2019-02-01,741,0,741,59,800,800,0,0
4340,2019-02-01,815,0,815,65,880,880,0,0
4341,2019-02-01,547,0,547,43,590,590,0,0
4342,2019-02-01,676,0,676,54,730,730,0,0
4343,2019-02-01,861,0,861,59,920,920,0,0
4344,2019-02-01,750,0,750,60,810,810,0,0
4345,2019-02-01,1241,0,1241,99,1340,1340,0,0
4346,2019-02-01,1575,0,1575,125,1700,1700,0,0
4347,2019-02-01,2038,0,2038,162,2200,2200,0,0
4348,2019-02-01,1713,0,1713,137,1850,1850,0,0
4349,2019-02-01,277,0,277,13,290,290,0,0
4350,2019-02-01,519,0,519,41,560,560,0,0
4351,2019-02-01,241,0,241,19,260,260,0,0
4352,2019-02-01,908,0,908,72,980,980,0,0
4353,2019-02-01,417,0,417,33,450,450,0,0
4354,2019-02-01,1186,0,1186,94,1280,1280,0,0
4355,2019-02-01,1575,0,1575,125,1700,1700,0,0
4356,2019-02-01,399,0,399,31,430,430,0,0
4357,2019-02-01,1297,0,1297,103,1400,1400,0,0
4358,2019-02-01,518,0,518,32,550,550,0,0
4359,2019-02-01,1323,0,1323,97,1420,1420,0,0
4360,2019-02-01,510,0,510,40,550,550,0,0
4361,2019-02-01,1371,0,1371,109,1480,1480,0,0
4362,2019-02-01,621,0,621,49,670,670,0,0
4363,2019-02-01,269,0,269,21,290,290,0,0
4364,2019-02-01,2352,-500,1852,148,2000,2000,0,0
4365,2019-02-01,260,0,260,20,280,280,0,0
4366,2019-02-01,513,0,513,40,553,553,0,0
4367,2019-02-01,538,0,538,42,580,580,0,0
4368,2019-02-01,1389,0,1389,111,1500,1500,0,0
4369,2019-02-01,334,0,334,26,360,360,0,0
4370,2019-02-01,639,0,639,51,690,690,0,0
4371,2019-02-01,2130,0,2130,170,2300,2300,0,0
4372,2019-02-01,1575,0,1575,125,1700,1700,0,0
4373,2019-02-01,1575,0,1575,125,1700,1700,0,0
4374,2019-02-01,954,0,954,76,1030,1030,0,0
4375,2019-02-01,1371,0,1371,109,1480,1480,0,0
4376,2019-02-01,908,0,908,72,980,980,0,0
4377,2019-02-01,908,0,908,72,980,980,0,0
4378,2019-02-01,916,0,916,64,980,980,0,0
4379,2019-02-01,612,0,612,48,660,660,0,0
4380,2019-02-01,778,0,778,62,840,840,0,0
4381,2019-02-01,1926,0,1926,154,2080,2080,0,0
4382,2019-02-01,501,0,501,39,540,540,0,0
4383,2019-02-01,908,0,908,72,980,980,0,0
4384,2019-02-01,232,0,232,18,250,250,0,0
4385,2019-02-01,1213,0,1213,97,1310,1310,0,0
4386,2019-02-01,463,0,463,37,500,500,0,0
4387,2019-02-01,1658,0,1658,132,1790,1790,0,0
4388,2019-02-01,1815,0,1815,145,1960,1960,0,0
4389,2019-02-01,278,0,278,22,300,300,0,0
4390,2019-02-01,3186,0,3186,254,3440,3440,0,0
4391,2019-02-01,908,0,908,72,980,980,0,0
4392,2019-02-01,250,0,250,20,270,270,0,0
4393,2019-02-01,593,0,593,47,640,640,0,0
4394,2019-02-01,630,0,630,50,680,680,0,0
4395,2019-02-01,519,0,519,41,560,560,0,0
4396,2019-02-01,1260,0,1260,100,1360,1360,0,0
4397,2019-02-01,788,0,788,62,850,850,0,0
4398,2019-02-01,1084,0,1084,86,1170,1170,0,0
4399,2019-02-01,806,0,806,64,870,870,0,0
4400,2019-02-01,593,0,593,47,640,640,0,0
4401,2019-02-01,751,0,751,59,810,810,0,0
4402,2019-02-01,1510,0,1510,120,1630,1630,0,0
4403,2019-02-01,3195,0,3195,255,3450,3450,0,0
4404,2019-02-01,1112,0,1112,88,1200,1200,0,0
4405,2019-02-01,1204,0,1204,96,1300,1300,0,0
4406,2019-02-01,621,0,621,49,670,670,0,0
4407,2019-02-01,112,0,112,8,120,120,0,0
4408,2019-02-01,760,0,760,60,820,820,0,0
4409,2019-02-01,269,0,269,21,290,290,0,0
4410,2019-02-01,1065,0,1065,85,1150,1150,0,0
4411,2019-02-02,908,0,908,72,980,980,0,0
4412,2019-02-02,1167,0,1167,93,1260,1260,0,0
4413,2019-02-02,1121,0,1121,89,1210,1210,0,0
4414,2019-02-02,518,0,518,32,550,550,0,0
4415,2019-02-02,1001,0,1001,79,1080,0,1080,0
4416,2019-02-02,1815,0,1815,145,1960,1960,0,0
4417,2019-02-02,306,0,306,24,330,330,0,0
4418,2019-02-02,908,0,908,72,980,980,0,0
4419,2019-02-02,149,0,149,11,160,160,0,0
4420,2019-02-02,399,0,399,31,430,430,0,0
4421,2019-02-02,232,0,232,18,250,250,0,0
4422,2019-02-02,370,0,370,20,390,390,0,0
4423,2019-02-02,538,0,538,42,580,580,0,0
4424,2019-02-02,149,0,149,11,160,160,0,0
4425,2019-02-02,444,0,444,26,470,470,0,0
4426,2019-02-02,379,0,379,21,400,400,0,0
4427,2019-02-02,491,0,491,39,530,530,0,0
4428,2019-02-02,584,0,584,46,630,630,0,0
4429,2019-02-02,139,0,139,11,150,150,0,0
4430,2019-02-02,760,0,760,60,820,820,0,0
4431,2019-02-02,167,0,167,13,180,180,0,0
4432,2019-02-02,639,0,639,51,690,690,0,0
4433,2019-02-02,676,0,676,54,730,730,0,0
4434,2019-02-02,963,0,963,77,1040,1040,0,0
4435,2019-02-02,269,0,269,21,290,290,0,0
4436,2019-02-02,2399,0,2399,191,2590,2590,0,0
4437,2019-02-02,593,0,593,47,640,640,0,0
4438,2019-02-02,232,0,232,18,250,250,0,0
4439,2019-02-02,908,0,908,72,980,980,0,0
4440,2019-02-02,825,0,825,65,890,890,0,0
4441,2019-02-02,657,0,657,43,700,700,0,0
4442,2019-02-02,1658,0,1658,132,1790,1790,0,0
4443,2019-02-02,760,0,760,60,820,820,0,0
4444,2019-02-02,1352,0,1352,108,1460,1460,0,0
4445,2019-02-02,1325,0,1325,105,1430,1430,0,0
4446,2019-02-02,908,0,908,72,980,980,0,0
4447,2019-02-02,389,0,389,31,420,420,0,0
4448,2019-02-02,325,0,325,25,350,350,0,0
4449,2019-02-02,1186,0,1186,94,1280,1280,0,0
4450,2019-02-02,982,0,982,78,1060,1060,0,0
4451,2019-02-02,538,0,538,42,580,580,0,0
4452,2019-02-02,732,0,732,58,790,790,0,0
4453,2019-02-02,528,0,528,42,570,570,0,0
4454,2019-02-02,1241,0,1241,99,1340,1340,0,0
4455,2019-02-02,723,0,723,57,780,780,0,0
4456,2019-02-02,388,0,388,22,410,410,0,0
4457,2019-02-02,1621,0,1621,129,1750,1750,0,0
4458,2019-02-02,241,0,241,19,260,260,0,0
4459,2019-02-02,278,0,278,22,300,300,0,0
4460,2019-02-02,612,0,612,48,660,660,0,0
4461,2019-02-02,370,0,370,20,390,390,0,0
4462,2019-02-02,834,0,834,66,900,900,0,0
4463,2019-02-02,1815,0,1815,145,1960,1960,0,0
4464,2019-02-02,260,0,260,20,280,280,0,0
4465,2019-02-02,195,0,195,15,210,210,0,0
4466,2019-02-02,269,0,269,21,290,290,0,0
4467,2019-02-02,306,0,306,24,330,330,0,0
4468,2019-02-02,195,0,195,15,210,210,0,0
4469,2019-02-02,556,0,556,44,600,600,0,0
4470,2019-02-02,269,0,269,21,290,290,0,0
4471,2019-02-02,556,0,556,44,600,600,0,0
4472,2019-02-02,704,0,704,56,760,760,0,0
4473,2019-02-02,1315,0,1315,105,1420,1420,0,0
4474,2019-02-02,38,0,38,2,40,40,0,0
4475,2019-02-02,417,0,417,33,450,450,0,0
4476,2019-02-02,527,0,527,33,560,560,0,0
4477,2019-02-02,1815,0,1815,145,1960,1960,0,0
4478,2019-02-02,1399,0,1399,111,1510,0,1510,0
4479,2019-02-02,482,0,482,38,520,520,0,0
4480,2019-02-02,2723,0,2723,217,2940,2940,0,0
4481,2019-02-02,426,0,426,34,460,460,0,0
4482,2019-02-02,1815,0,1815,145,1960,0,1960,0
4483,2019-02-02,269,0,269,21,290,290,0,0
4484,2019-02-02,547,0,547,43,590,590,0,0
4485,2019-02-02,463,0,463,37,500,500,0,0
4486,2019-02-02,658,0,658,52,710,710,0,0
4487,2019-02-02,638,0,638,42,680,680,0,0
4488,2019-02-02,639,0,639,51,690,690,0,0
4489,2019-02-02,639,0,639,51,690,690,0,0
4490,2019-02-02,1815,0,1815,145,1960,1960,0,0
4491,2019-02-02,232,0,232,18,250,250,0,0
4492,2019-02-02,528,0,528,42,570,570,0,0
4493,2019-02-02,1102,0,1102,88,1190,1190,0,0
4494,2019-02-02,547,0,547,43,590,590,0,0
4495,2019-02-02,908,0,908,72,980,980,0,0
4496,2019-02-02,501,0,501,39,540,540,0,0
4497,2019-02-02,306,0,306,24,330,330,0,0
4498,2019-02-02,241,0,241,19,260,260,0,0
4499,2019-02-02,278,0,278,22,300,300,0,0
4500,2019-02-02,723,0,723,57,780,780,0,0
4501,2019-02-02,556,0,556,44,600,600,0,0
4502,2019-02-02,491,0,491,39,530,530,0,0
4503,2019-02-02,1852,0,1852,148,2000,2000,0,0
4504,2019-02-02,1121,0,1121,89,1210,1210,0,0
4505,2019-02-02,1575,0,1575,125,1700,1700,0,0
4506,2019-02-02,788,0,788,62,850,850,0,0
4507,2019-02-02,575,0,575,45,620,620,0,0
4508,2019-02-02,1334,0,1334,106,1440,1440,0,0
4509,2019-02-02,1019,0,1019,81,1100,1100,0,0
4510,2019-02-02,501,0,501,39,540,540,0,0
4511,2019-02-02,963,0,963,77,1040,1040,0,0
4512,2019-02-02,2399,0,2399,191,2590,2590,0,0
4513,2019-02-02,297,0,297,23,320,320,0,0
4514,2019-02-02,362,0,362,28,390,390,0,0
4515,2019-02-02,1556,0,1556,124,1680,1680,0,0
4516,2019-02-02,852,0,852,68,920,920,0,0
4517,2019-02-02,908,0,908,72,980,980,0,0
4518,2019-02-02,371,0,371,29,400,400,0,0
4519,2019-02-02,491,0,491,39,530,530,0,0
4520,2019-02-02,259,0,259,11,270,270,0,0
4521,2019-02-02,1871,0,1871,149,2020,2020,0,0
4522,2019-02-02,639,0,639,51,690,690,0,0
4523,2019-02-02,732,0,732,58,790,790,0,0
4524,2019-02-02,862,0,862,68,930,930,0,0
4525,2019-02-02,630,0,630,50,680,680,0,0
4526,2019-02-02,204,0,204,16,220,220,0,0
4527,2019-02-02,204,0,204,16,220,220,0,0
4528,2019-02-02,565,0,565,45,610,610,0,0
4529,2019-02-02,732,0,732,58,790,790,0,0
4530,2019-02-02,806,0,806,64,870,870,0,0
4531,2019-02-02,1056,0,1056,84,1140,1140,0,0
4532,2019-02-02,1028,0,1028,82,1110,1110,0,0
4533,2019-02-02,538,0,538,42,580,580,0,0
4534,2019-02-02,463,0,463,37,500,500,0,0
4535,2019-02-02,1306,0,1306,104,1410,1410,0,0
4536,2019-02-02,612,0,612,48,660,660,0,0
4537,2019-02-02,536,0,536,34,570,570,0,0
4538,2019-02-02,1575,0,1575,125,1700,1700,0,0
4539,2019-02-02,1223,0,1223,97,1320,1320,0,0
4540,2019-02-02,288,0,288,22,310,310,0,0
4541,2019-02-02,325,0,325,25,350,350,0,0
4542,2019-02-02,1602,0,1602,128,1730,1730,0,0
4543,2019-02-02,889,0,889,71,960,0,960,0
4544,2019-02-02,500,0,500,40,540,540,0,0
4545,2019-02-02,112,0,112,8,120,120,0,0
4546,2019-02-02,573,0,573,37,610,610,0,0
4547,2019-02-02,1815,0,1815,145,1960,1960,0,0
4548,2019-02-02,584,0,584,46,630,630,0,0
4549,2019-02-02,880,0,880,70,950,950,0,0
4550,2019-02-02,1195,0,1195,95,1290,1290,0,0
4551,2019-02-02,334,0,334,26,360,360,0,0
4552,2019-02-02,1056,0,1056,84,1140,1140,0,0
4553,2019-02-02,962,0,962,68,1030,1030,0,0
4554,2019-02-02,908,0,908,72,980,980,0,0
4555,2019-02-02,2908,0,2908,232,3140,3140,0,0
4556,2019-02-02,2038,0,2038,162,2200,2200,0,0
4557,2019-02-02,945,0,945,75,1020,1020,0,0
4558,2019-02-02,361,0,361,19,380,380,0,0
4559,2019-02-02,1417,0,1417,113,1530,1530,0,0
4560,2019-02-02,565,0,565,45,610,610,0,0
4561,2019-02-02,862,0,862,68,930,930,0,0
4562,2019-02-02,982,0,982,78,1060,1060,0,0
4563,2019-02-02,936,0,936,74,1010,1010,0,0
4564,2019-02-02,1575,0,1575,125,1700,1700,0,0
4565,2019-02-02,1852,0,1852,148,2000,2000,0,0
4566,2019-02-02,963,0,963,77,1040,1040,0,0
4567,2019-02-02,436,0,436,34,470,470,0,0
4568,2019-02-02,538,0,538,42,580,580,0,0
4569,2019-02-02,2362,0,2362,188,2550,2550,0,0
4570,2019-02-02,676,0,676,54,730,730,0,0
4571,2019-02-02,1010,0,1010,80,1090,1090,0,0
4572,2019-02-02,1417,0,1417,113,1530,1530,0,0
4573,2019-02-02,1149,0,1149,91,1240,1240,0,0
4574,2019-02-02,1899,0,1899,151,2050,2050,0,0
4575,2019-02-02,704,0,704,56,760,760,0,0
4576,2019-02-02,621,0,621,49,670,670,0,0
4577,2019-02-02,121,0,121,9,130,130,0,0
4578,2019-02-02,325,0,325,25,350,350,0,0
4579,2019-02-03,862,0,862,68,930,930,0,0
4580,2019-02-03,389,0,389,31,420,420,0,0
4581,2019-02-03,612,0,612,48,660,660,0,0
4582,2019-02-03,482,0,482,38,520,520,0,0
4583,2019-02-03,501,0,501,39,540,540,0,0
4584,2019-02-03,926,0,926,74,1000,1000,0,0
4585,2019-02-03,380,0,380,30,410,410,0,0
4586,2019-02-03,445,0,445,35,480,480,0,0
4587,2019-02-03,658,0,658,52,710,710,0,0
4588,2019-02-03,768,0,768,52,820,820,0,0
4589,2019-02-03,1519,0,1519,121,1640,1640,0,0
4590,2019-02-03,834,0,834,66,900,900,0,0
4591,2019-02-03,426,0,426,34,460,460,0,0
4592,2019-02-03,213,0,213,17,230,230,0,0
4593,2019-02-03,667,0,667,53,720,720,0,0
4594,2019-02-03,269,0,269,21,290,290,0,0
4595,2019-02-03,1362,0,1362,108,1470,1470,0,0
4596,2019-02-03,908,0,908,72,980,0,980,0
4597,2019-02-03,371,0,371,29,400,400,0,0
4598,2019-02-03,1176,0,1176,94,1270,1270,0,0
4599,2019-02-03,334,0,334,26,360,360,0,0
4600,2019-02-03,362,0,362,28,390,390,0,0
4601,2019-02-03,649,0,649,51,700,700,0,0
4602,2019-02-03,2028,0,2028,162,2190,2190,0,0
4603,2019-02-03,630,0,630,50,680,680,0,0
4604,2019-02-03,917,0,917,73,990,990,0,0
4605,2019-02-03,306,0,306,24,330,330,0,0
4606,2019-02-03,2528,0,2528,202,2730,0,2730,0
4607,2019-02-03,528,0,528,42,570,570,0,0
4608,2019-02-03,501,0,501,39,540,540,0,0
4609,2019-02-03,269,0,269,21,290,290,0,0
4610,2019-02-03,334,0,334,26,360,360,0,0
4611,2019-02-03,1315,0,1315,105,1420,1420,0,0
4612,2019-02-03,426,0,426,34,460,460,0,0
4613,2019-02-03,852,0,852,68,920,920,0,0
4614,2019-02-03,297,0,297,23,320,320,0,0
4615,2019-02-03,510,0,510,40,550,550,0,0
4616,2019-02-03,565,0,565,45,610,610,0,0
4617,2019-02-03,741,0,741,59,800,800,0,0
4618,2019-02-03,176,0,176,14,190,190,0,0
4619,2019-02-03,695,0,695,55,750,750,0,0
4620,2019-02-03,408,0,408,32,440,440,0,0
4621,2019-02-03,519,0,519,41,560,560,0,0
4622,2019-02-03,723,0,723,57,780,780,0,0
4623,2019-02-03,473,0,473,37,510,510,0,0
4624,2019-02-03,908,0,908,72,980,980,0,0
4625,2019-02-03,760,0,760,60,820,820,0,0
4626,2019-02-03,417,0,417,33,450,450,0,0
4627,2019-02-03,315,0,315,25,340,340,0,0
4628,2019-02-03,908,0,908,72,980,980,0,0
4629,2019-02-03,1075,0,1075,85,1160,1160,0,0
4630,2019-02-03,519,0,519,41,560,560,0,0
4631,2019-02-03,1010,0,1010,80,1090,1090,0,0
4632,2019-02-03,473,0,473,37,510,510,0,0
4633,2019-02-03,1158,0,1158,92,1250,1250,0,0
4634,2019-02-03,926,0,926,74,1000,1000,0,0
4635,2019-02-03,1204,0,1204,96,1300,1300,0,0
4636,2019-02-03,1463,0,1463,117,1580,1580,0,0
4637,2019-02-03,306,0,306,24,330,330,0,0
4638,2019-02-03,510,0,510,40,550,550,0,0
4639,2019-02-03,1195,0,1195,95,1290,1290,0,0
4640,2019-02-03,908,0,908,72,980,980,0,0
4641,2019-02-03,1093,0,1093,87,1180,1180,0,0
4642,2019-02-03,575,0,575,45,620,620,0,0
4643,2019-02-03,788,0,788,62,850,850,0,0
4644,2019-02-03,1575,0,1575,125,1700,1700,0,0
4645,2019-02-03,788,0,788,62,850,850,0,0
4646,2019-02-03,1575,0,1575,125,1700,0,1700,0
4647,2019-02-03,1472,0,1472,117,1589,1589,0,0
4648,2019-02-03,734,-156,578,46,624,624,0,0
4649,2019-02-03,1019,0,1019,81,1100,1100,0,0
4650,2019-02-03,695,0,695,55,750,750,0,0
4651,2019-02-03,139,0,139,11,150,150,0,0
4652,2019-02-03,547,0,547,43,590,590,0,0
4653,2019-02-03,278,0,278,22,300,300,0,0
4654,2019-02-03,371,0,371,29,400,400,0,0
4655,2019-02-03,538,0,538,42,580,580,0,0
4656,2019-02-03,593,0,593,47,640,640,0,0
4657,2019-02-03,676,0,676,54,730,730,0,0
4658,2019-02-03,584,0,584,46,630,630,0,0
4659,2019-02-03,741,0,741,59,800,800,0,0
4660,2019-02-03,482,0,482,38,520,520,0,0
4661,2019-02-03,510,0,510,40,550,550,0,0
4662,2019-02-03,491,0,491,39,530,530,0,0
4663,2019-02-03,389,0,389,31,420,420,0,0
4664,2019-02-03,112,0,112,8,120,120,0,0
4665,2019-02-03,852,0,852,68,920,920,0,0
4666,2019-02-03,704,0,704,56,760,760,0,0
4667,2019-02-03,797,0,797,63,860,860,0,0
4668,2019-02-03,232,0,232,18,250,250,0,0
4669,2019-02-03,519,0,519,41,560,560,0,0
4670,2019-02-03,352,0,352,28,380,380,0,0
4671,2019-02-03,908,0,908,72,980,980,0,0
4672,2019-02-03,649,0,649,51,700,700,0,0
4673,2019-02-03,834,0,834,66,900,900,0,0
4674,2019-02-03,297,0,297,23,320,320,0,0
4675,2019-02-03,249,0,249,11,260,260,0,0
4676,2019-02-03,908,0,908,72,980,980,0,0
4677,2019-02-03,352,0,352,28,380,380,0,0
4678,2019-02-03,306,0,306,24,330,330,0,0
4679,2019-02-03,1815,0,1815,145,1960,0,1960,0
4680,2019-02-03,880,0,880,70,950,950,0,0
4681,2019-02-03,1093,0,1093,87,1180,1180,0,0
4682,2019-02-03,538,0,538,42,580,580,0,0
4683,2019-02-03,1056,0,1056,84,1140,1140,0,0
4684,2019-02-03,917,0,917,73,990,990,0,0
4685,2019-02-03,917,0,917,73,990,990,0,0
4686,2019-02-03,686,0,686,54,740,740,0,0
4687,2019-02-03,769,0,769,61,830,830,0,0
4688,2019-02-03,1203,0,1203,87,1290,0,1290,0
4689,2019-02-03,695,0,695,55,750,750,0,0
4690,2019-02-03,676,0,676,54,730,730,0,0
4691,2019-02-03,926,0,926,74,1000,1000,0,0
4692,2019-02-03,1575,0,1575,125,1700,0,1700,0
4693,2019-02-03,1797,0,1797,143,1940,1940,0,0
4694,2019-02-03,788,0,788,62,850,850,0,0
4695,2019-02-03,362,0,362,28,390,390,0,0
4696,2019-02-03,834,0,834,66,900,900,0,0
4697,2019-02-03,963,0,963,77,1040,1040,0,0
4698,2019-02-03,417,0,417,33,450,450,0,0
4699,2019-02-03,1556,0,1556,124,1680,1680,0,0
4700,2019-02-03,1065,0,1065,85,1150,1150,0,0
4701,2019-02-03,602,0,602,48,650,650,0,0
4702,2019-02-03,510,0,510,40,550,550,0,0
4703,2019-02-03,436,0,436,34,470,470,0,0
4704,2019-02-03,575,0,575,45,620,620,0,0
4705,2019-02-03,223,0,223,17,240,240,0,0
4706,2019-02-04,695,0,695,55,750,750,0,0
4707,2019-02-04,584,0,584,46,630,630,0,0
4708,2019-02-04,852,0,852,68,920,920,0,0
4709,2019-02-04,186,0,186,14,200,200,0,0
4710,2019-02-04,1593,0,1593,127,1720,1720,0,0
4711,2019-02-04,288,0,288,22,310,310,0,0
4712,2019-02-04,278,0,278,22,300,300,0,0
4713,2019-02-04,473,0,473,37,510,510,0,0
4714,2019-02-04,1112,0,1112,88,1200,1200,0,0
4715,2019-02-04,908,0,908,72,980,980,0,0
4716,2019-02-04,236,-50,186,14,200,200,0,0
4717,2019-02-04,278,0,278,22,300,300,0,0
4718,2019-02-04,908,0,908,72,980,980,0,0
4719,2019-02-04,658,0,658,52,710,710,0,0
4720,2019-02-04,954,0,954,76,1030,1030,0,0
4721,2019-02-04,362,0,362,28,390,390,0,0
4722,2019-02-04,519,0,519,41,560,560,0,0
4723,2019-02-04,334,0,334,26,360,360,0,0
4724,2019-02-04,417,0,417,33,450,450,0,0
4725,2019-02-04,528,0,528,42,570,570,0,0
4726,2019-02-04,269,0,269,21,290,290,0,0
4727,2019-02-04,454,0,454,36,490,490,0,0
4728,2019-02-04,630,0,630,50,680,680,0,0
4729,2019-02-04,380,0,380,30,410,410,0,0
4730,2019-02-04,908,0,908,72,980,980,0,0
4731,2019-02-04,908,0,908,72,980,980,0,0
4732,2019-02-04,241,0,241,19,260,260,0,0
4733,2019-02-04,908,0,908,72,980,980,0,0
4734,2019-02-04,815,0,815,65,880,880,0,0
4735,2019-02-04,593,0,593,47,640,640,0,0
4736,2019-02-04,649,0,649,51,700,700,0,0
4737,2019-02-04,638,0,638,42,680,680,0,0
4738,2019-02-04,686,0,686,54,740,740,0,0
4739,2019-02-04,908,0,908,72,980,980,0,0
4740,2019-02-04,371,0,371,29,400,400,0,0
4741,2019-02-04,834,0,834,66,900,900,0,0
4742,2019-02-04,695,0,695,55,750,750,0,0
4743,2019-02-04,249,0,249,11,260,260,0,0
4744,2019-02-04,232,0,232,18,250,250,0,0
4745,2019-02-04,213,0,213,17,230,230,0,0
4746,2019-02-04,343,0,343,27,370,370,0,0
4747,2019-02-04,917,0,917,73,990,990,0,0
4748,2019-02-04,565,0,565,45,610,610,0,0
4749,2019-02-04,1001,0,1001,79,1080,1080,0,0
4750,2019-02-04,445,0,445,35,480,480,0,0
4751,2019-02-04,778,0,778,62,840,840,0,0
4752,2019-02-04,1149,0,1149,91,1240,1240,0,0
4753,2019-02-04,232,0,232,18,250,250,0,0
4754,2019-02-04,149,0,149,11,160,160,0,0
4755,2019-02-04,232,0,232,18,250,250,0,0
4756,2019-02-04,519,0,519,41,560,560,0,0
4757,2019-02-04,926,0,926,74,1000,1000,0,0
4758,2019-02-04,1296,0,1296,94,1390,1390,0,0
4759,2019-02-04,797,0,797,63,860,860,0,0
4760,2019-02-04,612,0,612,48,660,660,0,0
4761,2019-02-04,1038,0,1038,82,1120,1120,0,0
4762,2019-02-04,639,0,639,51,690,690,0,0
4763,2019-02-04,1815,0,1815,145,1960,1960,0,0
4764,2019-02-04,362,0,362,28,390,390,0,0
4765,2019-02-04,908,0,908,72,980,980,0,0
4766,2019-02-04,1815,0,1815,145,1960,0,1960,0
4767,2019-02-04,630,0,630,50,680,680,0,0
4768,2019-02-04,426,0,426,34,460,460,0,0
4769,2019-02-04,666,0,666,44,710,710,0,0
4770,2019-02-04,731,0,731,49,780,780,0,0
4771,2019-02-04,1371,0,1371,109,1480,1480,0,0
4772,2019-02-04,426,0,426,34,460,460,0,0
4773,2019-02-04,176,0,176,14,190,190,0,0
4774,2019-02-04,665,0,665,35,700,700,0,0
4775,2019-02-04,278,0,278,22,300,300,0,0
4776,2019-02-04,1852,0,1852,148,2000,2000,0,0
4777,2019-02-04,1399,0,1399,111,1510,1510,0,0
4778,2019-02-04,667,0,667,53,720,720,0,0
4779,2019-02-04,788,0,788,62,850,850,0,0
4780,2019-02-04,352,0,352,28,380,380,0,0
4781,2019-02-04,556,0,556,44,600,600,0,0
4782,2019-02-04,398,0,398,22,420,420,0,0
4783,2019-02-04,139,0,139,11,150,150,0,0
4784,2019-02-04,277,0,277,13,290,290,0,0
4785,2019-02-04,648,0,648,42,690,690,0,0
4786,2019-02-04,565,0,565,45,610,610,0,0
4787,2019-02-04,269,0,269,21,290,290,0,0
4788,2019-02-04,723,0,723,57,780,780,0,0
4789,2019-02-04,232,0,232,18,250,250,0,0
4790,2019-02-04,102,0,102,8,110,110,0,0
4791,2019-02-04,1454,0,1454,116,1570,1570,0,0
4792,2019-02-04,1019,0,1019,81,1100,1100,0,0
4793,2019-02-04,260,0,260,20,280,280,0,0
4794,2019-02-04,1093,0,1093,87,1180,1180,0,0
4795,2019-02-04,815,0,815,65,880,880,0,0
4796,2019-02-04,380,0,380,30,410,410,0,0
4797,2019-02-04,1158,0,1158,92,1250,1250,0,0
4798,2019-02-04,788,0,788,62,850,850,0,0
4799,2019-02-04,223,0,223,17,240,240,0,0
4800,2019-02-04,334,0,334,26,360,360,0,0
4801,2019-02-04,704,0,704,56,760,760,0,0
4802,2019-02-04,371,0,371,29,400,400,0,0
4803,2019-02-04,741,0,741,59,800,800,0,0
4804,2019-02-04,1158,0,1158,92,1250,1250,0,0
4805,2019-02-04,612,0,612,48,660,660,0,0
4806,2019-02-04,269,0,269,21,290,290,0,0
4807,2019-02-04,788,0,788,62,850,0,850,0
4808,2019-02-04,278,0,278,22,300,300,0,0
4809,2019-02-04,788,0,788,62,850,850,0,0
4810,2019-02-04,926,0,926,74,1000,1000,0,0
4811,2019-02-04,306,0,306,24,330,330,0,0
4812,2019-02-04,538,0,538,42,580,580,0,0
4813,2019-02-04,232,0,232,18,250,250,0,0
4814,2019-02-04,908,0,908,72,980,980,0,0
4815,2019-02-04,908,0,908,72,980,980,0,0
4816,2019-02-04,1371,0,1371,109,1480,1480,0,0
4817,2019-02-04,621,0,621,49,670,670,0,0
4818,2019-02-04,491,0,491,39,530,530,0,0
4819,2019-02-04,723,0,723,57,780,780,0,0
4820,2019-02-04,1167,0,1167,93,1260,1260,0,0
4821,2019-02-04,426,0,426,34,460,460,0,0
4822,2019-02-04,556,0,556,44,600,600,0,0
4823,2019-02-04,788,0,788,62,850,850,0,0
4824,2019-02-04,149,0,149,11,160,160,0,0
4825,2019-02-04,343,0,343,27,370,370,0,0
4826,2019-02-04,454,0,454,36,490,490,0,0
4827,2019-02-04,269,0,269,21,290,290,0,0
4828,2019-02-04,788,0,788,62,850,850,0,0
4829,2019-02-04,250,0,250,20,270,270,0,0
4830,2019-02-04,463,0,463,37,500,500,0,0
4831,2019-02-04,1010,0,1010,80,1090,1090,0,0
4832,2019-02-04,889,0,889,71,960,960,0,0
4833,2019-02-04,788,0,788,62,850,850,0,0
4834,2019-02-04,371,0,371,29,400,400,0,0
4835,2019-02-04,1436,0,1436,114,1550,1550,0,0
4836,2019-02-04,519,0,519,41,560,560,0,0
4837,2019-02-04,843,0,843,67,910,910,0,0
4838,2019-02-04,936,0,936,74,1010,1010,0,0
4839,2019-02-04,630,0,630,50,680,680,0,0
4840,2019-02-04,1612,0,1612,128,1740,1740,0,0
4841,2019-02-04,501,0,501,39,540,540,0,0
4842,2019-02-04,593,0,593,47,640,640,0,0
4843,2019-02-05,207,-44,163,13,176,176,0,0
4844,2019-02-05,260,0,260,20,280,280,0,0
4845,2019-02-05,1102,0,1102,88,1190,1190,0,0
4846,2019-02-05,297,0,297,23,320,320,0,0
4847,2019-02-05,251,0,251,19,270,270,0,0
4848,2019-02-05,186,0,186,14,200,200,0,0
4849,2019-02-05,834,0,834,66,900,900,0,0
4850,2019-02-05,269,0,269,21,290,290,0,0
4851,2019-02-05,1519,0,1519,121,1640,1640,0,0
4852,2019-02-05,223,0,223,17,240,240,0,0
4853,2019-02-05,1445,0,1445,115,1560,1560,0,0
4854,2019-02-05,510,0,510,40,550,550,0,0
4855,2019-02-05,760,0,760,60,820,820,0,0
4856,2019-02-05,277,0,277,13,290,290,0,0
4857,2019-02-05,649,0,649,51,700,700,0,0
4858,2019-02-05,547,0,547,43,590,590,0,0
4859,2019-02-05,686,0,686,54,740,740,0,0
4860,2019-02-05,676,0,676,54,730,730,0,0
4861,2019-02-05,565,0,565,45,610,610,0,0
4862,2019-02-05,1186,0,1186,94,1280,1280,0,0
4863,2019-02-05,500,0,500,40,540,540,0,0
4864,2019-02-05,195,0,195,15,210,210,0,0
4865,2019-02-05,538,0,538,42,580,580,0,0
4866,2019-02-06,260,0,260,20,280,280,0,0
4867,2019-02-06,973,0,973,77,1050,1050,0,0
4868,2019-02-06,1075,0,1075,85,1160,1160,0,0
4869,2019-02-06,1028,0,1028,82,1110,1110,0,0
4870,2019-02-06,788,0,788,62,850,850,0,0
4871,2019-02-06,501,0,501,39,540,540,0,0
4872,2019-02-06,306,0,306,24,330,330,0,0
4873,2019-02-06,973,0,973,77,1050,1050,0,0
4874,2019-02-06,1528,0,1528,122,1650,1650,0,0
4875,2019-02-06,516,0,516,14,530,530,0,0
4876,2019-02-06,731,0,731,49,780,780,0,0
4877,2019-02-06,575,0,575,45,620,620,0,0
4878,2019-02-06,1815,0,1815,145,1960,1960,0,0
4879,2019-02-06,528,0,528,42,570,570,0,0
4880,2019-02-06,667,0,667,53,720,720,0,0
4881,2019-02-06,908,0,908,72,980,980,0,0
4882,2019-02-06,908,0,908,72,980,980,0,0
4883,2019-02-06,380,0,380,30,410,410,0,0
4884,2019-02-06,547,0,547,43,590,590,0,0
4885,2019-02-06,908,0,908,72,980,980,0,0
4886,2019-02-06,510,0,510,40,550,550,0,0
4887,2019-02-06,741,0,741,59,800,800,0,0
4888,2019-02-06,454,0,454,36,490,490,0,0
4889,2019-02-06,315,0,315,25,340,340,0,0
4890,2019-02-06,499,-106,393,31,424,424,0,0
4891,2019-02-06,352,0,352,28,380,380,0,0
4892,2019-02-06,908,0,908,72,980,980,0,0
4893,2019-02-06,501,0,501,39,540,540,0,0
4894,2019-02-06,584,0,584,46,630,630,0,0
4895,2019-02-06,380,0,380,30,410,0,410,0
4896,2019-02-06,695,0,695,55,750,750,0,0
4897,2019-02-06,1101,0,1101,79,1180,1180,0,0
4898,2019-02-06,510,0,510,40,550,550,0,0
4899,2019-02-06,306,0,306,24,330,330,0,0
4900,2019-02-06,417,0,417,33,450,450,0,0
4901,2019-02-06,482,0,482,38,520,0,520,0
4902,2019-02-06,112,0,112,8,120,120,0,0
4903,2019-02-06,528,0,528,42,570,570,0,0
4904,2019-02-06,1936,0,1936,154,2090,2090,0,0
4905,2019-02-06,908,0,908,72,980,980,0,0
4906,2019-02-06,2093,0,2093,167,2260,2260,0,0
4907,2019-02-06,362,0,362,28,390,390,0,0
4908,2019-02-06,815,0,815,65,880,880,0,0
4909,2019-02-06,149,0,149,11,160,160,0,0
4910,2019-02-06,788,0,788,62,850,850,0,0
4911,2019-02-06,575,0,575,45,620,620,0,0
4912,2019-02-06,2158,0,2158,172,2330,2330,0,0
4913,2019-02-06,658,0,658,52,710,710,0,0
4914,2019-02-06,788,0,788,62,850,850,0,0
4915,2019-02-06,945,0,945,75,1020,1020,0,0
4916,2019-02-06,556,0,556,44,600,600,0,0
4917,2019-02-06,1010,0,1010,80,1090,1090,0,0
4918,2019-02-06,501,0,501,39,540,540,0,0
4919,2019-02-06,204,0,204,16,220,220,0,0
4920,2019-02-06,343,0,343,27,370,370,0,0
4921,2019-02-06,1093,0,1093,87,1180,1180,0,0
4922,2019-02-06,1232,0,1232,98,1330,1330,0,0
4923,2019-02-06,788,0,788,62,850,850,0,0
4924,2019-02-06,1575,0,1575,125,1700,1700,0,0
4925,2019-02-06,389,0,389,31,420,420,0,0
4926,2019-02-06,528,0,528,42,570,570,0,0
4927,2019-02-06,593,0,593,47,640,640,0,0
4928,2019-02-06,149,0,149,11,160,160,0,0
4929,2019-02-06,2001,0,2001,159,2160,2160,0,0
4930,2019-02-06,1065,0,1065,85,1150,1150,0,0
4931,2019-02-06,1075,0,1075,85,1160,1160,0,0
4932,2019-02-06,452,-96,356,28,384,384,0,0
4933,2019-02-06,426,0,426,34,460,0,460,0
4934,2019-02-06,277,0,277,13,290,290,0,0
4935,2019-02-06,917,0,917,73,990,990,0,0
4936,2019-02-06,686,0,686,54,740,740,0,0
4937,2019-02-06,1325,0,1325,105,1430,1430,0,0
4938,2019-02-06,204,0,204,16,220,220,0,0
4939,2019-02-06,445,0,445,35,480,480,0,0
4940,2019-02-06,760,0,760,60,820,0,820,0
4941,2019-02-06,334,0,334,26,360,360,0,0
4942,2019-02-06,519,0,519,41,560,560,0,0
4943,2019-02-06,556,0,556,44,600,600,0,0
4944,2019-02-06,528,0,528,42,570,570,0,0
4945,2019-02-06,251,0,251,19,270,270,0,0
4946,2019-02-06,639,0,639,51,690,690,0,0
4947,2019-02-06,1084,0,1084,86,1170,1170,0,0
4948,2019-02-06,797,0,797,63,860,860,0,0
4949,2019-02-06,380,0,380,30,410,410,0,0
4950,2019-02-06,445,0,445,35,480,480,0,0
4951,2019-02-06,1093,0,1093,87,1180,1180,0,0
4952,2019-02-06,1389,0,1389,111,1500,1500,0,0
4953,2019-02-06,399,0,399,31,430,430,0,0
4954,2019-02-06,389,0,389,31,420,420,0,0
4955,2019-02-06,899,0,899,71,970,970,0,0
4956,2019-02-07,806,0,806,64,870,870,0,0
4957,2019-02-07,741,0,741,59,800,800,0,0
4958,2019-02-07,417,0,417,33,450,450,0,0
4959,2019-02-07,1297,0,1297,103,1400,1400,0,0
4960,2019-02-07,251,0,251,19,270,270,0,0
4961,2019-02-07,621,0,621,49,670,670,0,0
4962,2019-02-07,538,0,538,42,580,580,0,0
4963,2019-02-07,528,0,528,42,570,570,0,0
4964,2019-02-07,908,0,908,72,980,980,0,0
4965,2019-02-07,371,0,371,29,400,400,0,0
4966,2019-02-07,473,0,473,37,510,510,0,0
4967,2019-02-07,306,0,306,24,330,330,0,0
4968,2019-02-07,334,0,334,26,360,360,0,0
4969,2019-02-07,862,0,862,68,930,930,0,0
4970,2019-02-07,288,0,288,22,310,310,0,0
4971,2019-02-07,556,0,556,44,600,600,0,0
4972,2019-02-07,1621,0,1621,129,1750,1750,0,0
4973,2019-02-07,704,0,704,56,760,760,0,0
4974,2019-02-07,1371,0,1371,109,1480,1480,0,0
4975,2019-02-07,612,0,612,48,660,660,0,0
4976,2019-02-07,436,0,436,34,470,470,0,0
4977,2019-02-07,510,0,510,40,550,550,0,0
4978,2019-02-07,1815,0,1815,145,1960,1960,0,0
4979,2019-02-07,306,0,306,24,330,330,0,0
4980,2019-02-07,510,0,510,40,550,550,0,0
4981,2019-02-07,232,0,232,18,250,250,0,0
4982,2019-02-07,472,0,472,28,500,500,0,0
4983,2019-02-07,538,0,538,42,580,580,0,0
4984,2019-02-07,473,0,473,37,510,510,0,0
4985,2019-02-07,741,0,741,59,800,800,0,0
4986,2019-02-07,223,0,223,17,240,240,0,0
4987,2019-02-07,695,0,695,55,750,750,0,0
4988,2019-02-07,1232,0,1232,98,1330,1330,0,0
4989,2019-02-07,463,0,463,37,500,500,0,0
4990,2019-02-07,436,0,436,34,470,470,0,0
4991,2019-02-07,575,0,575,45,620,620,0,0
4992,2019-02-07,1222,0,1222,88,1310,1310,0,0
4993,2019-02-07,334,0,334,26,360,0,360,0
4994,2019-02-07,436,0,436,34,470,470,0,0
4995,2019-02-07,1062,0,1062,58,1120,1120,0,0
4996,2019-02-07,794,-85,709,56,765,765,0,0
4997,2019-02-07,1232,0,1232,98,1330,1330,0,0
4998,2019-02-07,908,0,908,72,980,980,0,0
4999,2019-02-07,1389,0,1389,111,1500,1500,0,0
5000,2019-02-07,232,0,232,18,250,250,0,0
5001,2019-02-07,149,0,149,11,160,160,0,0
5002,2019-02-07,1575,0,1575,125,1700,1700,0,0
5003,2019-02-07,815,0,815,65,880,880,0,0
5004,2019-02-07,788,0,788,62,850,850,0,0
5005,2019-02-07,251,0,251,19,270,270,0,0
5006,2019-02-07,334,0,334,26,360,360,0,0
5007,2019-02-07,639,0,639,51,690,690,0,0
5008,2019-02-07,797,0,797,63,860,860,0,0
5009,2019-02-07,2528,0,2528,202,2730,2730,0,0
5010,2019-02-07,399,0,399,31,430,430,0,0
5011,2019-02-07,723,0,723,57,780,780,0,0
5012,2019-02-07,463,0,463,37,500,500,0,0
5013,2019-02-07,445,0,445,35,480,480,0,0
5014,2019-02-07,658,0,658,52,710,710,0,0
5015,2019-02-07,204,0,204,16,220,220,0,0
5016,2019-02-07,288,0,288,22,310,310,0,0
5017,2019-02-07,269,0,269,21,290,290,0,0
5018,2019-02-07,499,-106,393,31,424,424,0,0
5019,2019-02-07,232,0,232,18,250,250,0,0
5020,2019-02-07,1075,0,1075,85,1160,1160,0,0
5021,2019-02-07,1176,0,1176,94,1270,1270,0,0
5022,2019-02-07,292,-62,230,18,248,248,0,0
5023,2019-02-07,602,0,602,48,650,650,0,0
5024,2019-02-07,741,0,741,59,800,800,0,0
5025,2019-02-07,408,0,408,32,440,440,0,0
5026,2019-02-07,908,0,908,72,980,980,0,0
5027,2019-02-07,686,0,686,54,740,740,0,0
5028,2019-02-07,297,0,297,23,320,320,0,0
5029,2019-02-07,908,0,908,72,980,980,0,0
5030,2019-02-07,436,0,436,34,470,470,0,0
5031,2019-02-07,213,0,213,17,230,230,0,0
5032,2019-02-07,834,0,834,66,900,900,0,0
5033,2019-02-07,908,0,908,72,980,980,0,0
5034,2019-02-07,908,0,908,72,980,980,0,0
5035,2019-02-07,1223,0,1223,97,1320,1320,0,0
5036,2019-02-07,519,0,519,41,560,560,0,0
5037,2019-02-07,1686,0,1686,134,1820,1820,0,0
5038,2019-02-07,213,0,213,17,230,230,0,0
5039,2019-02-07,870,0,870,60,930,930,0,0
5040,2019-02-07,852,0,852,68,920,920,0,0
5041,2019-02-07,278,0,278,22,300,300,0,0
5042,2019-02-07,1065,0,1065,85,1150,1150,0,0
5043,2019-02-07,1149,0,1149,91,1240,1240,0,0
5044,2019-02-07,1251,0,1251,99,1350,1350,0,0
5045,2019-02-07,1027,0,1027,73,1100,1100,0,0
5046,2019-02-08,1491,0,1491,119,1610,1610,0,0
5047,2019-02-08,788,0,788,62,850,850,0,0
5048,2019-02-08,908,0,908,72,980,980,0,0
5049,2019-02-08,908,0,908,72,980,980,0,0
5050,2019-02-08,491,0,491,39,530,530,0,0
5051,2019-02-08,232,0,232,18,250,250,0,0
5052,2019-02-08,454,0,454,36,490,490,0,0
5053,2019-02-08,843,0,843,67,910,910,0,0
5054,2019-02-08,315,0,315,25,340,340,0,0
5055,2019-02-08,1751,0,1751,139,1890,1890,0,0
5056,2019-02-08,788,0,788,62,850,850,0,0
5057,2019-02-08,297,0,297,23,320,320,0,0
5058,2019-02-08,2092,0,2092,158,2250,2250,0,0
5059,2019-02-08,306,0,306,24,330,330,0,0
5060,2019-02-08,1389,0,1389,111,1500,1500,0,0
5061,2019-02-08,2399,0,2399,191,2590,0,2590,0
5062,2019-02-08,1815,0,1815,145,1960,1960,0,0
5063,2019-02-08,139,0,139,11,150,150,0,0
5064,2019-02-08,538,0,538,42,580,580,0,0
5065,2019-02-08,843,0,843,67,910,910,0,0
5066,2019-02-08,1815,0,1815,145,1960,1960,0,0
5067,2019-02-08,1417,0,1417,113,1530,1530,0,0
5068,2019-02-08,538,0,538,42,580,580,0,0
5069,2019-02-08,982,0,982,78,1060,1060,0,0
5070,2019-02-08,1389,0,1389,111,1500,1500,0,0
5071,2019-02-08,306,0,306,24,330,330,0,0
5072,2019-02-08,352,0,352,28,380,380,0,0
5073,2019-02-08,1815,0,1815,145,1960,1960,0,0
5074,2019-02-08,500,0,500,40,540,540,0,0
5075,2019-02-08,760,0,760,60,820,820,0,0
5076,2019-02-08,1065,0,1065,85,1150,1150,0,0
5077,2019-02-08,825,0,825,65,890,890,0,0
5078,2019-02-08,47,0,47,3,50,50,0,0
5079,2019-02-08,797,0,797,63,860,0,860,0
5080,2019-02-08,463,0,463,37,500,0,500,0
5081,2019-02-08,408,0,408,32,440,440,0,0
5082,2019-02-08,-463,0,-463,-37,-500,-500,0,0
5083,2019-02-08,463,0,463,37,500,500,0,0
5084,2019-02-08,463,0,463,37,500,500,0,0
5085,2019-02-08,463,0,463,37,500,500,0,0
5086,2019-02-08,630,0,630,50,680,680,0,0
5087,2019-02-08,797,0,797,63,860,860,0,0
5088,2019-02-08,47,0,47,3,50,50,0,0
5089,2019-02-08,630,0,630,50,680,680,0,0
5090,2019-02-08,501,0,501,39,540,540,0,0
5091,2019-02-08,686,0,686,54,740,740,0,0
5092,2019-02-08,584,0,584,46,630,630,0,0
5093,2019-02-08,269,0,269,21,290,290,0,0
5094,2019-02-08,408,0,408,32,440,440,0,0
5095,2019-02-08,1167,0,1167,93,1260,1260,0,0
5096,2019-02-08,102,0,102,8,110,110,0,0
5097,2019-02-08,1010,0,1010,80,1090,1090,0,0
5098,2019-02-08,306,0,306,24,330,330,0,0
5099,2019-02-08,704,0,704,56,760,760,0,0
5100,2019-02-08,871,0,871,69,940,940,0,0
5101,2019-02-08,815,0,815,65,880,880,0,0
5102,2019-02-08,149,0,149,11,160,160,0,0
5103,2019-02-08,760,0,760,60,820,820,0,0
5104,2019-02-08,584,0,584,46,630,630,0,0
5105,2019-02-08,260,0,260,20,280,280,0,0
5106,2019-02-08,408,0,408,32,440,440,0,0
5107,2019-02-08,510,0,510,40,550,550,0,0
5108,2019-02-08,1549,0,1549,71,1620,1620,0,0
5109,2019-02-08,454,0,454,36,490,490,0,0
5110,2019-02-08,1399,0,1399,111,1510,1510,0,0
5111,2019-02-08,982,0,982,78,1060,1060,0,0
5112,2019-02-08,323,0,323,17,340,340,0,0
5113,2019-02-08,852,0,852,68,920,920,0,0
5114,2019-02-08,825,0,825,65,890,890,0,0
5115,2019-02-08,1380,0,1380,110,1490,1490,0,0
5116,2019-02-08,1852,0,1852,148,2000,2000,0,0
5117,2019-02-08,1575,0,1575,125,1700,1700,0,0
5118,2019-02-08,223,0,223,17,240,240,0,0
5119,2019-02-08,667,0,667,53,720,720,0,0
5120,2019-02-08,612,0,612,48,660,660,0,0
5121,2019-02-08,612,0,612,48,660,660,0,0
5122,2019-02-08,528,0,528,42,570,570,0,0
5123,2019-02-08,713,0,713,57,770,770,0,0
5124,2019-02-08,362,0,362,28,390,390,0,0
5125,2019-02-08,278,0,278,22,300,300,0,0
5126,2019-02-08,926,0,926,74,1000,1000,0,0
5127,2019-02-08,371,0,371,29,400,400,0,0
5128,2019-02-08,834,0,834,66,900,900,0,0
5129,2019-02-08,1204,0,1204,96,1300,1300,0,0
5130,2019-02-08,260,0,260,20,280,280,0,0
5131,2019-02-08,362,0,362,28,390,390,0,0
5132,2019-02-08,1491,0,1491,119,1610,1610,0,0
5133,2019-02-08,491,0,491,39,530,530,0,0
5134,2019-02-08,462,0,462,28,490,490,0,0
5135,2019-02-08,241,0,241,19,260,260,0,0
5136,2019-02-08,104,-22,82,6,88,88,0,0
5137,2019-02-08,232,0,232,18,250,250,0,0
5138,2019-02-08,223,0,223,17,240,240,0,0
5139,2019-02-08,269,0,269,21,290,290,0,0
5140,2019-02-08,121,0,121,9,130,130,0,0
5141,2019-02-08,713,0,713,57,770,770,0,0
5142,2019-02-08,1658,0,1658,132,1790,0,1790,0
5143,2019-02-08,426,0,426,34,460,460,0,0
5144,2019-02-08,1926,0,1926,154,2080,2080,0,0
5145,2019-02-08,2778,0,2778,222,3000,3000,0,0
5146,2019-02-08,1649,0,1649,131,1780,1780,0,0
5147,2019-02-08,1815,0,1815,145,1960,1960,0,0
5148,2019-02-08,908,0,908,72,980,980,0,0
5149,2019-02-08,1047,0,1047,83,1130,1130,0,0
5150,2019-02-08,778,0,778,62,840,840,0,0
5151,2019-02-08,908,0,908,72,980,980,0,0
5152,2019-02-08,908,0,908,72,980,980,0,0
5153,2019-02-08,1306,0,1306,104,1410,1410,0,0
5154,2019-02-08,2723,0,2723,217,2940,2940,0,0
5155,2019-02-08,1778,0,1778,142,1920,1920,0,0
5156,2019-02-08,908,0,908,72,980,980,0,0
5157,2019-02-08,584,0,584,46,630,630,0,0
5158,2019-02-08,1575,0,1575,125,1700,1700,0,0
5159,2019-02-08,741,0,741,59,800,800,0,0
5160,2019-02-08,1305,0,1305,95,1400,1400,0,0
5161,2019-02-08,963,0,963,77,1040,1040,0,0
5162,2019-02-08,278,0,278,22,300,300,0,0
5163,2019-02-08,2509,0,2509,191,2700,2700,0,0
5164,2019-02-08,630,0,630,50,680,680,0,0
5165,2019-02-08,2028,0,2028,162,2190,2190,0,0
5166,2019-02-08,1815,0,1815,145,1960,1960,0,0
5167,2019-02-08,445,0,445,35,480,480,0,0
5168,2019-02-08,2065,0,2065,165,2230,2230,0,0
5169,2019-02-08,926,0,926,74,1000,1000,0,0
5170,2019-02-08,528,0,528,42,570,570,0,0
5171,2019-02-08,852,0,852,68,920,920,0,0
5172,2019-02-09,528,0,528,42,570,570,0,0
5173,2019-02-09,630,0,630,50,680,680,0,0
5174,2019-02-09,371,0,371,29,400,400,0,0
5175,2019-02-09,491,0,491,39,530,530,0,0
5176,2019-02-09,1815,0,1815,145,1960,0,1960,0
5177,2019-02-09,713,0,713,57,770,770,0,0
5178,2019-02-09,547,0,547,43,590,590,0,0
5179,2019-02-09,389,0,389,31,420,420,0,0
5180,2019-02-09,1528,0,1528,122,1650,1650,0,0
5181,2019-02-09,639,0,639,51,690,690,0,0
5182,2019-02-09,389,0,389,31,420,420,0,0
5183,2019-02-09,1815,0,1815,145,1960,1960,0,0
5184,2019-02-09,399,0,399,31,430,430,0,0
5185,2019-02-09,945,0,945,75,1020,1020,0,0
5186,2019-02-09,139,0,139,11,150,150,0,0
5187,2019-02-09,1815,0,1815,145,1960,1960,0,0
5188,2019-02-09,1130,0,1130,90,1220,1220,0,0
5189,2019-02-09,1084,0,1084,86,1170,1170,0,0
5190,2019-02-09,1195,0,1195,95,1290,1290,0,0
5191,2019-02-09,936,0,936,74,1010,1010,0,0
5192,2019-02-09,1121,0,1121,89,1210,1210,0,0
5193,2019-02-09,1815,0,1815,145,1960,1960,0,0
5194,2019-02-09,1084,0,1084,86,1170,1170,0,0
5195,2019-02-09,1815,0,1815,145,1960,1960,0,0
5196,2019-02-09,2473,0,2473,197,2670,2670,0,0
5197,2019-02-09,1112,0,1112,88,1200,1200,0,0
5198,2019-02-09,1269,0,1269,101,1370,1370,0,0
5199,2019-02-09,2251,0,2251,179,2430,2430,0,0
5200,2019-02-09,953,0,953,67,1020,1020,0,0
5201,2019-02-09,732,0,732,58,790,790,0,0
5202,2019-02-09,676,0,676,54,730,730,0,0
5203,2019-02-09,899,0,899,71,970,970,0,0
5204,2019-02-09,528,0,528,42,570,570,0,0
5205,2019-02-09,621,0,621,49,670,670,0,0
5206,2019-02-09,602,0,602,48,650,650,0,0
5207,2019-02-09,2953,0,2953,227,3180,3180,0,0
5208,2019-02-09,556,0,556,44,600,600,0,0
5209,2019-02-09,399,0,399,31,430,430,0,0
5210,2019-02-09,639,0,639,51,690,690,0,0
5211,2019-02-09,473,0,473,37,510,510,0,0
5212,2019-02-09,991,0,991,79,1070,1070,0,0
5213,2019-02-09,834,0,834,66,900,900,0,0
5214,2019-02-09,778,0,778,62,840,840,0,0
5215,2019-02-09,667,0,667,53,720,720,0,0
5216,2019-02-09,862,0,862,68,930,930,0,0
5217,2019-02-09,389,0,389,31,420,420,0,0
5218,2019-02-09,269,0,269,21,290,290,0,0
5219,2019-02-09,1815,0,1815,145,1960,1960,0,0
5220,2019-02-09,769,0,769,61,830,830,0,0
5221,2019-02-09,621,0,621,49,670,670,0,0
5222,2019-02-09,482,0,482,38,520,520,0,0
5223,2019-02-09,602,0,602,48,650,650,0,0
5224,2019-02-09,436,0,436,34,470,470,0,0
5225,2019-02-09,760,0,760,60,820,820,0,0
5226,2019-02-09,880,0,880,70,950,950,0,0
5227,2019-02-09,704,0,704,56,760,760,0,0
5228,2019-02-09,445,0,445,35,480,480,0,0
5229,2019-02-09,1676,0,1676,134,1810,1810,0,0
5230,2019-02-09,149,0,149,11,160,160,0,0
5231,2019-02-09,825,0,825,65,890,890,0,0
5232,2019-02-09,241,0,241,19,260,260,0,0
5233,2019-02-09,334,0,334,26,360,360,0,0
5234,2019-02-09,399,0,399,31,430,430,0,0
5235,2019-02-09,1010,0,1010,80,1090,0,1090,0
5236,2019-02-09,371,0,371,29,400,400,0,0
5237,2019-02-09,102,0,102,8,110,110,0,0
5238,2019-02-09,167,0,167,13,180,180,0,0
5239,2019-02-09,417,0,417,33,450,450,0,0
5240,2019-02-09,1815,0,1815,145,1960,1960,0,0
5241,2019-02-09,1102,0,1102,88,1190,1190,0,0
5242,2019-02-09,1075,0,1075,85,1160,1160,0,0
5243,2019-02-09,519,0,519,41,560,560,0,0
5244,2019-02-09,269,0,269,21,290,290,0,0
5245,2019-02-09,1240,0,1240,90,1330,1330,0,0
5246,2019-02-09,833,0,833,57,890,890,0,0
5247,2019-02-09,1538,0,1538,122,1660,1660,0,0
5248,2019-02-09,1602,0,1602,128,1730,1730,0,0
5249,2019-02-09,1815,0,1815,145,1960,1960,0,0
5250,2019-02-09,751,0,751,59,810,810,0,0
5251,2019-02-09,1352,0,1352,108,1460,1460,0,0
5252,2019-02-09,713,0,713,57,770,770,0,0
5253,2019-02-09,639,0,639,51,690,690,0,0
5254,2019-02-09,436,0,436,34,470,470,0,0
5255,2019-02-09,463,0,463,37,500,500,0,0
5256,2019-02-09,334,0,334,26,360,360,0,0
5257,2019-02-09,806,0,806,64,870,870,0,0
5258,2019-02-09,713,0,713,57,770,770,0,0
5259,2019-02-09,501,0,501,39,540,540,0,0
5260,2019-02-09,1028,0,1028,82,1110,1110,0,0
5261,2019-02-09,815,0,815,65,880,880,0,0
5262,2019-02-09,639,0,639,51,690,690,0,0
5263,2019-02-09,510,0,510,40,550,550,0,0
5264,2019-02-09,352,0,352,28,380,380,0,0
5265,2019-02-09,501,0,501,39,540,540,0,0
5266,2019-02-09,2362,0,2362,188,2550,2550,0,0
5267,2019-02-09,1176,0,1176,94,1270,1270,0,0
5268,2019-02-09,1575,0,1575,125,1700,1700,0,0
5269,2019-02-09,399,0,399,31,430,430,0,0
5270,2019-02-09,538,0,538,42,580,580,0,0
5271,2019-02-09,315,0,315,25,340,340,0,0
5272,2019-02-09,399,0,399,31,430,430,0,0
5273,2019-02-09,1399,0,1399,111,1510,1510,0,0
5274,2019-02-09,723,0,723,57,780,780,0,0
5275,2019-02-09,371,0,371,29,400,400,0,0
5276,2019-02-09,371,0,371,29,400,400,0,0
5277,2019-02-09,102,0,102,8,110,110,0,0
5278,2019-02-09,797,0,797,63,860,860,0,0
5279,2019-02-09,176,0,176,14,190,190,0,0
5280,2019-02-09,204,0,204,16,220,220,0,0
5281,2019-02-09,630,0,630,50,680,680,0,0
5282,2019-02-09,371,0,371,29,400,400,0,0
5283,2019-02-09,1139,0,1139,91,1230,1230,0,0
5284,2019-02-09,676,0,676,54,730,730,0,0
5285,2019-02-09,1445,0,1445,115,1560,1560,0,0
5286,2019-02-09,1732,0,1732,138,1870,1870,0,0
5287,2019-02-09,1093,0,1093,87,1180,1180,0,0
5288,2019-02-09,889,0,889,71,960,960,0,0
5289,2019-02-09,362,0,362,28,390,390,0,0
5290,2019-02-09,3116,0,3116,249,3365,3365,0,0
5291,2019-02-09,1575,0,1575,125,1700,1700,0,0
5292,2019-02-09,463,0,463,37,500,500,0,0
5293,2019-02-09,1129,0,1129,81,1210,1210,0,0
5294,2019-02-09,380,0,380,30,410,410,0,0
5295,2019-02-09,2667,0,2667,213,2880,2880,0,0
5296,2019-02-09,1426,0,1426,114,1540,1540,0,0
5297,2019-02-09,1156,0,1156,74,1230,1230,0,0
5298,2019-02-09,681,0,681,54,735,735,0,0
5299,2019-02-09,2223,0,2223,177,2400,2400,0,0
5300,2019-02-09,602,0,602,48,650,650,0,0
5301,2019-02-09,1565,0,1565,125,1690,1690,0,0
5302,2019-02-09,334,0,334,26,360,360,0,0
5303,2019-02-09,899,0,899,71,970,970,0,0
5304,2019-02-09,473,0,473,37,510,510,0,0
5305,2019-02-09,1010,0,1010,80,1090,1090,0,0
5306,2019-02-09,667,0,667,53,720,720,0,0
5307,2019-02-09,342,0,342,18,360,360,0,0
5308,2019-02-09,2565,0,2565,205,2770,2770,0,0
5309,2019-02-09,436,0,436,34,470,470,0,0
5310,2019-02-09,667,0,667,53,720,720,0,0
5311,2019-02-09,186,0,186,14,200,200,0,0
5312,2019-02-09,1575,0,1575,125,1700,1700,0,0
5313,2019-02-09,334,0,334,26,360,360,0,0
5314,2019-02-09,1426,0,1426,114,1540,1540,0,0
5315,2019-02-09,1575,0,1575,125,1700,1700,0,0
5316,2019-02-09,297,0,297,23,320,320,0,0
5317,2019-02-09,1575,0,1575,125,1700,1700,0,0
5318,2019-02-09,371,0,371,29,400,400,0,0
5319,2019-02-09,371,0,371,29,400,400,0,0
5320,2019-02-09,760,0,760,60,820,820,0,0
5321,2019-02-09,306,0,306,24,330,330,0,0
5322,2019-02-09,843,0,843,67,910,910,0,0
5323,2019-02-09,899,0,899,71,970,970,0,0
5324,2019-02-09,408,0,408,32,440,440,0,0
5325,2019-02-09,871,0,871,69,940,940,0,0
5326,2019-02-09,612,0,612,48,660,660,0,0
5327,2019-02-09,102,0,102,8,110,110,0,0
5328,2019-02-09,982,0,982,78,1060,1060,0,0
5329,2019-02-09,1676,0,1676,134,1810,1810,0,0
5330,2019-02-09,1010,0,1010,80,1090,1090,0,0
5331,2019-02-09,769,0,769,61,830,830,0,0
5332,2019-02-10,778,0,778,62,840,840,0,0
5333,2019-02-10,519,0,519,41,560,560,0,0
5334,2019-02-10,686,0,686,54,740,740,0,0
5335,2019-02-10,908,0,908,72,980,980,0,0
5336,2019-02-10,1667,0,1667,133,1800,1800,0,0
5337,2019-02-10,1936,0,1936,154,2090,0,2090,0
5338,2019-02-10,908,0,908,72,980,980,0,0
5339,2019-02-10,593,0,593,47,640,640,0,0
5340,2019-02-10,732,0,732,58,790,790,0,0
5341,2019-02-10,1056,0,1056,84,1140,1140,0,0
5342,2019-02-10,167,0,167,13,180,0,180,0
5343,2019-02-10,1815,0,1815,145,1960,1960,0,0
5344,2019-02-10,908,0,908,72,980,980,0,0
5345,2019-02-10,908,0,908,72,980,0,980,0
5346,2019-02-10,389,0,389,31,420,420,0,0
5347,2019-02-10,176,0,176,14,190,190,0,0
5348,2019-02-10,593,0,593,47,640,640,0,0
5349,2019-02-10,1815,0,1815,145,1960,1960,0,0
5350,2019-02-10,510,0,510,40,550,550,0,0
5351,2019-02-10,686,0,686,54,740,740,0,0
5352,2019-02-10,500,0,500,40,540,540,0,0
5353,2019-02-10,399,0,399,31,430,430,0,0
5354,2019-02-10,751,0,751,59,810,810,0,0
5355,2019-02-10,1741,0,1741,139,1880,1880,0,0
5356,2019-02-10,695,0,695,55,750,750,0,0
5357,2019-02-10,1445,0,1445,115,1560,1560,0,0
5358,2019-02-10,352,0,352,28,380,380,0,0
5359,2019-02-10,991,0,991,79,1070,1070,0,0
5360,2019-02-10,686,0,686,54,740,0,740,0
5361,2019-02-10,241,0,241,19,260,260,0,0
5362,2019-02-10,1111,0,1111,79,1190,1190,0,0
5363,2019-02-10,389,0,389,31,420,420,0,0
5364,2019-02-10,3630,0,3630,290,3920,3920,0,0
5365,2019-02-10,1815,0,1815,145,1960,1960,0,0
5366,2019-02-10,1195,0,1195,95,1290,1290,0,0
5367,2019-02-10,371,0,371,29,400,400,0,0
5368,2019-02-10,538,0,538,42,580,580,0,0
5369,2019-02-10,676,0,676,54,730,730,0,0
5370,2019-02-10,315,0,315,25,340,340,0,0
5371,2019-02-10,232,0,232,18,250,250,0,0
5372,2019-02-10,195,0,195,15,210,210,0,0
5373,2019-02-10,1963,0,1963,157,2120,2120,0,0
5374,2019-02-10,1183,0,1183,77,1260,1260,0,0
5375,2019-02-10,445,0,445,35,480,480,0,0
5376,2019-02-10,2695,0,2695,215,2910,2910,0,0
5377,2019-02-10,325,0,325,25,350,350,0,0
5378,2019-02-10,713,0,713,57,770,770,0,0
5379,2019-02-10,538,0,538,42,580,580,0,0
5380,2019-02-10,667,0,667,53,720,720,0,0
5381,2019-02-10,834,0,834,66,900,900,0,0
5382,2019-02-10,1815,0,1815,145,1960,1960,0,0
5383,2019-02-10,908,0,908,72,980,980,0,0
5384,2019-02-10,167,0,167,13,180,180,0,0
5385,2019-02-10,667,0,667,53,720,720,0,0
5386,2019-02-10,639,0,639,51,690,690,0,0
5387,2019-02-10,908,0,908,72,980,980,0,0
5388,2019-02-10,1167,0,1167,93,1260,1260,0,0
5389,2019-02-10,1019,0,1019,81,1100,1100,0,0
5390,2019-02-10,1232,0,1232,98,1330,1330,0,0
5391,2019-02-10,889,0,889,71,960,960,0,0
5392,2019-02-10,473,0,473,37,510,510,0,0
5393,2019-02-10,834,0,834,66,900,900,0,0
5394,2019-02-10,880,0,880,70,950,950,0,0
5395,2019-02-10,741,0,741,59,800,800,0,0
5396,2019-02-10,575,0,575,45,620,620,0,0
5397,2019-02-10,1852,0,1852,148,2000,2000,0,0
5398,2019-02-10,1001,0,1001,79,1080,1080,0,0
5399,2019-02-10,1019,0,1019,81,1100,1100,0,0
5400,2019-02-10,1519,0,1519,121,1640,1640,0,0
5401,2019-02-10,1982,0,1982,158,2140,2140,0,0
5402,2019-02-10,482,0,482,38,520,520,0,0
5403,2019-02-10,982,0,982,78,1060,1060,0,0
5404,2019-02-10,2389,0,2389,191,2580,2580,0,0
5405,2019-02-10,1001,0,1001,79,1080,1080,0,0
5406,2019-02-10,352,0,352,28,380,380,0,0
5407,2019-02-10,806,0,806,64,870,0,870,0
5408,2019-02-10,908,0,908,72,980,0,980,0
5409,2019-02-10,389,0,389,31,420,420,0,0
5410,2019-02-10,1288,0,1288,102,1390,1390,0,0
5411,2019-02-10,473,0,473,37,510,510,0,0
5412,2019-02-10,908,0,908,72,980,980,0,0
5413,2019-02-10,519,0,519,41,560,560,0,0
5414,2019-02-10,1204,0,1204,96,1300,1300,0,0
5415,2019-02-10,621,0,621,49,670,670,0,0
5416,2019-02-10,834,0,834,66,900,900,0,0
5417,2019-02-10,2723,0,2723,217,2940,2940,0,0
5418,2019-02-10,1815,0,1815,145,1960,1960,0,0
5419,2019-02-10,408,0,408,32,440,440,0,0
5420,2019-02-10,2556,0,2556,204,2760,2760,0,0
5421,2019-02-10,1296,0,1296,94,1390,1390,0,0
5422,2019-02-10,612,0,612,48,660,660,0,0
5423,2019-02-10,769,0,769,61,830,830,0,0
5424,2019-02-10,1815,0,1815,145,1960,1960,0,0
5425,2019-02-10,1815,0,1815,145,1960,0,1960,0
5426,2019-02-10,1380,0,1380,110,1490,1490,0,0
5427,2019-02-10,463,0,463,37,500,500,0,0
5428,2019-02-10,1343,0,1343,107,1450,1450,0,0
5429,2019-02-10,1510,0,1510,120,1630,1630,0,0
5430,2019-02-10,186,0,186,14,200,200,0,0
5431,2019-02-10,676,0,676,54,730,730,0,0
5432,2019-02-10,278,0,278,22,300,300,0,0
5433,2019-02-10,908,0,908,72,980,980,0,0
5434,2019-02-10,1806,0,1806,144,1950,1950,0,0
5435,2019-02-10,616,0,616,49,665,665,0,0
5436,2019-02-10,408,0,408,32,440,440,0,0
5437,2019-02-10,269,0,269,21,290,290,0,0
5438,2019-02-10,445,0,445,35,480,480,0,0
5439,2019-02-10,788,0,788,62,850,850,0,0
5440,2019-02-10,1575,0,1575,125,1700,1700,0,0
5441,2019-02-10,269,0,269,21,290,290,0,0
5442,2019-02-10,788,0,788,62,850,850,0,0
5443,2019-02-10,1575,0,1575,125,1700,1700,0,0
5444,2019-02-10,788,0,788,62,850,850,0,0
5445,2019-02-10,260,0,260,20,280,280,0,0
5446,2019-02-10,778,0,778,62,840,840,0,0
5447,2019-02-10,510,0,510,40,550,550,0,0
5448,2019-02-10,306,0,306,24,330,330,0,0
5449,2019-02-10,2362,0,2362,188,2550,2550,0,0
5450,2019-02-10,755,0,755,60,815,815,0,0
5451,2019-02-10,1575,0,1575,125,1700,1700,0,0
5452,2019-02-10,788,0,788,62,850,850,0,0
5453,2019-02-10,788,0,788,62,850,850,0,0
5454,2019-02-10,278,0,278,22,300,300,0,0
5455,2019-02-10,343,0,343,27,370,370,0,0
5456,2019-02-10,297,0,297,23,320,320,0,0
5457,2019-02-10,788,0,788,62,850,850,0,0
5458,2019-02-10,907,0,907,63,970,970,0,0
5459,2019-02-10,1019,0,1019,81,1100,1100,0,0
5460,2019-02-10,1389,0,1389,111,1500,1500,0,0
5461,2019-02-10,833,0,833,57,890,0,890,0
5462,2019-02-10,260,0,260,20,280,280,0,0
5463,2019-02-10,139,0,139,11,150,150,0,0
5464,2019-02-10,1334,0,1334,106,1440,1440,0,0
5465,2019-02-10,1880,0,1880,150,2030,2030,0,0
5466,2019-02-10,491,0,491,39,530,530,0,0
5467,2019-02-10,212,0,212,8,220,220,0,0
5468,2019-02-10,306,0,306,24,330,330,0,0
5469,2019-02-10,1278,0,1278,102,1380,1380,0,0
5470,2019-02-10,362,0,362,28,390,390,0,0
5471,2019-02-10,797,0,797,63,860,860,0,0
5472,2019-02-10,620,0,620,40,660,660,0,0
5473,2019-02-10,260,0,260,20,280,280,0,0
5474,2019-02-10,584,0,584,46,630,630,0,0
5475,2019-02-10,2686,0,2686,214,2900,2900,0,0
5476,2019-02-10,426,0,426,34,460,460,0,0
5477,2019-02-10,630,0,630,50,680,680,0,0
5478,2019-02-10,269,0,269,21,290,290,0,0
5479,2019-02-10,435,0,435,25,460,460,0,0
5480,2019-02-10,565,0,565,45,610,610,0,0
5481,2019-02-10,926,0,926,74,1000,1000,0,0
5482,2019-02-10,1130,0,1130,90,1220,1220,0,0
5483,2019-02-10,741,0,741,59,800,0,800,0
5484,2019-02-10,1575,0,1575,125,1700,1700,0,0
5485,2019-02-10,510,0,510,40,550,550,0,0
5486,2019-02-10,788,0,788,62,850,850,0,0
5487,2019-02-10,1436,0,1436,114,1550,1550,0,0
5488,2019-02-10,1575,0,1575,125,1700,1700,0,0
5489,2019-02-10,251,0,251,19,270,270,0,0
5490,2019-02-10,343,0,343,27,370,370,0,0
5491,2019-02-10,473,0,473,37,510,510,0,0
5492,2019-02-10,454,0,454,36,490,490,0,0
5493,2019-02-10,1026,0,1026,64,1090,1090,0,0
5494,2019-02-10,982,0,982,78,1060,0,1060,0
5495,2019-02-10,278,0,278,22,300,300,0,0
5496,2019-02-10,1223,0,1223,97,1320,1320,0,0
5497,2019-02-10,491,0,491,39,530,530,0,0
5498,2019-02-10,1575,0,1575,125,1700,0,1700,0
5499,2019-02-10,788,0,788,62,850,850,0,0
5500,2019-02-10,760,0,760,60,820,820,0,0
5501,2019-02-10,667,0,667,53,720,720,0,0
5502,2019-02-10,732,0,732,58,790,790,0,0
5503,2019-02-10,741,0,741,59,800,800,0,0
5504,2019-02-10,1741,0,1741,139,1880,1880,0,0
5505,2019-02-10,1815,0,1815,145,1960,0,1960,0
5506,2019-02-10,482,0,482,38,520,520,0,0
5507,2019-02-10,1121,0,1121,89,1210,1210,0,0
5508,2019-02-10,1399,0,1399,111,1510,0,1510,0
5509,2019-02-10,788,0,788,62,850,850,0,0
5510,2019-02-10,1186,0,1186,94,1280,1280,0,0
5511,2019-02-10,473,0,473,37,510,510,0,0
5512,2019-02-10,751,0,751,59,810,810,0,0
5513,2019-02-10,788,0,788,62,850,850,0,0
5514,2019-02-10,1186,0,1186,94,1280,1280,0,0
5515,2019-02-10,1251,0,1251,99,1350,1350,0,0
5516,2019-02-10,1251,0,1251,99,1350,1350,0,0
5517,2019-02-10,788,0,788,62,850,850,0,0
5518,2019-02-10,1575,0,1575,125,1700,1700,0,0
5519,2019-02-10,2130,0,2130,170,2300,0,2300,0
5520,2019-02-10,2362,0,2362,188,2550,2550,0,0
5521,2019-02-10,399,0,399,31,430,430,0,0
5522,2019-02-10,1075,0,1075,85,1160,1160,0,0
5523,2019-02-10,278,0,278,22,300,300,0,0
5524,2019-02-10,426,0,426,34,460,460,0,0
5525,2019-02-10,463,0,463,37,500,500,0,0
5526,2019-02-10,584,0,584,46,630,630,0,0
5527,2019-02-10,-1251,0,-1251,-99,-1350,-1350,0,0
5528,2019-02-10,1001,0,1001,79,1080,1080,0,0
5529,2019-02-10,1575,0,1575,125,1700,1700,0,0
5530,2019-02-10,1269,0,1269,101,1370,1370,0,0
5531,2019-02-10,1575,0,1575,125,1700,1700,0,0
5532,2019-02-10,269,0,269,21,290,290,0,0
5533,2019-02-10,1149,0,1149,91,1240,1240,0,0
5534,2019-02-10,788,0,788,62,850,850,0,0
5535,2019-02-10,788,0,788,62,850,850,0,0
5536,2019-02-11,288,0,288,22,310,310,0,0
5537,2019-02-11,1815,0,1815,145,1960,1960,0,0
5538,2019-02-11,908,0,908,72,980,980,0,0
5539,2019-02-11,1010,0,1010,80,1090,1090,0,0
5540,2019-02-11,399,0,399,31,430,430,0,0
5541,2019-02-11,732,0,732,58,790,790,0,0
5542,2019-02-11,1815,0,1815,145,1960,1960,0,0
5543,2019-02-11,954,0,954,76,1030,1030,0,0
5544,2019-02-11,667,0,667,53,720,720,0,0
5545,2019-02-11,658,0,658,52,710,710,0,0
5546,2019-02-11,500,0,500,40,540,540,0,0
5547,2019-02-11,1001,0,1001,79,1080,1080,0,0
5548,2019-02-11,2001,0,2001,159,2160,2160,0,0
5549,2019-02-11,334,0,334,26,360,360,0,0
5550,2019-02-11,602,0,602,48,650,650,0,0
5551,2019-02-11,-519,0,-519,-41,-560,-560,0,0
5552,2019-02-11,686,0,686,54,740,740,0,0
5553,2019-02-11,686,0,686,54,740,740,0,0
5554,2019-02-11,723,0,723,57,780,780,0,0
5555,2019-02-11,621,0,621,49,670,670,0,0
5556,2019-02-11,519,0,519,41,560,560,0,0
5557,2019-02-11,667,0,667,53,720,720,0,0
5558,2019-02-11,297,0,297,23,320,320,0,0
5559,2019-02-11,1352,0,1352,108,1460,0,1460,0
5560,2019-02-11,982,0,982,78,1060,1060,0,0
5561,2019-02-11,1149,0,1149,91,1240,1240,0,0
5562,2019-02-11,676,0,676,54,730,730,0,0
5563,2019-02-11,1713,0,1713,137,1850,1850,0,0
5564,2019-02-11,-674,0,-674,-36,-710,-710,0,0
5565,2019-02-11,674,0,674,36,710,710,0,0
5566,2019-02-11,674,0,674,36,710,710,0,0
5567,2019-02-11,593,0,593,47,640,640,0,0
5568,2019-02-11,2036,0,2036,154,2190,2190,0,0
5569,2019-02-11,1815,0,1815,145,1960,1960,0,0
5570,2019-02-11,436,0,436,34,470,470,0,0
5571,2019-02-11,325,0,325,25,350,350,0,0
5572,2019-02-11,1556,0,1556,124,1680,1680,0,0
5573,2019-02-11,908,0,908,72,980,980,0,0
5574,2019-02-11,491,0,491,39,530,530,0,0
5575,2019-02-11,269,0,269,21,290,290,0,0
5576,2019-02-11,362,0,362,28,390,390,0,0
5577,2019-02-11,889,0,889,71,960,960,0,0
5578,2019-02-11,584,0,584,46,630,630,0,0
5579,2019-02-11,491,0,491,39,530,530,0,0
5580,2019-02-11,454,0,454,36,490,490,0,0
5581,2019-02-11,68149,0,68149,5451,73600,0,73600,0
5582,2019-02-11,1815,0,1815,145,1960,1960,0,0
5583,2019-02-11,377,-80,297,23,320,320,0,0
5584,2019-02-11,1658,0,1658,132,1790,1790,0,0
5585,2019-02-11,834,0,834,66,900,900,0,0
5586,2019-02-11,501,0,501,39,540,540,0,0
5587,2019-02-11,352,0,352,28,380,380,0,0
5588,2019-02-11,862,0,862,68,930,930,0,0
5589,2019-02-11,1417,0,1417,113,1530,1530,0,0
5590,2019-02-11,334,0,334,26,360,360,0,0
5591,2019-02-11,1575,0,1575,125,1700,1700,0,0
5592,2019-02-11,204,0,204,16,220,220,0,0
5593,2019-02-11,880,0,880,70,950,950,0,0
5594,2019-02-11,389,0,389,31,420,0,420,0
5595,2019-02-11,1852,0,1852,148,2000,0,2000,0
5596,2019-02-11,226,-48,178,14,192,192,0,0
5597,2019-02-11,723,0,723,57,780,780,0,0
5598,2019-02-11,232,0,232,18,250,250,0,0
5599,2019-02-11,822,0,822,48,870,870,0,0
5600,2019-02-11,121,0,121,9,130,130,0,0
5601,2019-02-11,899,0,899,71,970,970,0,0
5602,2019-02-11,704,0,704,56,760,760,0,0
5603,2019-02-11,686,0,686,54,740,740,0,0
5604,2019-02-11,760,0,760,60,820,820,0,0
5605,2019-02-11,501,0,501,39,540,540,0,0
5606,2019-02-11,463,0,463,37,500,500,0,0
5607,2019-02-11,695,0,695,55,750,750,0,0
5608,2019-02-11,343,0,343,27,370,370,0,0
5609,2019-02-11,741,0,741,59,800,800,0,0
5610,2019-02-11,1417,0,1417,113,1530,1530,0,0
5611,2019-02-11,538,0,538,42,580,580,0,0
5612,2019-02-11,1084,0,1084,86,1170,1170,0,0
5613,2019-02-11,556,0,556,44,600,600,0,0
5614,2019-02-11,2973,0,2973,237,3210,3210,0,0
5615,2019-02-11,806,0,806,64,870,870,0,0
5616,2019-02-11,732,0,732,58,790,790,0,0
5617,2019-02-11,871,0,871,69,940,940,0,0
5618,2019-02-11,602,0,602,48,650,650,0,0
5619,2019-02-11,731,0,731,49,780,780,0,0
5620,2019-02-11,510,0,510,40,550,550,0,0
5621,2019-02-11,584,0,584,46,630,630,0,0
5622,2019-02-11,880,0,880,70,950,950,0,0
5623,2019-02-11,408,0,408,32,440,440,0,0
5624,2019-02-11,713,0,713,57,770,770,0,0
5625,2019-02-11,741,0,741,59,800,800,0,0
5626,2019-02-11,630,0,630,50,680,680,0,0
5627,2019-02-11,1417,0,1417,113,1530,1530,0,0
5628,2019-02-11,899,0,899,71,970,0,970,0
5629,2019-02-11,639,0,639,51,690,690,0,0
5630,2019-02-11,288,0,288,22,310,310,0,0
5631,2019-02-11,538,0,538,42,580,580,0,0
5632,2019-02-11,1667,0,1667,133,1800,1800,0,0
5633,2019-02-11,788,0,788,62,850,850,0,0
5634,2019-02-11,371,0,371,29,400,400,0,0
5635,2019-02-11,547,0,547,43,590,590,0,0
5636,2019-02-11,575,0,575,45,620,620,0,0
5637,2019-02-11,302,-64,238,18,256,256,0,0
5638,2019-02-11,612,0,612,48,660,660,0,0
5639,2019-02-12,491,0,491,39,530,530,0,0
5640,2019-02-12,232,0,232,18,250,250,0,0
5641,2019-02-12,1130,0,1130,90,1220,1220,0,0
5642,2019-02-12,954,0,954,76,1030,1030,0,0
5643,2019-02-12,232,0,232,18,250,250,0,0
5644,2019-02-12,269,0,269,21,290,290,0,0
5645,2019-02-12,176,0,176,14,190,190,0,0
5646,2019-02-12,491,0,491,39,530,530,0,0
5647,2019-02-12,982,0,982,78,1060,1060,0,0
5648,2019-02-12,112,0,112,8,120,120,0,0
5649,2019-02-12,510,0,510,40,550,550,0,0
5650,2019-02-12,259,0,259,11,270,270,0,0
5651,2019-02-12,352,0,352,28,380,380,0,0
5652,2019-02-12,232,0,232,18,250,250,0,0
5653,2019-02-12,730,0,730,40,770,0,770,0
5654,2019-02-12,399,0,399,31,430,430,0,0
5655,2019-02-12,371,0,371,29,400,400,0,0
5656,2019-02-13,149,0,149,11,160,160,0,0
5657,2019-02-13,195,0,195,15,210,210,0,0
5658,2019-02-13,1463,0,1463,117,1580,1580,0,0
5659,2019-02-13,741,0,741,59,800,800,0,0
5660,2019-02-13,288,0,288,22,310,310,0,0
5661,2019-02-13,908,0,908,72,980,980,0,0
5662,2019-02-13,139,0,139,11,150,150,0,0
5663,2019-02-13,1815,0,1815,145,1960,1960,0,0
5664,2019-02-13,908,0,908,72,980,980,0,0
5665,2019-02-13,825,0,825,65,890,890,0,0
5666,2019-02-13,621,0,621,49,670,670,0,0
5667,2019-02-13,769,0,769,61,830,830,0,0
5668,2019-02-13,473,0,473,37,510,510,0,0
5669,2019-02-13,249,0,249,11,260,260,0,0
5670,2019-02-13,1899,0,1899,151,2050,2050,0,0
5671,2019-02-13,908,0,908,72,980,980,0,0
5672,2019-02-13,1565,0,1565,125,1690,1690,0,0
5673,2019-02-13,908,0,908,72,980,980,0,0
5674,2019-02-13,2723,0,2723,217,2940,2940,0,0
5675,2019-02-13,713,0,713,57,770,770,0,0
5676,2019-02-13,806,0,806,64,870,870,0,0
5677,2019-02-13,306,0,306,24,330,330,0,0
5678,2019-02-13,139,0,139,11,150,150,0,0
5679,2019-02-13,501,0,501,39,540,540,0,0
5680,2019-02-13,1102,0,1102,88,1190,1190,0,0
5681,2019-02-13,399,0,399,31,430,430,0,0
5682,2019-02-13,362,0,362,28,390,390,0,0
5683,2019-02-13,899,0,899,71,970,970,0,0
5684,2019-02-13,260,0,260,20,280,280,0,0
5685,2019-02-13,444,0,444,26,470,470,0,0
5686,2019-02-13,112,0,112,8,120,120,0,0
5687,2019-02-13,139,0,139,11,150,150,0,0
5688,2019-02-13,-463,0,-463,-37,-500,-500,0,0
5689,2019-02-13,464,-11,453,36,489,489,0,0
5690,2019-02-13,463,0,463,37,500,500,0,0
5691,2019-02-13,352,0,352,28,380,380,0,0
5692,2019-02-13,769,0,769,61,830,830,0,0
5693,2019-02-13,667,0,667,53,720,720,0,0
5694,2019-02-13,1028,0,1028,82,1110,1110,0,0
5695,2019-02-13,1436,0,1436,114,1550,1550,0,0
5696,2019-02-13,871,0,871,69,940,940,0,0
5697,2019-02-13,593,0,593,47,640,640,0,0
5698,2019-02-13,473,0,473,37,510,510,0,0
5699,2019-02-13,908,0,908,72,980,980,0,0
5700,2019-02-13,167,0,167,13,180,180,0,0
5701,2019-02-13,259,0,259,11,270,270,0,0
5702,2019-02-13,56,0,56,4,60,60,0,0
5703,2019-02-13,431,0,431,34,465,465,0,0
5704,2019-02-13,371,0,371,29,400,400,0,0
5705,2019-02-13,501,0,501,39,540,540,0,0
5706,2019-02-13,843,0,843,67,910,910,0,0
5707,2019-02-13,1602,0,1602,128,1730,0,1730,0
5708,2019-02-13,1121,0,1121,89,1210,1210,0,0
5709,2019-02-13,1149,0,1149,91,1240,1240,0,0
5710,2019-02-13,334,0,334,26,360,360,0,0
5711,2019-02-13,797,0,797,63,860,860,0,0
5712,2019-02-13,1815,0,1815,145,1960,1960,0,0
5713,2019-02-13,463,0,463,37,500,500,0,0
5714,2019-02-13,1065,0,1065,85,1150,0,1150,0
5715,2019-02-13,1065,0,1065,85,1150,1150,0,0
5716,2019-02-13,1612,0,1612,128,1740,1740,0,0
5717,2019-02-13,862,0,862,68,930,930,0,0
5718,2019-02-13,1473,0,1473,117,1590,1590,0,0
5719,2019-02-13,250,0,250,20,270,270,0,0
5720,2019-02-13,269,0,269,21,290,290,0,0
5721,2019-02-13,546,0,546,34,580,580,0,0
5722,2019-02-13,195,0,195,15,210,210,0,0
5723,2019-02-13,334,0,334,26,360,360,0,0
5724,2019-02-13,676,0,676,54,730,730,0,0
5725,2019-02-13,1139,0,1139,91,1230,1230,0,0
5726,2019-02-13,908,0,908,72,980,980,0,0
5727,2019-02-13,908,0,908,72,980,980,0,0
5728,2019-02-13,565,0,565,45,610,610,0,0
5729,2019-02-13,1815,0,1815,145,1960,1960,0,0
5730,2019-02-13,536,0,536,34,570,570,0,0
5731,2019-02-13,649,0,649,51,700,700,0,0
5732,2019-02-13,1815,0,1815,145,1960,1960,0,0
5733,2019-02-13,445,0,445,35,480,0,480,0
5734,2019-02-13,834,0,834,66,900,900,0,0
5735,2019-02-13,1093,0,1093,87,1180,1180,0,0
5736,2019-02-13,482,0,482,38,520,520,0,0
5737,2019-02-13,954,0,954,76,1030,1030,0,0
5738,2019-02-13,519,0,519,41,560,560,0,0
5739,2019-02-13,908,0,908,72,980,980,0,0
5740,2019-02-13,315,0,315,25,340,340,0,0
5741,2019-02-13,278,0,278,22,300,300,0,0
5742,2019-02-13,500,0,500,40,540,540,0,0
5743,2019-02-13,1315,0,1315,105,1420,1420,0,0
5744,2019-02-13,926,0,926,74,1000,1000,0,0
5745,2019-02-14,1815,0,1815,145,1960,1960,0,0
5746,2019-02-14,1602,0,1602,128,1730,1730,0,0
5747,2019-02-14,1223,0,1223,97,1320,1320,0,0
5748,2019-02-14,908,0,908,72,980,980,0,0
5749,2019-02-14,1593,0,1593,127,1720,1720,0,0
5750,2019-02-14,908,0,908,72,980,980,0,0
5751,2019-02-14,908,0,908,72,980,980,0,0
5752,2019-02-14,621,0,621,49,670,670,0,0
5753,2019-02-14,908,0,908,72,980,980,0,0
5754,2019-02-14,1232,0,1232,98,1330,1330,0,0
5755,2019-02-14,325,0,325,25,350,350,0,0
5756,2019-02-14,1269,0,1269,101,1370,1370,0,0
5757,2019-02-14,362,0,362,28,390,390,0,0
5758,2019-02-14,519,0,519,41,560,560,0,0
5759,2019-02-14,908,0,908,72,980,980,0,0
5760,2019-02-14,908,0,908,72,980,980,0,0
5761,2019-02-14,908,0,908,72,980,980,0,0
5762,2019-02-14,639,0,639,51,690,690,0,0
5763,2019-02-14,908,0,908,72,980,980,0,0
5764,2019-02-14,1630,0,1630,130,1760,1760,0,0
5765,2019-02-14,630,0,630,50,680,680,0,0
5766,2019-02-14,360,0,360,20,380,380,0,0
5767,2019-02-14,149,0,149,11,160,160,0,0
5768,2019-02-14,723,0,723,57,780,780,0,0
5769,2019-02-14,852,0,852,68,920,0,920,0
5770,2019-02-14,1519,0,1519,121,1640,1640,0,0
5771,2019-02-14,232,0,232,18,250,250,0,0
5772,2019-02-14,1038,0,1038,82,1120,1120,0,0
5773,2019-02-14,667,0,667,53,720,720,0,0
5774,2019-02-14,445,0,445,35,480,480,0,0
5775,2019-02-14,176,0,176,14,190,190,0,0
5776,2019-02-14,575,0,575,45,620,620,0,0
5777,2019-02-14,1075,0,1075,85,1160,1160,0,0
5778,2019-02-14,1149,0,1149,91,1240,1240,0,0
5779,2019-02-14,760,0,760,60,820,820,0,0
5780,2019-02-14,473,0,473,37,510,510,0,0
5781,2019-02-14,908,0,908,72,980,980,0,0
5782,2019-02-14,1815,0,1815,145,1960,1960,0,0
5783,2019-02-14,436,0,436,34,470,470,0,0
5784,2019-02-14,658,0,658,52,710,710,0,0
5785,2019-02-14,139,0,139,11,150,150,0,0
5786,2019-02-14,741,0,741,59,800,800,0,0
5787,2019-02-14,389,0,389,31,420,420,0,0
5788,2019-02-14,149,0,149,11,160,160,0,0
5789,2019-02-14,686,0,686,54,740,740,0,0
5790,2019-02-14,593,0,593,47,640,640,0,0
5791,2019-02-14,1380,0,1380,110,1490,1490,0,0
5792,2019-02-14,473,0,473,37,510,510,0,0
5793,2019-02-14,482,0,482,38,520,520,0,0
5794,2019-02-14,1454,0,1454,116,1570,1570,0,0
5795,2019-02-14,908,0,908,72,980,980,0,0
5796,2019-02-14,2917,0,2917,233,3150,3150,0,0
5797,2019-02-14,305,0,305,15,320,320,0,0
5798,2019-02-14,1038,0,1038,82,1120,1120,0,0
5799,2019-02-14,621,0,621,49,670,670,0,0
5800,2019-02-14,547,0,547,43,590,590,0,0
5801,2019-02-14,1065,0,1065,85,1150,1150,0,0
5802,2019-02-14,1065,0,1065,85,1150,1150,0,0
5803,2019-02-14,501,0,501,39,540,540,0,0
5804,2019-02-14,417,0,417,33,450,450,0,0
5805,2019-02-14,1822,0,1822,128,1950,1950,0,0
5806,2019-02-14,936,0,936,74,1010,1010,0,0
5807,2019-02-14,871,0,871,69,940,940,0,0
5808,2019-02-14,167,0,167,13,180,180,0,0
5809,2019-02-14,371,0,371,29,400,400,0,0
5810,2019-02-14,334,0,334,26,360,360,0,0
5811,2019-02-14,167,0,167,13,180,180,0,0
5812,2019-02-14,500,0,500,40,540,540,0,0
5813,2019-02-14,1362,0,1362,108,1470,1470,0,0
5814,2019-02-14,1093,0,1093,87,1180,0,1180,0
5815,2019-02-14,1630,0,1630,130,1760,1760,0,0
5816,2019-02-14,973,0,973,77,1050,1050,0,0
5817,2019-02-14,1288,0,1288,102,1390,1390,0,0
5818,2019-02-14,797,0,797,63,860,860,0,0
5819,2019-02-14,399,0,399,31,430,430,0,0
5820,2019-02-14,315,0,315,25,340,340,0,0
5821,2019-02-14,621,0,621,49,670,670,0,0
5822,2019-02-14,815,0,815,65,880,880,0,0
5823,2019-02-14,371,0,371,29,400,400,0,0
5824,2019-02-14,908,0,908,72,980,980,0,0
5825,2019-02-14,1149,0,1149,91,1240,1240,0,0
5826,2019-02-14,498,0,498,22,520,520,0,0
5827,2019-02-14,288,0,288,22,310,310,0,0
5828,2019-02-14,380,0,380,30,410,410,0,0
5829,2019-02-14,778,0,778,62,840,840,0,0
5830,2019-02-14,278,0,278,22,300,300,0,0
5831,2019-02-14,519,0,519,41,560,560,0,0
5832,2019-02-14,788,0,788,62,850,850,0,0
5833,2019-02-14,2602,0,2602,208,2810,2810,0,0
5834,2019-02-14,232,0,232,18,250,250,0,0
5835,2019-02-14,1723,0,1723,137,1860,1860,0,0
5836,2019-02-14,954,0,954,76,1030,1030,0,0
5837,2019-02-14,334,0,334,26,360,360,0,0
5838,2019-02-14,658,0,658,52,710,710,0,0
5839,2019-02-14,788,0,788,62,850,850,0,0
5840,2019-02-14,1973,0,1973,157,2130,2130,0,0
5841,2019-02-14,1001,0,1001,79,1080,1080,0,0
5842,2019-02-14,389,0,389,31,420,420,0,0
5843,2019-02-14,1232,0,1232,98,1330,1330,0,0
5844,2019-02-14,1260,0,1260,100,1360,1360,0,0
5845,2019-02-14,788,0,788,62,850,850,0,0
5846,2019-02-14,1047,0,1047,83,1130,1130,0,0
5847,2019-02-14,602,0,602,48,650,650,0,0
5848,2019-02-15,723,0,723,57,780,780,0,0
5849,2019-02-15,1084,0,1084,86,1170,1170,0,0
5850,2019-02-15,593,0,593,47,640,640,0,0
5851,2019-02-15,528,0,528,42,570,570,0,0
5852,2019-02-15,871,0,871,69,940,940,0,0
5853,2019-02-15,389,0,389,31,420,420,0,0
5854,2019-02-15,1732,0,1732,138,1870,1870,0,0
5855,2019-02-15,306,0,306,24,330,330,0,0
5856,2019-02-15,1278,0,1278,102,1380,1380,0,0
5857,2019-02-15,834,0,834,66,900,900,0,0
5858,2019-02-15,760,0,760,60,820,820,0,0
5859,2019-02-15,-389,0,-389,-31,-420,-420,0,0
5860,2019-02-15,445,0,445,35,480,480,0,0
5861,2019-02-15,426,0,426,34,460,460,0,0
5862,2019-02-15,991,0,991,79,1070,1070,0,0
5863,2019-02-15,130,0,130,10,140,140,0,0
5864,2019-02-15,769,0,769,61,830,830,0,0
5865,2019-02-15,288,0,288,22,310,310,0,0
5866,2019-02-15,306,0,306,24,330,330,0,0
5867,2019-02-15,788,0,788,62,850,850,0,0
5868,2019-02-15,1352,0,1352,108,1460,1460,0,0
5869,2019-02-15,259,0,259,11,270,270,0,0
5870,2019-02-15,1028,0,1028,82,1110,1110,0,0
5871,2019-02-15,732,0,732,58,790,790,0,0
5872,2019-02-15,814,0,814,56,870,870,0,0
5873,2019-02-15,758,0,758,42,800,800,0,0
5874,2019-02-15,695,0,695,55,750,750,0,0
5875,2019-02-15,908,0,908,72,980,980,0,0
5876,2019-02-15,584,0,584,46,630,630,0,0
5877,2019-02-15,1001,0,1001,79,1080,1080,0,0
5878,2019-02-15,760,0,760,60,820,820,0,0
5879,2019-02-15,288,0,288,22,310,310,0,0
5880,2019-02-15,658,0,658,52,710,710,0,0
5881,2019-02-15,908,0,908,72,980,0,980,0
5882,2019-02-15,519,0,519,41,560,560,0,0
5883,2019-02-15,232,0,232,18,250,250,0,0
5884,2019-02-15,917,0,917,73,990,990,0,0
5885,2019-02-15,1917,0,1917,153,2070,2070,0,0
5886,2019-02-15,766,-82,684,54,738,738,0,0
5887,2019-02-15,528,0,528,42,570,570,0,0
5888,2019-02-15,1010,0,1010,80,1090,1090,0,0
5889,2019-02-15,862,0,862,68,930,930,0,0
5890,2019-02-15,362,0,362,28,390,390,0,0
5891,2019-02-15,1084,0,1084,86,1170,1170,0,0
5892,2019-02-15,672,0,672,53,725,725,0,0
5893,2019-02-15,269,0,269,21,290,290,0,0
5894,2019-02-15,908,0,908,72,980,980,0,0
5895,2019-02-15,908,0,908,72,980,980,0,0
5896,2019-02-15,788,0,788,62,850,850,0,0
5897,2019-02-15,306,0,306,24,330,330,0,0
5898,2019-02-15,991,0,991,79,1070,1070,0,0
5899,2019-02-15,167,0,167,13,180,180,0,0
5900,2019-02-15,232,0,232,18,250,250,0,0
5901,2019-02-15,288,0,288,22,310,310,0,0
5902,2019-02-15,463,0,463,37,500,500,0,0
5903,2019-02-15,528,0,528,42,570,570,0,0
5904,2019-02-15,436,0,436,34,470,470,0,0
5905,2019-02-15,352,0,352,28,380,380,0,0
5906,2019-02-15,1806,0,1806,144,1950,1950,0,0
5907,2019-02-15,417,0,417,33,450,450,0,0
5908,2019-02-15,547,0,547,43,590,590,0,0
5909,2019-02-15,584,0,584,46,630,630,0,0
5910,2019-02-15,1815,0,1815,145,1960,1960,0,0
5911,2019-02-15,371,0,371,29,400,400,0,0
5912,2019-02-15,380,0,380,30,410,410,0,0
5913,2019-02-15,741,0,741,59,800,800,0,0
5914,2019-02-15,232,0,232,18,250,0,250,0
5915,2019-02-15,334,0,334,26,360,360,0,0
5916,2019-02-15,556,0,556,44,600,600,0,0
5917,2019-02-15,1075,0,1075,85,1160,1160,0,0
5918,2019-02-15,519,0,519,41,560,560,0,0
5919,2019-02-15,528,0,528,42,570,570,0,0
5920,2019-02-15,1001,0,1001,79,1080,1080,0,0
5921,2019-02-15,686,0,686,54,740,740,0,0
5922,2019-02-15,797,0,797,63,860,860,0,0
5923,2019-02-15,278,0,278,22,300,300,0,0
5924,2019-02-15,788,0,788,62,850,850,0,0
5925,2019-02-15,213,0,213,17,230,230,0,0
5926,2019-02-15,454,0,454,36,490,490,0,0
5927,2019-02-15,612,0,612,48,660,660,0,0
5928,2019-02-15,499,-106,393,31,424,424,0,0
5929,2019-02-15,584,0,584,46,630,630,0,0
5930,2019-02-15,1161,0,1161,39,1200,1200,0,0
5931,2019-02-15,269,0,269,21,290,290,0,0
5932,2019-02-15,112,0,112,8,120,120,0,0
5933,2019-02-15,1047,0,1047,83,1130,1130,0,0
5934,2019-02-15,1084,0,1084,86,1170,1170,0,0
5935,2019-02-15,371,0,371,29,400,400,0,0
5936,2019-02-15,565,0,565,45,610,610,0,0
5937,2019-02-15,998,-212,786,62,848,848,0,0
5938,2019-02-15,112,0,112,8,120,120,0,0
5939,2019-02-15,1038,0,1038,82,1120,1120,0,0
5940,2019-02-15,510,0,510,40,550,550,0,0
5941,2019-02-15,343,0,343,27,370,370,0,0
5942,2019-02-15,278,0,278,22,300,300,0,0
5943,2019-02-15,871,0,871,69,940,940,0,0
5944,2019-02-15,926,0,926,74,1000,1000,0,0
5945,2019-02-15,1815,0,1815,145,1960,1960,0,0
5946,2019-02-15,121,0,121,9,130,130,0,0
5947,2019-02-15,630,0,630,50,680,680,0,0
5948,2019-02-15,1575,0,1575,125,1700,1700,0,0
5949,2019-02-15,732,0,732,58,790,790,0,0
5950,2019-02-15,1315,0,1315,105,1420,1420,0,0
5951,2019-02-15,547,0,547,43,590,590,0,0
5952,2019-02-15,741,0,741,59,800,800,0,0
5953,2019-02-15,277,0,277,13,290,290,0,0
5954,2019-02-15,380,0,380,30,410,410,0,0
5955,2019-02-15,1195,0,1195,95,1290,1290,0,0
5956,2019-02-15,482,0,482,38,520,520,0,0
5957,2019-02-15,908,0,908,72,980,980,0,0
5958,2019-02-15,1815,0,1815,145,1960,1960,0,0
5959,2019-02-15,371,0,371,29,400,400,0,0
5960,2019-02-15,575,0,575,45,620,620,0,0
5961,2019-02-15,1241,0,1241,99,1340,1340,0,0
5962,2019-02-15,658,0,658,52,710,710,0,0
5963,2019-02-15,1186,0,1186,94,1280,1280,0,0
5964,2019-02-15,473,0,473,37,510,510,0,0
5965,2019-02-15,908,0,908,72,980,980,0,0
5966,2019-02-15,778,0,778,62,840,840,0,0
5967,2019-02-15,1538,0,1538,122,1660,1660,0,0
5968,2019-02-15,491,0,491,39,530,530,0,0
5969,2019-02-15,510,0,510,40,550,550,0,0
5970,2019-02-15,556,0,556,44,600,600,0,0
5971,2019-02-15,917,0,917,73,990,990,0,0
5972,2019-02-15,908,0,908,72,980,0,980,0
5973,2019-02-15,260,0,260,20,280,280,0,0
5974,2019-02-15,1751,0,1751,139,1890,1890,0,0
5975,2019-02-15,834,0,834,66,900,900,0,0
5976,2019-02-15,232,0,232,18,250,250,0,0
5977,2019-02-15,760,0,760,60,820,820,0,0
5978,2019-02-15,1288,0,1288,102,1390,1390,0,0
5979,2019-02-15,538,0,538,42,580,580,0,0
5980,2019-02-15,241,0,241,19,260,260,0,0
5981,2019-02-16,1408,0,1408,112,1520,1520,0,0
5982,2019-02-16,908,0,908,72,980,980,0,0
5983,2019-02-16,1815,0,1815,145,1960,1960,0,0
5984,2019-02-16,112,0,112,8,120,120,0,0
5985,2019-02-16,547,0,547,43,590,590,0,0
5986,2019-02-16,1009,-108,901,71,972,972,0,0
5987,2019-02-16,399,0,399,31,430,430,0,0
5988,2019-02-16,1815,0,1815,145,1960,1960,0,0
5989,2019-02-16,1010,0,1010,80,1090,1090,0,0
5990,2019-02-16,408,0,408,32,440,440,0,0
5991,2019-02-16,315,0,315,25,340,340,0,0
5992,2019-02-16,584,0,584,46,630,630,0,0
5993,2019-02-16,501,0,501,39,540,540,0,0
5994,2019-02-16,1093,0,1093,87,1180,1180,0,0
5995,2019-02-16,963,0,963,77,1040,1040,0,0
5996,2019-02-16,1815,0,1815,145,1960,1960,0,0
5997,2019-02-16,954,0,954,76,1030,1030,0,0
5998,2019-02-16,-908,0,-908,-72,-980,-980,0,0
5999,2019-02-16,908,0,908,72,980,980,0,0
6000,2019-02-16,1167,0,1167,93,1260,1260,0,0
6001,2019-02-16,334,0,334,26,360,360,0,0
6002,2019-02-16,297,0,297,23,320,320,0,0
6003,2019-02-16,288,0,288,22,310,310,0,0
6004,2019-02-16,334,0,334,26,360,360,0,0
6005,2019-02-16,732,0,732,58,790,790,0,0
6006,2019-02-16,500,0,500,40,540,540,0,0
6007,2019-02-16,306,0,306,24,330,330,0,0
6008,2019-02-16,269,0,269,21,290,290,0,0
6009,2019-02-16,1815,0,1815,145,1960,1960,0,0
6010,2019-02-16,676,0,676,54,730,730,0,0
6011,2019-02-16,630,0,630,50,680,680,0,0
6012,2019-02-16,292,0,292,23,315,315,0,0
6013,2019-02-16,1260,0,1260,100,1360,1360,0,0
6014,2019-02-16,240,0,240,10,250,250,0,0
6015,2019-02-16,1158,0,1158,92,1250,0,1250,0
6016,2019-02-16,232,0,232,18,250,250,0,0
6017,2019-02-16,362,0,362,28,390,390,0,0
6018,2019-02-16,899,0,899,71,970,970,0,0
6019,2019-02-16,751,0,751,59,810,0,810,0
6020,2019-02-16,371,0,371,29,400,400,0,0
6021,2019-02-16,621,0,621,49,670,670,0,0
6022,2019-02-16,769,0,769,61,830,830,0,0
6023,2019-02-16,778,0,778,62,840,840,0,0
6024,2019-02-16,1815,0,1815,145,1960,1960,0,0
6025,2019-02-16,232,0,232,18,250,250,0,0
6026,2019-02-16,862,0,862,68,930,930,0,0
6027,2019-02-16,1278,0,1278,102,1380,1380,0,0
6028,2019-02-16,908,0,908,72,980,980,0,0
6029,2019-02-16,426,0,426,34,460,460,0,0
6030,2019-02-16,815,0,815,65,880,880,0,0
6031,2019-02-16,1388,0,1388,102,1490,0,1490,0
6032,2019-02-16,630,0,630,50,680,680,0,0
6033,2019-02-16,722,0,722,48,770,770,0,0
6034,2019-02-16,630,0,630,50,680,680,0,0
6035,2019-02-16,204,0,204,16,220,220,0,0
6036,2019-02-16,769,0,769,61,830,830,0,0
6037,2019-02-16,425,0,425,25,450,450,0,0
6038,2019-02-16,778,0,778,62,840,840,0,0
6039,2019-02-16,797,0,797,63,860,860,0,0
6040,2019-02-16,362,0,362,28,390,390,0,0
6041,2019-02-16,768,0,768,52,820,820,0,0
6042,2019-02-16,1323,0,1323,97,1420,1420,0,0
6043,2019-02-16,607,0,607,48,655,655,0,0
6044,2019-02-16,1176,0,1176,94,1270,1270,0,0
6045,2019-02-16,1232,0,1232,98,1330,1330,0,0
6046,2019-02-16,2001,0,2001,159,2160,2160,0,0
6047,2019-02-16,473,0,473,37,510,510,0,0
6048,2019-02-16,815,0,815,65,880,880,0,0
6049,2019-02-16,899,0,899,71,970,970,0,0
6050,2019-02-16,917,0,917,73,990,990,0,0
6051,2019-02-16,584,0,584,46,630,630,0,0
6052,2019-02-16,528,0,528,42,570,570,0,0
6053,2019-02-16,749,0,749,51,800,800,0,0
6054,2019-02-16,352,0,352,28,380,380,0,0
6055,2019-02-16,1815,0,1815,145,1960,1960,0,0
6056,2019-02-16,778,0,778,62,840,840,0,0
6057,2019-02-16,472,0,472,28,500,500,0,0
6058,2019-02-16,2278,0,2278,182,2460,2460,0,0
6059,2019-02-16,649,0,649,51,700,700,0,0
6060,2019-02-16,408,0,408,32,440,440,0,0
6061,2019-02-16,788,0,788,62,850,850,0,0
6062,2019-02-16,639,0,639,51,690,690,0,0
6063,2019-02-16,1760,0,1760,140,1900,1900,0,0
6064,2019-02-16,528,0,528,42,570,570,0,0
6065,2019-02-16,426,0,426,34,460,460,0,0
6066,2019-02-16,528,0,528,42,570,570,0,0
6067,2019-02-16,297,0,297,23,320,320,0,0
6068,2019-02-16,751,0,751,59,810,810,0,0
6069,2019-02-16,2130,0,2130,170,2300,2300,0,0
6070,2019-02-16,1575,0,1575,125,1700,1700,0,0
6071,2019-02-16,1575,0,1575,125,1700,1700,0,0
6072,2019-02-16,1575,0,1575,125,1700,1700,0,0
6073,2019-02-16,1065,0,1065,85,1150,1150,0,0
6074,2019-02-16,1065,0,1065,85,1150,1150,0,0
6075,2019-02-16,695,0,695,55,750,750,0,0
6076,2019-02-16,510,0,510,40,550,550,0,0
6077,2019-02-16,547,0,547,43,590,590,0,0
6078,2019-02-16,454,0,454,36,490,490,0,0
6079,2019-02-16,760,0,760,60,820,820,0,0
6080,2019-02-16,732,0,732,58,790,790,0,0
6081,2019-02-16,2001,0,2001,159,2160,0,2160,0
6082,2019-02-16,1158,0,1158,92,1250,1250,0,0
6083,2019-02-16,538,0,538,42,580,580,0,0
6084,2019-02-16,635,0,635,50,685,685,0,0
6085,2019-02-16,667,0,667,53,720,0,720,0
6086,2019-02-16,602,0,602,48,650,650,0,0
6087,2019-02-16,232,0,232,18,250,250,0,0
6088,2019-02-16,556,0,556,44,600,600,0,0
6089,2019-02-16,260,0,260,20,280,280,0,0
6090,2019-02-16,2389,0,2389,191,2580,2580,0,0
6091,2019-02-16,352,0,352,28,380,380,0,0
6092,2019-02-16,741,0,741,59,800,800,0,0
6093,2019-02-16,389,0,389,31,420,420,0,0
6094,2019-02-16,102,0,102,8,110,110,0,0
6095,2019-02-16,1908,0,1908,152,2060,2060,0,0
6096,2019-02-16,417,0,417,33,450,450,0,0
6097,2019-02-16,584,0,584,46,630,630,0,0
6098,2019-02-16,260,0,260,20,280,280,0,0
6099,2019-02-16,649,0,649,51,700,700,0,0
6100,2019-02-16,602,0,602,48,650,650,0,0
6101,2019-02-16,250,0,250,20,270,270,0,0
6102,2019-02-16,195,0,195,15,210,210,0,0
6103,2019-02-16,769,0,769,61,830,830,0,0
6104,2019-02-16,325,0,325,25,350,350,0,0
6105,2019-02-16,695,0,695,55,750,750,0,0
6106,2019-02-16,593,0,593,47,640,640,0,0
6107,2019-02-16,139,0,139,11,150,150,0,0
6108,2019-02-16,788,0,788,62,850,850,0,0
6109,2019-02-16,565,0,565,45,610,610,0,0
6110,2019-02-16,1389,0,1389,111,1500,1500,0,0
6111,2019-02-16,1371,0,1371,109,1480,1480,0,0
6112,2019-02-16,649,0,649,51,700,700,0,0
6113,2019-02-16,288,0,288,22,310,310,0,0
6114,2019-02-16,426,0,426,34,460,460,0,0
6115,2019-02-16,251,0,251,19,270,270,0,0
6116,2019-02-16,1667,0,1667,133,1800,1800,0,0
6117,2019-02-16,1065,0,1065,85,1150,1150,0,0
6118,2019-02-16,250,0,250,20,270,270,0,0
6119,2019-02-16,1815,0,1815,145,1960,1960,0,0
6120,2019-02-16,213,0,213,17,230,230,0,0
6121,2019-02-16,1100,0,1100,70,1170,1170,0,0
6122,2019-02-16,1114,-234,880,56,936,936,0,0
6123,2019-02-16,575,0,575,45,620,620,0,0
6124,2019-02-16,-1100,0,-1100,-70,-1170,-1170,0,0
6125,2019-02-16,371,0,371,29,400,400,0,0
6126,2019-02-16,788,0,788,62,850,850,0,0
6127,2019-02-16,1889,0,1889,151,2040,2040,0,0
6128,2019-02-16,954,0,954,76,1030,1030,0,0
6129,2019-02-16,426,0,426,34,460,460,0,0
6130,2019-02-16,269,0,269,21,290,290,0,0
6131,2019-02-16,2510,0,2510,200,2710,2710,0,0
6132,2019-02-16,1575,0,1575,125,1700,1700,0,0
6133,2019-02-16,260,0,260,20,280,280,0,0
6134,2019-02-16,667,0,667,53,720,720,0,0
6135,2019-02-16,658,0,658,52,710,710,0,0
6136,2019-02-16,102,0,102,8,110,110,0,0
6137,2019-02-16,1575,0,1575,125,1700,1700,0,0
6138,2019-02-16,1676,0,1676,134,1810,1810,0,0
6139,2019-02-16,1575,0,1575,125,1700,1700,0,0
6140,2019-02-16,788,0,788,62,850,850,0,0
6141,2019-02-16,1491,0,1491,119,1610,1610,0,0
6142,2019-02-16,371,0,371,29,400,400,0,0
6143,2019-02-16,788,0,788,62,850,850,0,0
6144,2019-02-16,788,0,788,62,850,850,0,0
6145,2019-02-16,695,0,695,55,750,750,0,0
6146,2019-02-16,343,0,343,27,370,370,0,0
6147,2019-02-16,704,0,704,56,760,760,0,0
6148,2019-02-16,889,0,889,71,960,960,0,0
6149,2019-02-16,945,0,945,75,1020,1020,0,0
6150,2019-02-17,908,0,908,72,980,980,0,0
6151,2019-02-17,908,0,908,72,980,980,0,0
6152,2019-02-17,538,0,538,42,580,580,0,0
6153,2019-02-17,871,0,871,69,940,940,0,0
6154,2019-02-17,1121,0,1121,89,1210,1210,0,0
6155,2019-02-17,528,0,528,42,570,570,0,0
6156,2019-02-17,732,0,732,58,790,790,0,0
6157,2019-02-17,1844,-392,1452,116,1568,1568,0,0
6158,2019-02-17,454,0,454,36,490,490,0,0
6159,2019-02-17,866,-184,682,54,736,736,0,0
6160,2019-02-17,343,0,343,27,370,370,0,0
6161,2019-02-17,454,0,454,36,490,490,0,0
6162,2019-02-17,852,0,852,68,920,920,0,0
6163,2019-02-17,491,0,491,39,530,530,0,0
6164,2019-02-17,889,0,889,71,960,960,0,0
6165,2019-02-17,1232,0,1232,98,1330,1330,0,0
6166,2019-02-17,297,0,297,23,320,320,0,0
6167,2019-02-17,56,0,56,4,60,60,0,0
6168,2019-02-17,505,-54,451,35,486,486,0,0
6169,2019-02-17,399,0,399,31,430,430,0,0
6170,2019-02-17,482,0,482,38,520,520,0,0
6171,2019-02-17,389,0,389,31,420,420,0,0
6172,2019-02-17,1676,0,1676,134,1810,1810,0,0
6173,2019-02-17,899,0,899,71,970,970,0,0
6174,2019-02-17,417,0,417,33,450,450,0,0
6175,2019-02-17,1815,0,1815,145,1960,0,1960,0
6176,2019-02-17,251,0,251,19,270,270,0,0
6177,2019-02-17,1760,0,1760,140,1900,1900,0,0
6178,2019-02-17,852,0,852,68,920,920,0,0
6179,2019-02-17,47,0,47,3,50,50,0,0
6180,2019-02-17,630,0,630,50,680,680,0,0
6181,2019-02-17,454,0,454,36,490,490,0,0
6182,2019-02-17,1028,0,1028,82,1110,1110,0,0
6183,2019-02-17,621,0,621,49,670,670,0,0
6184,2019-02-17,2606,-554,2052,164,2216,2216,0,0
6185,2019-02-17,334,0,334,26,360,360,0,0
6186,2019-02-17,852,0,852,68,920,920,0,0
6187,2019-02-17,408,0,408,32,440,440,0,0
6188,2019-02-17,668,-142,526,42,568,568,0,0
6189,2019-02-17,621,0,621,49,670,670,0,0
6190,2019-02-17,639,0,639,51,690,690,0,0
6191,2019-02-17,362,0,362,28,390,390,0,0
6192,2019-02-17,973,0,973,77,1050,1050,0,0
6193,2019-02-17,231,0,231,9,240,240,0,0
6194,2019-02-17,621,0,621,49,670,670,0,0
6195,2019-02-17,454,0,454,36,490,490,0,0
6196,2019-02-17,528,0,528,42,570,570,0,0
6197,2019-02-17,417,0,417,33,450,450,0,0
6198,2019-02-17,454,0,454,36,490,490,0,0
6199,2019-02-17,908,0,908,72,980,980,0,0
6200,2019-02-17,1092,-117,975,78,1053,1053,0,0
6201,2019-02-17,630,0,630,50,680,680,0,0
6202,2019-02-17,204,0,204,16,220,220,0,0
6203,2019-02-17,547,0,547,43,590,590,0,0
6204,2019-02-17,167,0,167,13,180,180,0,0
6205,2019-02-17,251,0,251,19,270,270,0,0
6206,2019-02-17,315,0,315,25,340,340,0,0
6207,2019-02-17,908,0,908,72,980,980,0,0
6208,2019-02-17,667,0,667,53,720,720,0,0
6209,2019-02-17,1815,0,1815,145,1960,1960,0,0
6210,2019-02-17,658,0,658,52,710,710,0,0
6211,2019-02-17,1815,0,1815,145,1960,1960,0,0
6212,2019-02-17,306,0,306,24,330,330,0,0
6213,2019-02-17,1973,0,1973,157,2130,2130,0,0
6214,2019-02-17,908,0,908,72,980,980,0,0
6215,2019-02-17,1204,0,1204,96,1300,1300,0,0
6216,2019-02-17,889,0,889,71,960,960,0,0
6217,2019-02-17,806,0,806,64,870,870,0,0
6218,2019-02-17,371,0,371,29,400,400,0,0
6219,2019-02-17,501,0,501,39,540,540,0,0
6220,2019-02-17,251,0,251,19,270,270,0,0
6221,2019-02-17,112,0,112,8,120,120,0,0
6222,2019-02-17,241,0,241,19,260,260,0,0
6223,2019-02-17,501,0,501,39,540,540,0,0
6224,2019-02-17,834,0,834,66,900,900,0,0
6225,2019-02-17,639,0,639,51,690,690,0,0
6226,2019-02-17,408,0,408,32,440,440,0,0
6227,2019-02-17,1065,0,1065,85,1150,1150,0,0
6228,2019-02-17,269,0,269,21,290,290,0,0
6229,2019-02-17,1167,0,1167,93,1260,1260,0,0
6230,2019-02-17,538,0,538,42,580,580,0,0
6231,2019-02-17,436,0,436,34,470,470,0,0
6232,2019-02-17,223,0,223,17,240,240,0,0
6233,2019-02-17,232,0,232,18,250,250,0,0
6234,2019-02-17,954,0,954,76,1030,1030,0,0
6235,2019-02-17,1815,0,1815,145,1960,1960,0,0
6236,2019-02-17,862,0,862,68,930,930,0,0
6237,2019-02-17,325,0,325,25,350,350,0,0
6238,2019-02-17,232,0,232,18,250,250,0,0
6239,2019-02-17,269,0,269,21,290,290,0,0
6240,2019-02-17,389,0,389,31,420,420,0,0
6241,2019-02-17,1917,0,1917,153,2070,2070,0,0
6242,2019-02-17,547,0,547,43,590,590,0,0
6243,2019-02-17,528,0,528,42,570,570,0,0
6244,2019-02-17,760,0,760,60,820,820,0,0
6245,2019-02-17,260,0,260,20,280,280,0,0
6246,2019-02-17,519,0,519,41,560,560,0,0
6247,2019-02-17,399,0,399,31,430,430,0,0
6248,2019-02-17,112,0,112,8,120,120,0,0
6249,2019-02-17,1204,0,1204,96,1300,1300,0,0
6250,2019-02-17,788,0,788,62,850,850,0,0
6251,2019-02-17,843,0,843,67,910,910,0,0
6252,2019-02-17,945,0,945,75,1020,1020,0,0
6253,2019-02-17,788,0,788,62,850,850,0,0
6254,2019-02-17,667,0,667,53,720,720,0,0
6255,2019-02-17,658,0,658,52,710,710,0,0
6256,2019-02-17,1908,0,1908,152,2060,2060,0,0
6257,2019-02-17,1925,0,1925,145,2070,2070,0,0
6258,2019-02-17,1443,0,1443,97,1540,0,1540,0
6259,2019-02-17,741,0,741,59,800,800,0,0
6260,2019-02-17,362,0,362,28,390,390,0,0
6261,2019-02-17,556,0,556,44,600,600,0,0
6262,2019-02-17,417,0,417,33,450,450,0,0
6263,2019-02-17,556,0,556,44,600,600,0,0
6264,2019-02-17,260,0,260,20,280,280,0,0
6265,2019-02-17,1269,0,1269,101,1370,1370,0,0
6266,2019-02-17,251,0,251,19,270,270,0,0
6267,2019-02-17,445,0,445,35,480,480,0,0
6268,2019-02-17,491,0,491,39,530,530,0,0
6269,2019-02-17,2130,0,2130,170,2300,2300,0,0
6270,2019-02-17,436,0,436,34,470,470,0,0
6271,2019-02-17,1575,0,1575,125,1700,1700,0,0
6272,2019-02-17,278,0,278,22,300,300,0,0
6273,2019-02-17,788,0,788,62,850,850,0,0
6274,2019-02-17,482,0,482,38,520,520,0,0
6275,2019-02-17,2130,0,2130,170,2300,2300,0,0
6276,2019-02-17,1741,0,1741,139,1880,1880,0,0
6277,2019-02-17,788,0,788,62,850,850,0,0
6278,2019-02-17,2223,0,2223,177,2400,2400,0,0
6279,2019-02-17,510,0,510,40,550,550,0,0
6280,2019-02-17,1575,0,1575,125,1700,1700,0,0
6281,2019-02-17,815,0,815,65,880,880,0,0
6282,2019-02-17,584,0,584,46,630,630,0,0
6283,2019-02-17,649,0,649,51,700,700,0,0
6284,2019-02-17,1926,0,1926,154,2080,0,2080,0
6285,2019-02-18,676,0,676,54,730,730,0,0
6286,2019-02-18,334,0,334,26,360,360,0,0
6287,2019-02-18,769,0,769,61,830,830,0,0
6288,2019-02-18,555,0,555,35,590,590,0,0
6289,2019-02-18,1699,-182,1517,121,1638,0,1638,0
6290,2019-02-18,426,0,426,34,460,460,0,0
6291,2019-02-18,908,0,908,72,980,0,980,0
6292,2019-02-18,405,-86,319,25,344,344,0,0
6293,2019-02-18,1815,0,1815,145,1960,1960,0,0
6294,2019-02-18,769,0,769,61,830,830,0,0
6295,2019-02-18,1526,0,1526,104,1630,1630,0,0
6296,2019-02-18,510,0,510,40,550,550,0,0
6297,2019-02-18,908,0,908,72,980,980,0,0
6298,2019-02-18,288,0,288,22,310,310,0,0
6299,2019-02-18,908,0,908,72,980,980,0,0
6300,2019-02-18,436,0,436,34,470,470,0,0
6301,2019-02-18,862,0,862,68,930,930,0,0
6302,2019-02-18,1362,0,1362,108,1470,1470,0,0
6303,2019-02-18,408,0,408,32,440,440,0,0
6304,2019-02-18,417,0,417,33,450,450,0,0
6305,2019-02-18,769,0,769,61,830,830,0,0
6306,2019-02-18,325,0,325,25,350,350,0,0
6307,2019-02-18,1362,0,1362,108,1470,1470,0,0
6308,2019-02-18,269,0,269,21,290,290,0,0
6309,2019-02-18,417,0,417,33,450,450,0,0
6310,2019-02-18,593,0,593,47,640,640,0,0
6311,2019-02-18,454,0,454,36,490,490,0,0
6312,2019-02-18,260,0,260,20,280,280,0,0
6313,2019-02-18,908,0,908,72,980,980,0,0
6314,2019-02-18,908,0,908,72,980,980,0,0
6315,2019-02-18,139,0,139,11,150,150,0,0
6316,2019-02-18,232,0,232,18,250,250,0,0
6317,2019-02-18,1815,0,1815,145,1960,1960,0,0
6318,2019-02-18,1102,0,1102,88,1190,1190,0,0
6319,2019-02-18,751,0,751,59,810,810,0,0
6320,2019-02-18,1510,0,1510,120,1630,1630,0,0
6321,2019-02-18,501,0,501,39,540,540,0,0
6322,2019-02-18,417,0,417,33,450,450,0,0
6323,2019-02-18,445,0,445,35,480,480,0,0
6324,2019-02-18,379,0,379,21,400,400,0,0
6325,2019-02-18,1232,0,1232,98,1330,1330,0,0
6326,2019-02-18,491,0,491,39,530,530,0,0
6327,2019-02-18,473,0,473,37,510,510,0,0
6328,2019-02-18,556,0,556,44,600,600,0,0
6329,2019-02-18,917,0,917,73,990,990,0,0
6330,2019-02-18,278,0,278,22,300,300,0,0
6331,2019-02-18,741,0,741,59,800,800,0,0
6332,2019-02-18,371,0,371,29,400,400,0,0
6333,2019-02-18,297,0,297,23,320,320,0,0
6334,2019-02-18,1065,0,1065,85,1150,1150,0,0
6335,2019-02-18,352,0,352,28,380,380,0,0
6336,2019-02-18,1038,0,1038,82,1120,1120,0,0
6337,2019-02-18,825,0,825,65,890,890,0,0
6338,2019-02-18,528,0,528,42,570,570,0,0
6339,2019-02-18,917,0,917,73,990,990,0,0
6340,2019-02-18,575,0,575,45,620,620,0,0
6341,2019-02-18,297,0,297,23,320,320,0,0
6342,2019-02-18,1593,0,1593,127,1720,1720,0,0
6343,2019-02-18,306,0,306,24,330,330,0,0
6344,2019-02-18,686,0,686,54,740,740,0,0
6345,2019-02-18,167,0,167,13,180,180,0,0
6346,2019-02-18,223,0,223,17,240,240,0,0
6347,2019-02-18,575,0,575,45,620,620,0,0
6348,2019-02-18,176,0,176,14,190,190,0,0
6349,2019-02-18,686,0,686,54,740,740,0,0
6350,2019-02-18,436,0,436,34,470,470,0,0
6351,2019-02-18,440,0,440,0,440,440,0,0
6352,2019-02-18,788,0,788,62,850,850,0,0
6353,2019-02-18,778,0,778,62,840,840,0,0
6354,2019-02-18,547,0,547,43,590,590,0,0
6355,2019-02-18,1019,0,1019,81,1100,1100,0,0
6356,2019-02-18,1038,0,1038,82,1120,1120,0,0
6357,2019-02-18,1852,0,1852,148,2000,2000,0,0
6358,2019-02-18,1852,0,1852,148,2000,2000,0,0
6359,2019-02-18,741,0,741,59,800,800,0,0
6360,2019-02-18,1954,0,1954,156,2110,2110,0,0
6361,2019-02-18,982,0,982,78,1060,1060,0,0
6362,2019-02-18,704,0,704,56,760,760,0,0
6363,2019-02-18,232,0,232,18,250,250,0,0
6364,2019-02-18,167,0,167,13,180,180,0,0
6365,2019-02-18,880,0,880,70,950,0,950,0
6366,2019-02-18,788,0,788,62,850,850,0,0
6367,2019-02-18,945,0,945,75,1020,1020,0,0
6368,2019-02-18,352,0,352,28,380,380,0,0
6369,2019-02-18,843,0,843,67,910,910,0,0
6370,2019-02-18,1575,0,1575,125,1700,1700,0,0
6371,2019-02-18,426,0,426,34,460,460,0,0
6372,2019-02-18,584,0,584,46,630,630,0,0
6373,2019-02-18,593,0,593,47,640,640,0,0
6374,2019-02-18,176,0,176,14,190,190,0,0
6375,2019-02-18,778,0,778,62,840,840,0,0
6376,2019-02-19,213,0,213,17,230,230,0,0
6377,2019-02-19,362,0,362,28,390,390,0,0
6378,2019-02-19,546,-116,430,34,464,464,0,0
6379,2019-02-19,731,-154,577,39,616,616,0,0
6380,2019-02-19,528,0,528,42,570,570,0,0
6381,2019-02-19,463,0,463,37,500,500,0,0
6382,2019-02-19,399,0,399,31,430,430,0,0
6383,2019-02-19,547,0,547,43,590,590,0,0
6384,2019-02-19,482,0,482,38,520,520,0,0
6385,2019-02-20,269,0,269,21,290,290,0,0
6386,2019-02-20,575,0,575,45,620,620,0,0
6387,2019-02-20,1158,0,1158,92,1250,1250,0,0
6388,2019-02-20,1232,0,1232,98,1330,1330,0,0
6389,2019-02-20,408,0,408,32,440,440,0,0
6390,2019-02-20,149,0,149,11,160,160,0,0
6391,2019-02-20,676,0,676,54,730,730,0,0
6392,2019-02-20,777,0,777,53,830,0,830,0
6393,2019-02-20,1093,0,1093,87,1180,1180,0,0
6394,2019-02-20,436,0,436,34,470,470,0,0
6395,2019-02-20,528,0,528,42,570,570,0,0
6396,2019-02-20,1167,0,1167,93,1260,1260,0,0
6397,2019-02-20,1685,0,1685,125,1810,1810,0,0
6398,2019-02-20,963,0,963,77,1040,1040,0,0
6399,2019-02-20,445,0,445,35,480,480,0,0
6400,2019-02-20,232,0,232,18,250,250,0,0
6401,2019-02-20,1306,0,1306,104,1410,1410,0,0
6402,2019-02-20,334,0,334,26,360,360,0,0
6403,2019-02-20,797,0,797,63,860,860,0,0
6404,2019-02-20,899,0,899,71,970,970,0,0
6405,2019-02-20,1186,0,1186,94,1280,1280,0,0
6406,2019-02-20,325,0,325,25,350,350,0,0
6407,2019-02-20,565,0,565,45,610,610,0,0
6408,2019-02-20,306,0,306,24,330,330,0,0
6409,2019-02-20,463,0,463,37,500,500,0,0
6410,2019-02-20,1815,0,1815,145,1960,1960,0,0
6411,2019-02-20,612,0,612,48,660,660,0,0
6412,2019-02-20,871,0,871,69,940,940,0,0
6413,2019-02-20,612,0,612,48,660,660,0,0
6414,2019-02-20,176,0,176,14,190,190,0,0
6415,2019-02-20,630,0,630,50,680,680,0,0
6416,2019-02-20,694,0,694,46,740,740,0,0
6417,2019-02-20,260,0,260,20,280,280,0,0
6418,2019-02-20,982,0,982,78,1060,1060,0,0
6419,2019-02-20,611,0,611,39,650,650,0,0
6420,2019-02-20,908,0,908,72,980,980,0,0
6421,2019-02-20,260,0,260,20,280,280,0,0
6422,2019-02-20,325,0,325,25,350,350,0,0
6423,2019-02-20,362,0,362,28,390,390,0,0
6424,2019-02-20,686,0,686,54,740,740,0,0
6425,2019-02-20,269,0,269,21,290,290,0,0
6426,2019-02-20,658,0,658,52,710,710,0,0
6427,2019-02-20,695,0,695,55,750,750,0,0
6428,2019-02-20,1093,0,1093,87,1180,1180,0,0
6429,2019-02-20,334,0,334,26,360,360,0,0
6430,2019-02-20,491,0,491,39,530,530,0,0
6431,2019-02-20,269,0,269,21,290,290,0,0
6432,2019-02-20,1547,0,1547,123,1670,1670,0,0
6433,2019-02-20,797,0,797,63,860,860,0,0
6434,2019-02-20,908,0,908,72,980,980,0,0
6435,2019-02-20,730,0,730,40,770,770,0,0
6436,2019-02-20,556,0,556,44,600,600,0,0
6437,2019-02-20,445,0,445,35,480,480,0,0
6438,2019-02-20,1065,0,1065,85,1150,1150,0,0
6439,2019-02-20,1354,-145,1209,96,1305,1305,0,0
6440,2019-02-20,723,0,723,57,780,780,0,0
6441,2019-02-20,788,0,788,62,850,850,0,0
6442,2019-02-20,788,0,788,62,850,850,0,0
6443,2019-02-20,695,0,695,55,750,750,0,0
6444,2019-02-20,788,0,788,62,850,850,0,0
6445,2019-02-20,788,0,788,62,850,850,0,0
6446,2019-02-20,1575,0,1575,125,1700,0,1700,0
6447,2019-02-20,788,0,788,62,850,850,0,0
6448,2019-02-20,139,0,139,11,150,150,0,0
6449,2019-02-20,704,0,704,56,760,760,0,0
6450,2019-02-20,371,0,371,29,400,400,0,0
6451,2019-02-20,371,0,371,29,400,400,0,0
6452,2019-02-20,473,0,473,37,510,510,0,0
6453,2019-02-20,788,0,788,62,850,850,0,0
6454,2019-02-20,269,0,269,21,290,290,0,0
6455,2019-02-20,788,0,788,62,850,850,0,0
6456,2019-02-20,306,0,306,24,330,330,0,0
6457,2019-02-20,676,0,676,54,730,730,0,0
6458,2019-02-20,362,0,362,28,390,390,0,0
6459,2019-02-20,352,0,352,28,380,380,0,0
6460,2019-02-20,612,0,612,48,660,660,0,0
6461,2019-02-20,686,0,686,54,740,740,0,0
6462,2019-02-20,769,0,769,61,830,830,0,0
6463,2019-02-20,556,0,556,44,600,600,0,0
6464,2019-02-20,1112,0,1112,88,1200,1200,0,0
6465,2019-02-20,547,0,547,43,590,590,0,0
6466,2019-02-20,1112,0,1112,88,1200,1200,0,0
6467,2019-02-20,306,0,306,24,330,330,0,0
6468,2019-02-20,713,0,713,57,770,770,0,0
6469,2019-02-20,510,0,510,40,550,550,0,0
6470,2019-02-20,788,0,788,62,850,850,0,0
6471,2019-02-20,908,0,908,72,980,980,0,0
6472,2019-02-20,1204,0,1204,96,1300,1300,0,0
6473,2019-02-20,908,0,908,72,980,980,0,0
6474,2019-02-20,12704,0,12704,1016,13720,13720,0,0
6475,2019-02-20,649,0,649,51,700,700,0,0
6476,2019-02-20,584,0,584,46,630,630,0,0
6477,2019-02-20,436,0,436,34,470,470,0,0
6478,2019-02-20,334,0,334,26,360,360,0,0
6479,2019-02-20,538,0,538,42,580,580,0,0
6480,2019-02-20,667,0,667,53,720,720,0,0
6481,2019-02-20,1019,0,1019,81,1100,1100,0,0
6482,2019-02-20,1278,0,1278,102,1380,1380,0,0
6483,2019-02-21,232,0,232,18,250,250,0,0
6484,2019-02-21,1815,0,1815,145,1960,1960,0,0
6485,2019-02-21,760,0,760,60,820,820,0,0
6486,2019-02-21,445,0,445,35,480,480,0,0
6487,2019-02-21,445,0,445,35,480,480,0,0
6488,2019-02-21,806,0,806,64,870,870,0,0
6489,2019-02-21,843,0,843,67,910,910,0,0
6490,2019-02-21,1195,0,1195,95,1290,1290,0,0
6491,2019-02-21,556,0,556,44,600,600,0,0
6492,2019-02-21,1815,0,1815,145,1960,1960,0,0
6493,2019-02-21,250,0,250,20,270,270,0,0
6494,2019-02-21,815,0,815,65,880,880,0,0
6495,2019-02-21,538,0,538,42,580,580,0,0
6496,2019-02-21,843,0,843,67,910,910,0,0
6497,2019-02-21,751,0,751,59,810,810,0,0
6498,2019-02-21,1815,0,1815,145,1960,0,1960,0
6499,2019-02-21,908,0,908,72,980,980,0,0
6500,2019-02-21,1657,0,1657,123,1780,1780,0,0
6501,2019-02-21,250,0,250,20,270,270,0,0
6502,2019-02-21,732,0,732,58,790,790,0,0
6503,2019-02-21,269,0,269,21,290,290,0,0
6504,2019-02-21,2139,0,2139,171,2310,2310,0,0
6505,2019-02-21,1815,0,1815,145,1960,1960,0,0
6506,2019-02-21,593,0,593,47,640,640,0,0
6507,2019-02-21,908,0,908,72,980,980,0,0
6508,2019-02-21,1084,0,1084,86,1170,1170,0,0
6509,2019-02-21,602,0,602,48,650,650,0,0
6510,2019-02-21,232,0,232,18,250,250,0,0
6511,2019-02-21,917,0,917,73,990,990,0,0
6512,2019-02-21,352,0,352,28,380,380,0,0
6513,2019-02-21,352,0,352,28,380,380,0,0
6514,2019-02-21,352,0,352,28,380,380,0,0
6515,2019-02-21,1001,0,1001,79,1080,1080,0,0
6516,2019-02-21,649,0,649,51,700,700,0,0
6517,2019-02-21,926,0,926,74,1000,1000,0,0
6518,2019-02-21,658,0,658,52,710,710,0,0
6519,2019-02-21,262,-28,234,18,252,252,0,0
6520,2019-02-21,686,0,686,54,740,740,0,0
6521,2019-02-21,806,0,806,64,870,870,0,0
6522,2019-02-21,528,0,528,42,570,570,0,0
6523,2019-02-21,360,0,360,20,380,380,0,0
6524,2019-02-21,899,0,899,71,970,970,0,0
6525,2019-02-21,686,0,686,54,740,740,0,0
6526,2019-02-21,528,0,528,42,570,570,0,0
6527,2019-02-21,915,-98,817,65,882,882,0,0
6528,2019-02-21,482,0,482,38,520,520,0,0
6529,2019-02-21,398,0,398,22,420,420,0,0
6530,2019-02-21,815,0,815,65,880,880,0,0
6531,2019-02-21,1010,0,1010,80,1090,1090,0,0
6532,2019-02-21,778,0,778,62,840,840,0,0
6533,2019-02-21,360,0,360,20,380,380,0,0
6534,2019-02-21,1575,0,1575,125,1700,0,1700,0
6535,2019-02-21,297,0,297,23,320,320,0,0
6536,2019-02-21,788,0,788,62,850,850,0,0
6537,2019-02-21,788,0,788,62,850,850,0,0
6538,2019-02-21,269,0,269,21,290,290,0,0
6539,2019-02-21,325,0,325,25,350,350,0,0
6540,2019-02-21,815,0,815,65,880,0,880,0
6541,2019-02-21,195,0,195,15,210,210,0,0
6542,2019-02-21,175,0,175,13,188,188,0,0
6543,2019-02-21,788,0,788,62,850,850,0,0
6544,2019-02-21,297,0,297,23,320,320,0,0
6545,2019-02-21,1102,0,1102,88,1190,1190,0,0
6546,2019-02-21,797,0,797,63,860,860,0,0
6547,2019-02-21,223,0,223,17,240,240,0,0
6548,2019-02-21,769,0,769,61,830,830,0,0
6549,2019-02-21,167,0,167,13,180,180,0,0
6550,2019-02-21,325,0,325,25,350,350,0,0
6551,2019-02-21,1575,0,1575,125,1700,1700,0,0
6552,2019-02-21,491,0,491,39,530,530,0,0
6553,2019-02-21,547,0,547,43,590,590,0,0
6554,2019-02-21,741,0,741,59,800,800,0,0
6555,2019-02-21,1260,0,1260,100,1360,1360,0,0
6556,2019-02-21,602,0,602,48,650,650,0,0
6557,2019-02-21,362,0,362,28,390,390,0,0
6558,2019-02-21,575,0,575,45,620,620,0,0
6559,2019-02-21,306,0,306,24,330,330,0,0
6560,2019-02-21,453,0,453,27,480,480,0,0
6561,2019-02-21,1380,0,1380,110,1490,1490,0,0
6562,2019-02-21,593,0,593,47,640,640,0,0
6563,2019-02-21,686,0,686,54,740,740,0,0
6564,2019-02-21,1833,0,1833,137,1970,1970,0,0
6565,2019-02-21,602,0,602,48,650,650,0,0
6566,2019-02-21,908,0,908,72,980,980,0,0
6567,2019-02-21,908,0,908,72,980,980,0,0
6568,2019-02-21,908,0,908,72,980,980,0,0
6569,2019-02-21,1195,0,1195,95,1290,1290,0,0
6570,2019-02-21,602,0,602,48,650,650,0,0
6571,2019-02-21,695,0,695,55,750,750,0,0
6572,2019-02-21,1815,0,1815,145,1960,0,1960,0
6573,2019-02-21,297,0,297,23,320,320,0,0
6574,2019-02-21,621,0,621,49,670,670,0,0
6575,2019-02-21,426,0,426,34,460,460,0,0
6576,2019-02-21,565,0,565,45,610,610,0,0
6577,2019-02-21,1019,0,1019,81,1100,1100,0,0
6578,2019-02-21,232,0,232,18,250,250,0,0
6579,2019-02-21,139,0,139,11,150,150,0,0
6580,2019-02-21,602,0,602,48,650,650,0,0
6581,2019-02-22,630,0,630,50,680,680,0,0
6582,2019-02-22,963,0,963,77,1040,1040,0,0
6583,2019-02-22,917,0,917,73,990,990,0,0
6584,2019-02-22,334,0,334,26,360,360,0,0
6585,2019-02-22,908,0,908,72,980,980,0,0
6586,2019-02-22,908,0,908,72,980,980,0,0
6587,2019-02-22,389,0,389,31,420,420,0,0
6588,2019-02-22,908,0,908,72,980,980,0,0
6589,2019-02-22,908,0,908,72,980,980,0,0
6590,2019-02-22,834,0,834,66,900,900,0,0
6591,2019-02-22,306,0,306,24,330,330,0,0
6592,2019-02-22,834,0,834,66,900,900,0,0
6593,2019-02-22,491,0,491,39,530,530,0,0
6594,2019-02-22,982,0,982,78,1060,1060,0,0
6595,2019-02-22,1815,0,1815,145,1960,1960,0,0
6596,2019-02-22,704,0,704,56,760,760,0,0
6597,2019-02-22,334,0,334,26,360,360,0,0
6598,2019-02-22,315,0,315,25,340,340,0,0
6599,2019-02-22,667,0,667,53,720,720,0,0
6600,2019-02-22,760,0,760,60,820,820,0,0
6601,2019-02-22,556,0,556,44,600,600,0,0
6602,2019-02-22,1815,0,1815,145,1960,0,1960,0
6603,2019-02-22,-760,0,-760,-60,-820,-820,0,0
6604,2019-02-22,2158,0,2158,172,2330,2330,0,0
6605,2019-02-22,538,0,538,42,580,580,0,0
6606,2019-02-22,575,0,575,45,620,620,0,0
6607,2019-02-22,491,0,491,39,530,530,0,0
6608,2019-02-22,1963,0,1963,157,2120,2120,0,0
6609,2019-02-22,1001,0,1001,79,1080,1080,0,0
6610,2019-02-22,389,0,389,31,420,420,0,0
6611,2019-02-22,945,0,945,75,1020,1020,0,0
6612,2019-02-22,889,0,889,71,960,960,0,0
6613,2019-02-22,315,0,315,25,340,340,0,0
6614,2019-02-22,908,0,908,72,980,980,0,0
6615,2019-02-22,1157,0,1157,83,1240,1240,0,0
6616,2019-02-22,806,0,806,64,870,870,0,0
6617,2019-02-22,575,0,575,45,620,620,0,0
6618,2019-02-22,278,0,278,22,300,300,0,0
6619,2019-02-22,908,0,908,72,980,980,0,0
6620,2019-02-22,575,0,575,45,620,620,0,0
6621,2019-02-22,269,0,269,21,290,290,0,0
6622,2019-02-22,584,0,584,46,630,630,0,0
6623,2019-02-22,908,0,908,72,980,980,0,0
6624,2019-02-22,704,0,704,56,760,760,0,0
6625,2019-02-22,251,0,251,19,270,270,0,0
6626,2019-02-22,436,0,436,34,470,470,0,0
6627,2019-02-22,232,0,232,18,250,250,0,0
6628,2019-02-22,241,0,241,19,260,260,0,0
6629,2019-02-22,519,0,519,41,560,560,0,0
6630,2019-02-22,519,0,519,41,560,560,0,0
6631,2019-02-22,630,0,630,50,680,680,0,0
6632,2019-02-22,713,0,713,57,770,770,0,0
6633,2019-02-22,325,0,325,25,350,350,0,0
6634,2019-02-22,223,0,223,17,240,240,0,0
6635,2019-02-22,760,0,760,60,820,820,0,0
6636,2019-02-22,834,0,834,66,900,900,0,0
6637,2019-02-22,908,0,908,72,980,980,0,0
6638,2019-02-22,501,0,501,39,540,540,0,0
6639,2019-02-22,278,0,278,22,300,300,0,0
6640,2019-02-22,186,0,186,14,200,200,0,0
6641,2019-02-22,620,0,620,40,660,660,0,0
6642,2019-02-22,933,0,933,57,990,990,0,0
6643,2019-02-22,954,0,954,76,1030,1030,0,0
6644,2019-02-22,908,0,908,72,980,980,0,0
6645,2019-02-22,889,0,889,71,960,960,0,0
6646,2019-02-22,908,0,908,72,980,980,0,0
6647,2019-02-22,288,0,288,22,310,310,0,0
6648,2019-02-22,908,0,908,72,980,0,980,0
6649,2019-02-22,315,0,315,25,340,340,0,0
6650,2019-02-22,325,0,325,25,350,0,350,0
6651,2019-02-22,306,0,306,24,330,330,0,0
6652,2019-02-22,760,0,760,60,820,820,0,0
6653,2019-02-22,1148,0,1148,82,1230,1230,0,0
6654,2019-02-22,1815,0,1815,145,1960,1960,0,0
6655,2019-02-22,501,0,501,39,540,540,0,0
6656,2019-02-22,1241,0,1241,99,1340,1340,0,0
6657,2019-02-22,445,0,445,35,480,480,0,0
6658,2019-02-22,852,0,852,68,920,920,0,0
6659,2019-02-22,1815,0,1815,145,1960,1960,0,0
6660,2019-02-22,445,0,445,35,480,480,0,0
6661,2019-02-22,1352,0,1352,108,1460,1460,0,0
6662,2019-02-22,788,0,788,62,850,850,0,0
6663,2019-02-22,1575,0,1575,125,1700,1700,0,0
6664,2019-02-22,584,0,584,46,630,630,0,0
6665,2019-02-22,491,0,491,39,530,530,0,0
6666,2019-02-22,1028,0,1028,82,1110,1110,0,0
6667,2019-02-22,473,0,473,37,510,510,0,0
6668,2019-02-22,769,0,769,61,830,830,0,0
6669,2019-02-22,1047,0,1047,83,1130,1130,0,0
6670,2019-02-22,260,0,260,20,280,280,0,0
6671,2019-02-22,1232,0,1232,98,1330,1330,0,0
6672,2019-02-22,408,0,408,32,440,440,0,0
6673,2019-02-22,1963,0,1963,157,2120,0,2120,0
6674,2019-02-22,788,0,788,62,850,850,0,0
6675,2019-02-22,250,0,250,20,270,270,0,0
6676,2019-02-22,1639,0,1639,131,1770,1770,0,0
6677,2019-02-22,1575,0,1575,125,1700,1700,0,0
6678,2019-02-22,496,0,496,39,535,535,0,0
6679,2019-02-22,843,0,843,67,910,910,0,0
6680,2019-02-22,760,0,760,60,820,820,0,0
6681,2019-02-22,1065,0,1065,85,1150,1150,0,0
6682,2019-02-22,278,0,278,22,300,300,0,0
6683,2019-02-22,556,0,556,44,600,600,0,0
6684,2019-02-22,251,0,251,19,270,270,0,0
6685,2019-02-22,2991,0,2991,239,3230,3230,0,0
6686,2019-02-22,702,0,702,38,740,740,0,0
6687,2019-02-22,436,0,436,34,470,470,0,0
6688,2019-02-22,538,0,538,42,580,580,0,0
6689,2019-02-22,1167,0,1167,93,1260,1260,0,0
6690,2019-02-22,1019,0,1019,81,1100,1100,0,0
6691,2019-02-22,834,0,834,66,900,900,0,0
6692,2019-02-22,834,0,834,66,900,900,0,0
6693,2019-02-22,1408,0,1408,112,1520,1520,0,0
6694,2019-02-22,685,0,685,45,730,730,0,0
6695,2019-02-22,547,0,547,43,590,590,0,0
6696,2019-02-22,1639,0,1639,131,1770,1770,0,0
6697,2019-02-22,1195,0,1195,95,1290,1290,0,0
6698,2019-02-22,362,0,362,28,390,390,0,0
6699,2019-02-22,686,0,686,54,740,740,0,0
6700,2019-02-22,1010,0,1010,80,1090,1090,0,0
6701,2019-02-22,1815,0,1815,145,1960,1960,0,0
6702,2019-02-22,139,0,139,11,150,150,0,0
6703,2019-02-22,880,0,880,70,950,950,0,0
6704,2019-02-22,1815,0,1815,145,1960,1960,0,0
6705,2019-02-22,1815,0,1815,145,1960,1960,0,0
6706,2019-02-22,1815,0,1815,145,1960,1960,0,0
6707,2019-02-22,5445,0,5445,435,5880,5880,0,0
6708,2019-02-22,334,0,334,26,360,360,0,0
6709,2019-02-22,1713,0,1713,137,1850,1850,0,0
6710,2019-02-22,612,0,612,48,660,660,0,0
6711,2019-02-22,852,0,852,68,920,920,0,0
6712,2019-02-22,667,0,667,53,720,720,0,0
6713,2019-02-22,380,0,380,30,410,410,0,0
6714,2019-02-22,2056,0,2056,164,2220,2220,0,0
6715,2019-02-22,1121,0,1121,89,1210,1210,0,0
6716,2019-02-22,1204,0,1204,96,1300,1300,0,0
6717,2019-02-22,1176,0,1176,94,1270,1270,0,0
6718,2019-02-22,1417,0,1417,113,1530,1530,0,0
6719,2019-02-22,1121,0,1121,89,1210,1210,0,0
6720,2019-02-22,1815,0,1815,145,1960,1960,0,0
6721,2019-02-22,241,0,241,19,260,260,0,0
6722,2019-02-22,889,0,889,71,960,960,0,0
6723,2019-02-22,186,0,186,14,200,200,0,0
6724,2019-02-22,362,0,362,28,390,390,0,0
6725,2019-02-22,1575,0,1575,125,1700,1700,0,0
6726,2019-02-22,667,0,667,53,720,720,0,0
6727,2019-02-22,371,0,371,29,400,400,0,0
6728,2019-02-22,1852,0,1852,148,2000,2000,0,0
6729,2019-02-22,260,0,260,20,280,280,0,0
6730,2019-02-22,1602,0,1602,128,1730,1730,0,0
6731,2019-02-22,260,0,260,20,280,280,0,0
6732,2019-02-22,482,0,482,38,520,520,0,0
6733,2019-02-22,1815,0,1815,145,1960,0,1960,0
6734,2019-02-22,704,0,704,56,760,760,0,0
6735,2019-02-22,334,0,334,26,360,360,0,0
6736,2019-02-22,510,0,510,40,550,550,0,0
6737,2019-02-23,1139,0,1139,91,1230,1230,0,0
6738,2019-02-23,621,0,621,49,670,670,0,0
6739,2019-02-23,1232,0,1232,98,1330,1330,0,0
6740,2019-02-23,444,0,444,26,470,470,0,0
6741,2019-02-23,389,0,389,31,420,420,0,0
6742,2019-02-23,565,0,565,45,610,610,0,0
6743,2019-02-23,695,0,695,55,750,750,0,0
6744,2019-02-23,306,0,306,24,330,330,0,0
6745,2019-02-23,1352,0,1352,108,1460,1460,0,0
6746,2019-02-23,389,0,389,31,420,420,0,0
6747,2019-02-23,232,0,232,18,250,250,0,0
6748,2019-02-23,1352,0,1352,108,1460,1460,0,0
6749,2019-02-23,232,0,232,18,250,250,0,0
6750,2019-02-23,1139,0,1139,91,1230,1230,0,0
6751,2019-02-23,-389,0,-389,-31,-420,-420,0,0
6752,2019-02-23,1075,0,1075,85,1160,1160,0,0
6753,2019-02-23,1130,0,1130,90,1220,1220,0,0
6754,2019-02-23,1352,0,1352,108,1460,1460,0,0
6755,2019-02-23,584,0,584,46,630,630,0,0
6756,2019-02-23,260,0,260,20,280,280,0,0
6757,2019-02-23,556,0,556,44,600,600,0,0
6758,2019-02-23,1852,0,1852,148,2000,2000,0,0
6759,2019-02-23,288,0,288,22,310,310,0,0
6760,2019-02-23,371,0,371,29,400,400,0,0
6761,2019-02-23,834,0,834,66,900,900,0,0
6762,2019-02-23,399,0,399,31,430,430,0,0
6763,2019-02-23,862,0,862,68,930,930,0,0
6764,2019-02-23,1129,0,1129,81,1210,1210,0,0
6765,2019-02-23,889,0,889,71,960,960,0,0
6766,2019-02-23,334,0,334,26,360,360,0,0
6767,2019-02-23,908,0,908,72,980,0,980,0
6768,2019-02-23,1815,0,1815,145,1960,1960,0,0
6769,2019-02-23,908,0,908,72,980,980,0,0
6770,2019-02-23,2723,0,2723,217,2940,2940,0,0
6771,2019-02-23,1815,0,1815,145,1960,1960,0,0
6772,2019-02-23,399,0,399,31,430,430,0,0
6773,2019-02-23,592,0,592,38,630,630,0,0
6774,2019-02-23,2723,0,2723,217,2940,2940,0,0
6775,2019-02-23,732,0,732,58,790,790,0,0
6776,2019-02-23,908,0,908,72,980,980,0,0
6777,2019-02-23,1815,0,1815,145,1960,1960,0,0
6778,2019-02-23,416,0,416,24,440,440,0,0
6779,2019-02-23,440,0,440,35,475,475,0,0
6780,2019-02-23,371,0,371,29,400,400,0,0
6781,2019-02-23,556,0,556,44,600,600,0,0
6782,2019-02-23,102,0,102,8,110,110,0,0
6783,2019-02-23,769,0,769,61,830,830,0,0
6784,2019-02-23,399,0,399,31,430,430,0,0
6785,2019-02-23,260,0,260,20,280,280,0,0
6786,2019-02-23,658,0,658,52,710,710,0,0
6787,2019-02-23,436,0,436,34,470,470,0,0
6788,2019-02-23,769,0,769,61,830,830,0,0
6789,2019-02-23,334,0,334,26,360,360,0,0
6790,2019-02-23,528,0,528,42,570,570,0,0
6791,2019-02-23,399,0,399,31,430,430,0,0
6792,2019-02-23,371,0,371,29,400,400,0,0
6793,2019-02-23,260,0,260,20,280,280,0,0
6794,2019-02-23,167,0,167,13,180,180,0,0
6795,2019-02-23,491,0,491,39,530,530,0,0
6796,2019-02-23,1815,0,1815,145,1960,1960,0,0
6797,2019-02-23,561,0,561,44,605,605,0,0
6798,2019-02-23,297,0,297,23,320,320,0,0
6799,2019-02-23,1223,0,1223,97,1320,1320,0,0
6800,2019-02-23,741,0,741,59,800,800,0,0
6801,2019-02-23,713,0,713,57,770,770,0,0
6802,2019-02-23,676,0,676,54,730,730,0,0
6803,2019-02-23,908,0,908,72,980,980,0,0
6804,2019-02-23,908,0,908,72,980,980,0,0
6805,2019-02-23,732,0,732,58,790,790,0,0
6806,2019-02-23,1815,0,1815,145,1960,1960,0,0
6807,2019-02-23,371,0,371,29,400,400,0,0
6808,2019-02-23,880,0,880,70,950,950,0,0
6809,2019-02-23,1121,0,1121,89,1210,1210,0,0
6810,2019-02-23,249,0,249,11,260,260,0,0
6811,2019-02-23,959,0,959,41,1000,1000,0,0
6812,2019-02-23,778,0,778,62,840,840,0,0
6813,2019-02-23,334,0,334,26,360,360,0,0
6814,2019-02-23,778,0,778,62,840,840,0,0
6815,2019-02-23,-778,0,-778,-62,-840,-840,0,0
6816,2019-02-23,676,0,676,54,730,730,0,0
6817,2019-02-23,389,0,389,31,420,420,0,0
6818,2019-02-23,1426,0,1426,114,1540,1540,0,0
6819,2019-02-23,1815,0,1815,145,1960,1960,0,0
6820,2019-02-23,297,0,297,23,320,320,0,0
6821,2019-02-23,278,0,278,22,300,300,0,0
6822,2019-02-23,982,0,982,78,1060,1060,0,0
6823,2019-02-23,630,0,630,50,680,680,0,0
6824,2019-02-23,56,0,56,4,60,60,0,0
6825,2019-02-23,1380,0,1380,110,1490,1490,0,0
6826,2019-02-23,1251,0,1251,99,1350,1350,0,0
6827,2019-02-23,612,0,612,48,660,660,0,0
6828,2019-02-23,741,0,741,59,800,800,0,0
6829,2019-02-23,788,0,788,62,850,850,0,0
6830,2019-02-23,788,0,788,62,850,850,0,0
6831,2019-02-23,788,0,788,62,850,850,0,0
6832,2019-02-23,788,0,788,62,850,850,0,0
6833,2019-02-23,788,0,788,62,850,850,0,0
6834,2019-02-23,1084,0,1084,86,1170,1170,0,0
6835,2019-02-23,788,0,788,62,850,850,0,0
6836,2019-02-23,1047,0,1047,83,1130,1130,0,0
6837,2019-02-23,3149,0,3149,251,3400,3400,0,0
6838,2019-02-23,1112,0,1112,88,1200,1200,0,0
6839,2019-02-23,788,0,788,62,850,850,0,0
6840,2019-02-23,297,0,297,23,320,320,0,0
6841,2019-02-23,278,0,278,22,300,300,0,0
6842,2019-02-23,1065,0,1065,85,1150,1150,0,0
6843,2019-02-23,1575,0,1575,125,1700,1700,0,0
6844,2019-02-23,751,0,751,59,810,810,0,0
6845,2019-02-23,232,0,232,18,250,250,0,0
6846,2019-02-23,2852,0,2852,228,3080,0,3080,0
6847,2019-02-23,1148,0,1148,82,1230,1230,0,0
6848,2019-02-23,3149,0,3149,251,3400,3400,0,0
6849,2019-02-23,149,0,149,11,160,160,0,0
6850,2019-02-23,658,0,658,52,710,710,0,0
6851,2019-02-23,936,0,936,74,1010,1010,0,0
6852,2019-02-23,565,0,565,45,610,610,0,0
6853,2019-02-23,269,0,269,21,290,290,0,0
6854,2019-02-23,843,0,843,67,910,910,0,0
6855,2019-02-23,1232,0,1232,98,1330,1330,0,0
6856,2019-02-23,1139,0,1139,91,1230,1230,0,0
6857,2019-02-23,1833,0,1833,137,1970,1970,0,0
6858,2019-02-23,223,0,223,17,240,240,0,0
6859,2019-02-23,325,0,325,25,350,350,0,0
6860,2019-02-23,697,-148,549,43,592,592,0,0
6861,2019-02-23,732,0,732,58,790,790,0,0
6862,2019-02-23,260,0,260,20,280,280,0,0
6863,2019-02-23,306,0,306,24,330,330,0,0
6864,2019-02-23,1195,0,1195,95,1290,1290,0,0
6865,2019-02-23,204,0,204,16,220,220,0,0
6866,2019-02-23,778,0,778,62,840,840,0,0
6867,2019-02-23,436,0,436,34,470,470,0,0
6868,2019-02-23,501,0,501,39,540,540,0,0
6869,2019-02-23,371,0,371,29,400,400,0,0
6870,2019-02-23,334,0,334,26,360,360,0,0
6871,2019-02-23,926,0,926,74,1000,1000,0,0
6872,2019-02-23,1751,0,1751,139,1890,0,1890,0
6873,2019-02-23,-926,0,-926,-74,-1000,-1000,0,0
6874,2019-02-23,334,0,334,26,360,360,0,0
6875,2019-02-23,1232,0,1232,98,1330,1330,0,0
6876,2019-02-23,963,0,963,77,1040,1040,0,0
6877,2019-02-23,1926,0,1926,154,2080,2080,0,0
6878,2019-02-23,575,0,575,45,620,620,0,0
6879,2019-02-23,723,0,723,57,780,780,0,0
6880,2019-02-23,649,0,649,51,700,700,0,0
6881,2019-02-23,1630,0,1630,130,1760,1760,0,0
6882,2019-02-23,880,0,880,70,950,950,0,0
6883,2019-02-23,741,0,741,59,800,800,0,0
6884,2019-02-23,908,0,908,72,980,980,0,0
6885,2019-02-23,908,0,908,72,980,980,0,0
6886,2019-02-23,1387,0,1387,93,1480,1480,0,0
6887,2019-02-23,1815,0,1815,145,1960,1960,0,0
6888,2019-02-23,1139,0,1139,91,1230,1230,0,0
6889,2019-02-23,2278,0,2278,182,2460,0,2460,0
6890,2019-02-23,1926,0,1926,154,2080,2080,0,0
6891,2019-02-23,612,0,612,48,660,660,0,0
6892,2019-02-23,926,0,926,74,1000,1000,0,0
6893,2019-02-23,1278,0,1278,102,1380,1380,0,0
6894,2019-02-23,454,0,454,36,490,490,0,0
6895,2019-02-23,1167,0,1167,93,1260,1260,0,0
6896,2019-02-23,825,0,825,65,890,890,0,0
6897,2019-02-23,5786,0,5786,454,6240,6240,0,0
6898,2019-02-23,741,0,741,59,800,800,0,0
6899,2019-02-23,1575,0,1575,125,1700,1700,0,0
6900,2019-02-23,1575,0,1575,125,1700,1700,0,0
6901,2019-02-23,806,0,806,64,870,870,0,0
6902,2019-02-23,1065,0,1065,85,1150,0,1150,0
6903,2019-02-23,389,0,389,31,420,420,0,0
6904,2019-02-23,1667,0,1667,133,1800,1800,0,0
6905,2019-02-23,167,0,167,13,180,180,0,0
6906,2019-02-23,649,0,649,51,700,700,0,0
6907,2019-02-23,232,0,232,18,250,250,0,0
6908,2019-02-23,1852,0,1852,148,2000,2000,0,0
6909,2019-02-23,1010,0,1010,80,1090,1090,0,0
6910,2019-02-23,834,0,834,66,900,900,0,0
6911,2019-02-23,889,0,889,71,960,960,0,0
6912,2019-02-23,288,0,288,22,310,310,0,0
6913,2019-02-23,862,0,862,68,930,930,0,0
6914,2019-02-23,1593,0,1593,127,1720,1720,0,0
6915,2019-02-23,1575,0,1575,125,1700,1700,0,0
6916,2019-02-23,1575,0,1575,125,1700,1700,0,0
6917,2019-02-23,741,0,741,59,800,800,0,0
6918,2019-02-24,473,0,473,37,510,510,0,0
6919,2019-02-24,667,0,667,53,720,720,0,0
6920,2019-02-24,908,0,908,72,980,980,0,0
6921,2019-02-24,1204,0,1204,96,1300,1300,0,0
6922,2019-02-24,2232,0,2232,178,2410,2410,0,0
6923,2019-02-24,1010,0,1010,80,1090,1090,0,0
6924,2019-02-24,926,0,926,74,1000,1000,0,0
6925,2019-02-24,908,0,908,72,980,0,980,0
6926,2019-02-24,417,0,417,33,450,450,0,0
6927,2019-02-24,769,0,769,61,830,830,0,0
6928,2019-02-24,1815,0,1815,145,1960,1960,0,0
6929,2019-02-24,908,0,908,72,980,980,0,0
6930,2019-02-24,584,0,584,46,630,630,0,0
6931,2019-02-24,1555,0,1555,115,1670,1670,0,0
6932,2019-02-24,908,0,908,72,980,980,0,0
6933,2019-02-24,982,0,982,78,1060,1060,0,0
6934,2019-02-24,445,0,445,35,480,480,0,0
6935,2019-02-24,630,0,630,50,680,680,0,0
6936,2019-02-24,1815,0,1815,145,1960,1960,0,0
6937,2019-02-24,538,0,538,42,580,580,0,0
6938,2019-02-24,1084,0,1084,86,1170,1170,0,0
6939,2019-02-24,556,0,556,44,600,600,0,0
6940,2019-02-24,260,0,260,20,280,280,0,0
6941,2019-02-24,1084,0,1084,86,1170,1170,0,0
6942,2019-02-24,417,0,417,33,450,450,0,0
6943,2019-02-24,908,0,908,72,980,980,0,0
6944,2019-02-24,908,0,908,72,980,980,0,0
6945,2019-02-24,269,0,269,21,290,290,0,0
6946,2019-02-24,139,0,139,11,150,150,0,0
6947,2019-02-24,889,0,889,71,960,960,0,0
6948,2019-02-24,575,0,575,45,620,620,0,0
6949,2019-02-24,463,0,463,37,500,500,0,0
6950,2019-02-24,806,0,806,64,870,870,0,0
6951,2019-02-24,417,0,417,33,450,450,0,0
6952,2019-02-24,908,0,908,72,980,980,0,0
6953,2019-02-24,908,0,908,72,980,980,0,0
6954,2019-02-24,741,0,741,59,800,800,0,0
6955,2019-02-24,741,0,741,59,800,800,0,0
6956,2019-02-24,297,0,297,23,320,320,0,0
6957,2019-02-24,491,0,491,39,530,530,0,0
6958,2019-02-24,565,0,565,45,610,610,0,0
6959,2019-02-24,436,0,436,34,470,470,0,0
6960,2019-02-24,445,0,445,35,480,480,0,0
6961,2019-02-24,1001,0,1001,79,1080,1080,0,0
6962,2019-02-24,334,0,334,26,360,360,0,0
6963,2019-02-24,676,0,676,54,730,730,0,0
6964,2019-02-24,751,0,751,59,810,810,0,0
6965,2019-02-24,954,0,954,76,1030,1030,0,0
6966,2019-02-24,602,0,602,48,650,0,650,0
6967,2019-02-24,908,0,908,72,980,980,0,0
6968,2019-02-24,315,0,315,25,340,340,0,0
6969,2019-02-24,751,0,751,59,810,810,0,0
6970,2019-02-24,908,0,908,72,980,980,0,0
6971,2019-02-24,1325,0,1325,105,1430,1430,0,0
6972,2019-02-24,288,0,288,22,310,310,0,0
6973,2019-02-24,666,0,666,44,710,710,0,0
6974,2019-02-24,908,0,908,72,980,980,0,0
6975,2019-02-24,538,0,538,42,580,580,0,0
6976,2019-02-24,1815,0,1815,145,1960,1960,0,0
6977,2019-02-24,649,0,649,51,700,700,0,0
6978,2019-02-24,241,0,241,19,260,260,0,0
6979,2019-02-24,575,0,575,45,620,620,0,0
6980,2019-02-24,1973,0,1973,157,2130,2130,0,0
6981,2019-02-24,612,0,612,48,660,0,660,0
6982,2019-02-24,1815,0,1815,145,1960,1960,0,0
6983,2019-02-24,269,0,269,21,290,290,0,0
6984,2019-02-24,565,0,565,45,610,610,0,0
6985,2019-02-24,908,0,908,72,980,980,0,0
6986,2019-02-24,908,0,908,72,980,980,0,0
6987,2019-02-24,325,0,325,25,350,350,0,0
6988,2019-02-24,1371,0,1371,109,1480,1480,0,0
6989,2019-02-24,1815,0,1815,145,1960,1960,0,0
6990,2019-02-24,1815,0,1815,145,1960,1960,0,0
6991,2019-02-24,491,0,491,39,530,530,0,0
6992,2019-02-24,352,0,352,28,380,380,0,0
6993,2019-02-24,908,0,908,72,980,980,0,0
6994,2019-02-24,1056,0,1056,84,1140,0,1140,0
6995,2019-02-24,528,0,528,42,570,570,0,0
6996,2019-02-24,426,0,426,34,460,460,0,0
6997,2019-02-24,334,0,334,26,360,360,0,0
6998,2019-02-24,269,0,269,21,290,290,0,0
6999,2019-02-24,325,0,325,25,350,350,0,0
7000,2019-02-24,866,-184,682,54,736,736,0,0
7001,2019-02-24,167,0,167,13,180,180,0,0
7002,2019-02-24,1121,0,1121,89,1210,1210,0,0
7003,2019-02-24,1269,0,1269,101,1370,1370,0,0
7004,2019-02-24,1575,0,1575,125,1700,1700,0,0
7005,2019-02-24,2362,0,2362,188,2550,2550,0,0
7006,2019-02-24,1575,0,1575,125,1700,1700,0,0
7007,2019-02-24,1204,0,1204,96,1300,1300,0,0
7008,2019-02-24,278,0,278,22,300,300,0,0
7009,2019-02-24,417,0,417,33,450,450,0,0
7010,2019-02-24,130,0,130,10,140,140,0,0
7011,2019-02-24,556,0,556,44,600,600,0,0
7012,2019-02-24,788,0,788,62,850,850,0,0
7013,2019-02-24,426,0,426,34,460,460,0,0
7014,2019-02-24,547,0,547,43,590,590,0,0
7015,2019-02-24,325,0,325,25,350,350,0,0
7016,2019-02-24,426,0,426,34,460,460,0,0
7017,2019-02-24,1352,0,1352,108,1460,1460,0,0
7018,2019-02-24,-325,0,-325,-25,-350,-350,0,0
7019,2019-02-24,575,0,575,45,620,620,0,0
7020,2019-02-24,649,0,649,51,700,700,0,0
7021,2019-02-24,676,0,676,54,730,730,0,0
7022,2019-02-24,297,0,297,23,320,320,0,0
7023,2019-02-24,399,0,399,31,430,430,0,0
7024,2019-02-24,176,0,176,14,190,190,0,0
7025,2019-02-24,769,0,769,61,830,830,0,0
7026,2019-02-24,399,0,399,31,430,430,0,0
7027,2019-02-24,399,0,399,31,430,430,0,0
7028,2019-02-24,825,0,825,65,890,890,0,0
7029,2019-02-24,862,0,862,68,930,930,0,0
7030,2019-02-24,241,0,241,19,260,260,0,0
7031,2019-02-24,399,0,399,31,430,430,0,0
7032,2019-02-24,436,0,436,34,470,470,0,0
7033,2019-02-24,1222,0,1222,88,1310,1310,0,0
7034,2019-02-24,973,0,973,77,1050,1050,0,0
7035,2019-02-24,277,0,277,13,290,290,0,0
7036,2019-02-24,491,0,491,39,530,530,0,0
7037,2019-02-24,1073,0,1073,77,1150,1150,0,0
7038,2019-02-24,741,0,741,59,800,800,0,0
7039,2019-02-24,139,0,139,11,150,150,0,0
7040,2019-02-24,584,0,584,46,630,630,0,0
7041,2019-02-24,1213,0,1213,97,1310,1310,0,0
7042,2019-02-24,1815,0,1815,145,1960,1960,0,0
7043,2019-02-24,528,0,528,42,570,570,0,0
7044,2019-02-24,778,0,778,62,840,840,0,0
7045,2019-02-24,4371,0,4371,349,4720,4720,0,0
7046,2019-02-24,343,0,343,27,370,370,0,0
7047,2019-02-24,1820,-384,1436,100,1536,1536,0,0
7048,2019-02-24,306,0,306,24,330,330,0,0
7049,2019-02-24,751,0,751,59,810,810,0,0
7050,2019-02-24,843,0,843,67,910,910,0,0
7051,2019-02-24,584,0,584,46,630,630,0,0
7052,2019-02-24,1362,0,1362,108,1470,1470,0,0
7053,2019-02-24,482,0,482,38,520,520,0,0
7054,2019-02-24,445,0,445,35,480,480,0,0
7055,2019-02-24,1297,0,1297,103,1400,1400,0,0
7056,2019-02-24,973,0,973,77,1050,1050,0,0
7057,2019-02-24,269,0,269,21,290,290,0,0
7058,2019-02-24,1399,0,1399,111,1510,1510,0,0
7059,2019-02-24,325,0,325,25,350,350,0,0
7060,2019-02-24,1519,0,1519,121,1640,1640,0,0
7061,2019-02-24,935,0,935,65,1000,1000,0,0
7062,2019-02-24,528,0,528,42,570,570,0,0
7063,2019-02-24,167,0,167,13,180,180,0,0
7064,2019-02-24,1259,0,1259,91,1350,1350,0,0
7065,2019-02-24,2232,0,2232,178,2410,2410,0,0
7066,2019-02-24,445,0,445,35,480,480,0,0
7067,2019-02-24,269,0,269,21,290,290,0,0
7068,2019-02-24,167,0,167,13,180,180,0,0
7069,2019-02-24,130,0,130,10,140,140,0,0
7070,2019-02-25,454,0,454,36,490,490,0,0
7071,2019-02-25,1945,0,1945,155,2100,2100,0,0
7072,2019-02-25,602,0,602,48,650,650,0,0
7073,2019-02-25,806,0,806,64,870,870,0,0
7074,2019-02-25,223,0,223,17,240,240,0,0
7075,2019-02-25,649,0,649,51,700,700,0,0
7076,2019-02-25,1278,0,1278,102,1380,1380,0,0
7077,2019-02-25,462,0,462,28,490,490,0,0
7078,2019-02-25,1815,0,1815,145,1960,1960,0,0
7079,2019-02-25,306,0,306,24,330,330,0,0
7080,2019-02-25,389,0,389,31,420,420,0,0
7081,2019-02-25,167,0,167,13,180,180,0,0
7082,2019-02-25,575,0,575,45,620,620,0,0
7083,2019-02-25,778,0,778,62,840,840,0,0
7084,2019-02-25,473,0,473,37,510,510,0,0
7085,2019-02-25,621,0,621,49,670,670,0,0
7086,2019-02-25,1108,0,1108,62,1170,1170,0,0
7087,2019-02-25,1815,0,1815,145,1960,1960,0,0
7088,2019-02-25,1815,0,1815,145,1960,1960,0,0
7089,2019-02-25,306,0,306,24,330,330,0,0
7090,2019-02-25,797,0,797,63,860,860,0,0
7091,2019-02-25,612,0,612,48,660,660,0,0
7092,2019-02-25,880,0,880,70,950,950,0,0
7093,2019-02-25,1323,0,1323,97,1420,1420,0,0
7094,2019-02-25,536,0,536,34,570,570,0,0
7095,2019-02-25,1038,0,1038,82,1120,1120,0,0
7096,2019-02-25,815,0,815,65,880,880,0,0
7097,2019-02-25,463,0,463,37,500,500,0,0
7098,2019-02-25,232,0,232,18,250,250,0,0
7099,2019-02-25,602,0,602,48,650,650,0,0
7100,2019-02-25,593,0,593,47,640,640,0,0
7101,2019-02-25,621,0,621,49,670,670,0,0
7102,2019-02-25,788,0,788,62,850,850,0,0
7103,2019-02-25,667,0,667,53,720,720,0,0
7104,2019-02-25,343,0,343,27,370,370,0,0
7105,2019-02-25,1112,0,1112,88,1200,1200,0,0
7106,2019-02-25,186,0,186,14,200,200,0,0
7107,2019-02-25,139,0,139,11,150,150,0,0
7108,2019-02-25,1815,0,1815,145,1960,1960,0,0
7109,2019-02-25,1158,0,1158,92,1250,1250,0,0
7110,2019-02-25,3352,0,3352,268,3620,3620,0,0
7111,2019-02-25,501,0,501,39,540,540,0,0
7112,2019-02-25,538,0,538,42,580,0,580,0
7113,2019-02-25,547,0,547,43,590,590,0,0
7114,2019-02-25,630,0,630,50,680,680,0,0
7115,2019-02-25,584,0,584,46,630,630,0,0
7116,2019-02-25,389,0,389,31,420,420,0,0
7117,2019-02-25,389,0,389,31,420,420,0,0
7118,2019-02-25,732,0,732,58,790,790,0,0
7119,2019-02-25,519,0,519,41,560,560,0,0
7120,2019-02-25,676,0,676,54,730,730,0,0
7121,2019-02-25,408,0,408,32,440,440,0,0
7122,2019-02-25,676,0,676,54,730,730,0,0
7123,2019-02-25,306,0,306,24,330,330,0,0
7124,2019-02-25,1007,-214,793,63,856,856,0,0
7125,2019-02-25,362,0,362,28,390,390,0,0
7126,2019-02-25,908,0,908,72,980,980,0,0
7127,2019-02-25,704,0,704,56,760,760,0,0
7128,2019-02-25,695,0,695,55,750,750,0,0
7129,2019-02-25,297,0,297,23,320,320,0,0
7130,2019-02-25,306,0,306,24,330,330,0,0
7131,2019-02-25,538,0,538,42,580,580,0,0
7132,2019-02-25,1288,0,1288,102,1390,1390,0,0
7133,2019-02-25,371,0,371,29,400,400,0,0
7134,2019-02-25,305,0,305,15,320,320,0,0
7135,2019-02-25,510,0,510,40,550,550,0,0
7136,2019-02-25,380,0,380,30,410,410,0,0
7137,2019-02-25,565,0,565,45,610,610,0,0
7138,2019-02-25,334,0,334,26,360,360,0,0
7139,2019-02-25,686,0,686,54,740,740,0,0
7140,2019-02-25,1083,0,1083,77,1160,1160,0,0
7141,2019-02-25,1130,0,1130,90,1220,1220,0,0
7142,2019-02-25,283,0,283,22,305,305,0,0
7143,2019-02-25,232,0,232,18,250,250,0,0
7144,2019-02-25,201,0,201,15,216,216,0,0
7145,2019-02-25,1223,0,1223,97,1320,1320,0,0
7146,2019-02-25,788,0,788,62,850,850,0,0
7147,2019-02-25,788,0,788,62,850,850,0,0
7148,2019-02-25,232,0,232,18,250,250,0,0
7149,2019-02-25,1852,0,1852,148,2000,2000,0,0
7150,2019-02-25,630,0,630,50,680,680,0,0
7151,2019-02-25,482,0,482,38,520,520,0,0
7152,2019-02-25,814,0,814,56,870,870,0,0
7153,2019-02-25,649,0,649,51,700,700,0,0
7154,2019-02-25,1130,0,1130,90,1220,1220,0,0
7155,2019-02-25,1695,0,1695,135,1830,1830,0,0
7156,2019-02-25,2130,0,2130,170,2300,2300,0,0
7157,2019-02-25,323,0,323,17,340,340,0,0
7158,2019-02-25,602,0,602,48,650,650,0,0
7159,2019-02-25,1084,0,1084,86,1170,1170,0,0
7160,2019-02-25,213,0,213,17,230,230,0,0
7161,2019-02-25,732,0,732,58,790,790,0,0
7162,2019-02-25,260,0,260,20,280,280,0,0
7163,2019-02-25,343,0,343,27,370,370,0,0
7164,2019-02-25,621,0,621,49,670,670,0,0
7165,2019-02-25,1371,0,1371,109,1480,0,1480,0
7166,2019-02-25,260,0,260,20,280,280,0,0
7167,2019-02-25,389,0,389,31,420,420,0,0
7168,2019-02-25,121,0,121,9,130,130,0,0
7169,2019-02-25,1343,0,1343,107,1450,0,1450,0
7170,2019-02-25,482,0,482,38,520,520,0,0
7171,2019-02-25,713,0,713,57,770,770,0,0
7172,2019-02-25,1209,0,1209,96,1305,1305,0,0
7173,2019-02-25,751,0,751,59,810,810,0,0
7174,2019-02-25,602,0,602,48,650,0,650,0
7175,2019-02-25,945,0,945,75,1020,1020,0,0
7176,2019-02-25,371,0,371,29,400,400,0,0
7177,2019-02-25,788,0,788,62,850,850,0,0
7178,2019-02-25,621,0,621,49,670,670,0,0
7179,2019-02-25,1575,0,1575,125,1700,1700,0,0
7180,2019-02-25,352,0,352,28,380,380,0,0
7181,2019-02-25,306,0,306,24,330,330,0,0
7182,2019-02-25,899,0,899,71,970,970,0,0
7183,2019-02-25,1056,0,1056,84,1140,1140,0,0
7184,2019-02-25,297,0,297,23,320,320,0,0
7185,2019-02-25,788,0,788,62,850,850,0,0
7186,2019-02-25,1547,0,1547,123,1670,1670,0,0
7187,2019-02-25,269,0,269,21,290,290,0,0
7188,2019-02-25,603,-128,475,37,512,512,0,0
7189,2019-02-25,130,0,130,10,140,140,0,0
7190,2019-02-25,649,0,649,51,700,700,0,0
7191,2019-02-25,1704,0,1704,136,1840,1840,0,0
7192,2019-02-25,1241,0,1241,99,1340,1340,0,0
7193,2019-02-25,667,0,667,53,720,720,0,0
7194,2019-02-25,1991,0,1991,159,2150,2150,0,0
7195,2019-02-25,362,0,362,28,390,390,0,0
7196,2019-02-25,788,0,788,62,850,850,0,0
7197,2019-02-25,788,0,788,62,850,850,0,0
7198,2019-02-25,1575,0,1575,125,1700,1700,0,0
7199,2019-02-25,741,0,741,59,800,800,0,0
7200,2019-02-25,1575,0,1575,125,1700,1700,0,0
7201,2019-02-25,593,0,593,47,640,640,0,0
7202,2019-02-25,1575,0,1575,125,1700,1700,0,0
7203,2019-02-25,139,0,139,11,150,150,0,0
7204,2019-02-25,788,0,788,62,850,850,0,0
7205,2019-02-25,760,0,760,60,820,820,0,0
7206,2019-02-25,491,0,491,39,530,530,0,0
7207,2019-02-25,269,0,269,21,290,290,0,0
7208,2019-02-25,167,0,167,13,180,180,0,0
7209,2019-02-25,102,0,102,8,110,110,0,0
7210,2019-02-25,788,0,788,62,850,850,0,0
7211,2019-02-25,1065,0,1065,85,1150,1150,0,0
7212,2019-02-26,676,0,676,54,730,730,0,0
7213,2019-02-26,306,0,306,24,330,330,0,0
7214,2019-02-26,323,0,323,17,340,340,0,0
7215,2019-02-26,454,0,454,36,490,490,0,0
7216,2019-02-26,306,0,306,24,330,330,0,0
7217,2019-02-26,371,0,371,29,400,400,0,0
7218,2019-02-26,371,0,371,29,400,400,0,0
7219,2019-02-26,362,0,362,28,390,390,0,0
7220,2019-02-26,713,0,713,57,770,770,0,0
7221,2019-02-26,463,0,463,37,500,500,0,0
7222,2019-02-26,1038,0,1038,82,1120,1120,0,0
7223,2019-02-26,288,0,288,22,310,310,0,0
7224,2019-02-26,899,0,899,71,970,970,0,0
7225,2019-02-26,621,0,621,49,670,670,0,0
7226,2019-02-26,380,0,380,30,410,410,0,0
7227,2019-02-26,741,0,741,59,800,800,0,0
7228,2019-02-27,630,0,630,50,680,680,0,0
7229,2019-02-27,1815,0,1815,145,1960,1960,0,0
7230,2019-02-27,667,0,667,53,720,720,0,0
7231,2019-02-27,908,0,908,72,980,980,0,0
7232,2019-02-27,102,0,102,8,110,110,0,0
7233,2019-02-27,454,0,454,36,490,490,0,0
7234,2019-02-27,1167,0,1167,93,1260,1260,0,0
7235,2019-02-27,491,0,491,39,530,530,0,0
7236,2019-02-27,1251,0,1251,99,1350,1350,0,0
7237,2019-02-27,760,0,760,60,820,820,0,0
7238,2019-02-27,686,0,686,54,740,740,0,0
7239,2019-02-27,593,0,593,47,640,640,0,0
7240,2019-02-27,1130,0,1130,90,1220,1220,0,0
7241,2019-02-27,908,0,908,72,980,980,0,0
7242,2019-02-27,371,0,371,29,400,400,0,0
7243,2019-02-27,991,0,991,79,1070,1070,0,0
7244,2019-02-27,269,0,269,21,290,290,0,0
7245,2019-02-27,417,0,417,33,450,450,0,0
7246,2019-02-27,862,0,862,68,930,930,0,0
7247,2019-02-27,1828,0,1828,146,1974,1974,0,0
7248,2019-02-27,325,0,325,25,350,350,0,0
7249,2019-02-27,519,0,519,41,560,560,0,0
7250,2019-02-27,501,0,501,39,540,540,0,0
7251,2019-02-27,519,0,519,41,560,0,560,0
7252,2019-02-27,935,0,935,65,1000,1000,0,0
7253,2019-02-27,249,0,249,11,260,260,0,0
7254,2019-02-27,575,0,575,45,620,620,0,0
7255,2019-02-27,260,0,260,20,280,280,0,0
7256,2019-02-27,907,0,907,63,970,970,0,0
7257,2019-02-27,260,0,260,20,280,280,0,0
7258,2019-02-27,501,0,501,39,540,540,0,0
7259,2019-02-27,538,0,538,42,580,580,0,0
7260,2019-02-27,649,0,649,51,700,700,0,0
7261,2019-02-27,862,0,862,68,930,930,0,0
7262,2019-02-27,167,0,167,13,180,180,0,0
7263,2019-02-27,1065,0,1065,85,1150,1150,0,0
7264,2019-02-27,630,0,630,50,680,680,0,0
7265,2019-02-27,269,0,269,21,290,290,0,0
7266,2019-02-27,639,0,639,51,690,690,0,0
7267,2019-02-27,899,0,899,71,970,970,0,0
7268,2019-02-27,362,0,362,28,390,390,0,0
7269,2019-02-27,351,0,351,19,370,370,0,0
7270,2019-02-27,667,0,667,53,720,720,0,0
7271,2019-02-27,292,-62,230,18,248,248,0,0
7272,2019-02-27,1102,0,1102,88,1190,1190,0,0
7273,2019-02-27,519,0,519,41,560,560,0,0
7274,2019-02-27,982,0,982,78,1060,1060,0,0
7275,2019-02-27,788,0,788,62,850,850,0,0
7276,2019-02-27,788,0,788,62,850,850,0,0
7277,2019-02-27,760,0,760,60,820,820,0,0
7278,2019-02-27,362,0,362,28,390,390,0,0
7279,2019-02-27,1575,0,1575,125,1700,0,1700,0
7280,2019-02-27,982,0,982,78,1060,1060,0,0
7281,2019-02-27,556,0,556,44,600,600,0,0
7282,2019-02-27,47,0,47,3,50,50,0,0
7283,2019-02-27,1676,0,1676,134,1810,0,1810,0
7284,2019-02-27,593,0,593,47,640,640,0,0
7285,2019-02-27,399,0,399,31,430,430,0,0
7286,2019-02-27,880,0,880,70,950,950,0,0
7287,2019-02-27,843,0,843,67,910,910,0,0
7288,2019-02-27,1065,0,1065,85,1150,1150,0,0
7289,2019-02-27,630,0,630,50,680,680,0,0
7290,2019-02-27,1232,0,1232,98,1330,1330,0,0
7291,2019-02-27,834,0,834,66,900,900,0,0
7292,2019-02-27,908,0,908,72,980,980,0,0
7293,2019-02-27,908,0,908,72,980,980,0,0
7294,2019-02-27,1658,0,1658,132,1790,1790,0,0
7295,2019-02-27,1638,0,1638,122,1760,0,1760,0
7296,2019-02-27,852,0,852,68,920,920,0,0
7297,2019-02-27,1112,0,1112,88,1200,1200,0,0
7298,2019-02-27,1454,0,1454,116,1570,1570,0,0
7299,2019-02-28,343,0,343,27,370,370,0,0
7300,2019-02-28,149,0,149,11,160,160,0,0
7301,2019-02-28,362,0,362,28,390,390,0,0
7302,2019-02-28,1862,0,1862,148,2010,2010,0,0
7303,2019-02-28,445,0,445,35,480,480,0,0
7304,2019-02-28,528,0,528,42,570,570,0,0
7305,2019-02-28,908,0,908,72,980,980,0,0
7306,2019-02-28,463,0,463,37,500,500,0,0
7307,2019-02-28,899,0,899,71,970,970,0,0
7308,2019-02-28,436,0,436,34,470,470,0,0
7309,2019-02-28,1055,-113,942,75,1017,1017,0,0
7310,2019-02-28,556,0,556,44,600,600,0,0
7311,2019-02-28,1815,0,1815,145,1960,1960,0,0
7312,2019-02-28,899,0,899,71,970,970,0,0
7313,2019-02-28,334,0,334,26,360,360,0,0
7314,2019-02-28,462,0,462,28,490,490,0,0
7315,2019-02-28,491,0,491,39,530,530,0,0
7316,2019-02-28,473,0,473,37,510,0,510,0
7317,2019-02-28,908,0,908,72,980,980,0,0
7318,2019-02-28,380,0,380,30,410,410,0,0
7319,2019-02-28,371,0,371,29,400,400,0,0
7320,2019-02-28,528,0,528,42,570,570,0,0
7321,2019-02-28,389,0,389,31,420,420,0,0
7322,2019-02-28,408,0,408,32,440,440,0,0
7323,2019-02-28,741,0,741,59,800,800,0,0
7324,2019-02-28,1075,0,1075,85,1160,1160,0,0
7325,2019-02-28,612,0,612,48,660,660,0,0
7326,2019-02-28,778,0,778,62,840,840,0,0
7327,2019-02-28,686,0,686,54,740,740,0,0
7328,2019-02-28,269,0,269,21,290,290,0,0
7329,2019-02-28,417,0,417,33,450,450,0,0
7330,2019-02-28,269,0,269,21,290,290,0,0
7331,2019-02-28,232,0,232,18,250,250,0,0
7332,2019-02-28,362,0,362,28,390,390,0,0
7333,2019-02-28,1149,0,1149,91,1240,1240,0,0
7334,2019-02-28,510,0,510,40,550,550,0,0
7335,2019-02-28,1260,0,1260,100,1360,1360,0,0
7336,2019-02-28,463,0,463,37,500,500,0,0
7337,2019-02-28,962,0,962,68,1030,1030,0,0
7338,2019-02-28,149,0,149,11,160,160,0,0
7339,2019-02-28,176,0,176,14,190,190,0,0
7340,2019-02-28,806,0,806,64,870,870,0,0
7341,2019-02-28,1139,0,1139,91,1230,1230,0,0
7342,2019-02-28,565,0,565,45,610,610,0,0
7343,2019-02-28,269,0,269,21,290,290,0,0
7344,2019-02-28,371,0,371,29,400,400,0,0
7345,2019-02-28,991,0,991,79,1070,1070,0,0
7346,2019-02-28,1075,0,1075,85,1160,1160,0,0
7347,2019-02-28,260,0,260,20,280,280,0,0
7348,2019-02-28,619,0,619,31,650,650,0,0
7349,2019-02-28,436,0,436,34,470,470,0,0
7350,2019-02-28,334,0,334,26,360,360,0,0
7351,2019-02-28,1528,0,1528,122,1650,1650,0,0
7352,2019-02-28,278,0,278,22,300,300,0,0
7353,2019-02-28,269,0,269,21,290,290,0,0
7354,2019-02-28,676,0,676,54,730,730,0,0
7355,2019-02-28,463,0,463,37,500,500,0,0
7356,2019-02-28,463,0,463,37,500,500,0,0
7357,2019-02-28,482,0,482,38,520,520,0,0
7358,2019-02-28,269,0,269,21,290,290,0,0
7359,2019-02-28,852,0,852,68,920,920,0,0
7360,2019-02-28,1834,0,1834,146,1980,1980,0,0
7361,2019-02-28,167,0,167,13,180,180,0,0
7362,2019-02-28,741,0,741,59,800,800,0,0
7363,2019-02-28,195,0,195,15,210,210,0,0
7364,2019-02-28,1130,0,1130,90,1220,1220,0,0
7365,2019-02-28,288,0,288,22,310,310,0,0
7366,2019-02-28,1139,-122,1017,81,1098,1098,0,0
7367,2019-02-28,389,0,389,31,420,420,0,0
7368,2019-02-28,584,0,584,46,630,630,0,0
7369,2019-02-28,843,0,843,67,910,910,0,0
7370,2019-02-28,1491,0,1491,119,1610,1610,0,0
7371,2019-02-28,167,0,167,13,180,180,0,0
7372,2019-02-28,926,0,926,74,1000,1000,0,0
7373,2019-02-28,47,0,47,3,50,50,0,0
7374,2019-02-28,723,0,723,57,780,780,0,0
7375,2019-02-28,1528,0,1528,122,1650,1650,0,0
7376,2019-02-28,278,0,278,22,300,300,0,0
7377,2019-02-28,723,0,723,57,780,780,0,0
7378,2019-02-28,695,0,695,55,750,750,0,0
7379,2019-02-28,648,0,648,42,690,690,0,0
7380,2019-02-28,110,0,110,0,110,110,0,0
7381,2019-02-28,195,0,195,15,210,210,0,0
7382,2019-02-28,843,0,843,67,910,910,0,0
7383,2019-02-28,121,0,121,9,130,130,0,0
7384,2019-02-28,325,0,325,25,350,350,0,0
7385,2019-02-28,302,-64,238,18,256,256,0,0
7386,2019-02-28,760,0,760,60,820,820,0,0
7387,2019-02-28,768,0,768,52,820,820,0,0
7388,2019-02-28,306,0,306,24,330,330,0,0
7389,2019-02-28,722,0,722,48,770,770,0,0
7390,2019-02-28,880,0,880,70,950,950,0,0
7391,2019-02-28,448,0,448,35,483,483,0,0
7392,2019-02-28,778,0,778,62,840,840,0,0
7393,2019-02-28,1149,0,1149,91,1240,1240,0,0
7394,2019-02-28,1815,0,1815,145,1960,1960,0,0
7395,2019-02-28,778,0,778,62,840,840,0,0
7396,2019-02-28,362,0,362,28,390,390,0,0
7397,2019-02-28,510,0,510,40,550,550,0,0
7398,2019-02-28,371,0,371,29,400,400,0,0
7399,2019-02-28,389,0,389,31,420,420,0,0
7400,2019-02-28,936,0,936,74,1010,1010,0,0
7401,2019-02-28,658,0,658,52,710,710,0,0
7402,2019-02-28,1575,0,1575,125,1700,1700,0,0
7403,2019-02-28,501,0,501,39,540,540,0,0
7404,2019-02-28,1575,0,1575,125,1700,1700,0,0
7405,2019-02-28,1575,0,1575,125,1700,1700,0,0
7406,2019-02-28,204,0,204,16,220,220,0,0
7407,2019-02-28,1158,0,1158,92,1250,1250,0,0
7408,2019-02-28,1325,0,1325,105,1430,0,1430,0
7409,2019-02-28,649,0,649,51,700,700,0,0
7410,2019-02-28,463,0,463,37,500,0,500,0
7411,2019-02-28,630,0,630,50,680,680,0,0
7412,2019-02-28,741,0,741,59,800,800,0,0
7413,2019-03-01,501,0,501,39,540,540,0,0
7414,2019-03-01,575,0,575,45,620,620,0,0
7415,2019-03-01,3630,0,3630,290,3920,3920,0,0
7416,2019-03-01,815,0,815,65,880,0,880,0
7417,2019-03-01,1167,0,1167,93,1260,1260,0,0
7418,2019-03-01,908,0,908,72,980,980,0,0
7419,2019-03-01,482,0,482,38,520,520,0,0
7420,2019-03-01,593,0,593,47,640,640,0,0
7421,2019-03-01,110,0,110,0,110,0,110,0
7422,2019-03-01,491,0,491,39,530,530,0,0
7423,2019-03-01,723,0,723,57,780,780,0,0
7424,2019-03-01,815,0,815,65,880,880,0,0
7425,2019-03-01,167,0,167,13,180,180,0,0
7426,2019-03-01,1963,0,1963,157,2120,2120,0,0
7427,2019-03-01,399,0,399,31,430,430,0,0
7428,2019-03-01,1149,0,1149,91,1240,1240,0,0
7429,2019-03-01,1612,0,1612,128,1740,1740,0,0
7430,2019-03-01,908,0,908,72,980,0,980,0
7431,2019-03-01,815,0,815,65,880,880,0,0
7432,2019-03-01,658,0,658,52,710,710,0,0
7433,2019-03-01,843,0,843,67,910,910,0,0
7434,2019-03-01,121,0,121,9,130,130,0,0
7435,2019-03-01,528,0,528,42,570,570,0,0
7436,2019-03-01,843,0,843,67,910,910,0,0
7437,2019-03-01,1055,0,1055,75,1130,1130,0,0
7438,2019-03-01,991,0,991,79,1070,1070,0,0
7439,2019-03-01,269,0,269,21,290,290,0,0
7440,2019-03-01,167,0,167,13,180,180,0,0
7441,2019-03-01,583,0,583,37,620,620,0,0
7442,2019-03-01,649,0,649,51,700,700,0,0
7443,2019-03-01,260,0,260,20,280,280,0,0
7444,2019-03-01,1815,0,1815,145,1960,1960,0,0
7445,2019-03-01,630,0,630,50,680,680,0,0
7446,2019-03-01,852,0,852,68,920,920,0,0
7447,2019-03-01,936,0,936,74,1010,1010,0,0
7448,2019-03-01,1130,0,1130,90,1220,1220,0,0
7449,2019-03-01,2075,0,2075,165,2240,2240,0,0
7450,2019-03-01,1991,0,1991,159,2150,2150,0,0
7451,2019-03-01,584,0,584,46,630,630,0,0
7452,2019-03-01,1815,0,1815,145,1960,1960,0,0
7453,2019-03-01,417,0,417,33,450,450,0,0
7454,2019-03-01,741,0,741,59,800,800,0,0
7455,2019-03-01,556,0,556,44,600,600,0,0
7456,2019-03-01,519,0,519,41,560,560,0,0
7457,2019-03-01,538,0,538,42,580,580,0,0
7458,2019-03-01,315,0,315,25,340,340,0,0
7459,2019-03-01,334,0,334,26,360,360,0,0
7460,2019-03-01,1954,0,1954,156,2110,2110,0,0
7461,2019-03-01,1436,0,1436,114,1550,0,1550,0
7462,2019-03-01,2278,0,2278,182,2460,0,2460,0
7463,2019-03-01,454,0,454,36,490,0,490,0
7464,2019-03-01,806,0,806,64,870,870,0,0
7465,2019-03-01,1027,0,1027,73,1100,1100,0,0
7466,2019-03-01,630,0,630,50,680,680,0,0
7467,2019-03-01,473,0,473,37,510,510,0,0
7468,2019-03-01,797,0,797,63,860,860,0,0
7469,2019-03-01,908,0,908,72,980,980,0,0
7470,2019-03-01,556,0,556,44,600,600,0,0
7471,2019-03-01,593,0,593,47,640,640,0,0
7472,2019-03-01,556,0,556,44,600,600,0,0
7473,2019-03-01,232,0,232,18,250,250,0,0
7474,2019-03-01,2241,0,2241,179,2420,2420,0,0
7475,2019-03-01,871,0,871,69,940,940,0,0
7476,2019-03-01,565,0,565,45,610,0,610,0
7477,2019-03-01,204,0,204,16,220,220,0,0
7478,2019-03-01,769,0,769,61,830,830,0,0
7479,2019-03-01,2723,0,2723,217,2940,2940,0,0
7480,2019-03-01,121,0,121,9,130,130,0,0
7481,2019-03-01,473,0,473,37,510,510,0,0
7482,2019-03-01,1436,0,1436,114,1550,1550,0,0
7483,2019-03-01,852,0,852,68,920,920,0,0
7484,2019-03-01,917,0,917,73,990,990,0,0
7485,2019-03-01,3630,0,3630,290,3920,3920,0,0
7486,2019-03-01,463,0,463,37,500,500,0,0
7487,2019-03-01,112,0,112,8,120,120,0,0
7488,2019-03-01,334,0,334,26,360,360,0,0
7489,2019-03-01,371,0,371,29,400,400,0,0
7490,2019-03-01,306,0,306,24,330,330,0,0
7491,2019-03-01,630,0,630,50,680,680,0,0
7492,2019-03-01,575,0,575,45,620,620,0,0
7493,2019-03-01,575,0,575,45,620,620,0,0
7494,2019-03-01,788,0,788,62,850,850,0,0
7495,2019-03-01,1815,0,1815,145,1960,1960,0,0
7496,2019-03-01,1065,0,1065,85,1150,1150,0,0
7497,2019-03-01,1065,0,1065,85,1150,1150,0,0
7498,2019-03-01,1065,0,1065,85,1150,1150,0,0
7499,2019-03-01,1584,0,1584,126,1710,1710,0,0
7500,2019-03-01,1852,0,1852,148,2000,2000,0,0
7501,2019-03-01,519,0,519,41,560,560,0,0
7502,2019-03-01,741,0,741,59,800,800,0,0
7503,2019-03-01,260,0,260,20,280,280,0,0
7504,2019-03-01,982,0,982,78,1060,1060,0,0
7505,2019-03-01,269,0,269,21,290,290,0,0
7506,2019-03-01,879,0,879,61,940,940,0,0
7507,2019-03-01,694,0,694,46,740,740,0,0
7508,2019-03-01,639,0,639,51,690,690,0,0
7509,2019-03-01,630,0,630,50,680,680,0,0
7510,2019-03-01,334,0,334,26,360,360,0,0
7511,2019-03-01,436,0,436,34,470,470,0,0
7512,2019-03-01,825,0,825,65,890,890,0,0
7513,2019-03-01,713,0,713,57,770,770,0,0
7514,2019-03-01,167,0,167,13,180,180,0,0
7515,2019-03-01,723,0,723,57,780,780,0,0
7516,2019-03-01,208,0,208,16,224,224,0,0
7517,2019-03-01,362,0,362,28,390,390,0,0
7518,2019-03-01,112,0,112,8,120,120,0,0
7519,2019-03-01,2130,0,2130,170,2300,0,2300,0
7520,2019-03-01,788,0,788,62,850,850,0,0
7521,2019-03-01,288,0,288,22,310,310,0,0
7522,2019-03-01,2362,0,2362,188,2550,2550,0,0
7523,2019-03-01,1306,0,1306,104,1410,1410,0,0
7524,2019-03-01,352,0,352,28,380,380,0,0
7525,2019-03-01,519,0,519,41,560,560,0,0
7526,2019-03-01,658,0,658,52,710,710,0,0
7527,2019-03-01,362,0,362,28,390,390,0,0
7528,2019-03-01,1815,0,1815,145,1960,0,1960,0
7529,2019-03-01,232,0,232,18,250,250,0,0
7530,2019-03-01,926,0,926,74,1000,1000,0,0
7531,2019-03-01,1306,0,1306,104,1410,1410,0,0
7532,2019-03-01,732,0,732,58,790,790,0,0
7533,2019-03-01,695,0,695,55,750,750,0,0
7534,2019-03-01,565,0,565,45,610,610,0,0
7535,2019-03-01,1575,0,1575,125,1700,1700,0,0
7536,2019-03-01,1815,0,1815,145,1960,1960,0,0
7537,2019-03-01,2788,0,2788,222,3010,3010,0,0
7538,2019-03-01,491,0,491,39,530,530,0,0
7539,2019-03-01,649,0,649,51,700,700,0,0
7540,2019-03-01,269,0,269,21,290,290,0,0
7541,2019-03-01,1038,0,1038,82,1120,1120,0,0
7542,2019-03-01,3195,0,3195,255,3450,3450,0,0
7543,2019-03-01,1186,0,1186,94,1280,1280,0,0
7544,2019-03-01,278,0,278,22,300,300,0,0
7545,2019-03-01,2130,0,2130,170,2300,2300,0,0
7546,2019-03-01,1788,0,1788,142,1930,1930,0,0
7547,2019-03-01,723,0,723,57,780,780,0,0
7548,2019-03-01,223,0,223,17,240,240,0,0
7549,2019-03-01,315,0,315,25,340,340,0,0
7550,2019-03-01,417,0,417,33,450,450,0,0
7551,2019-03-01,1251,0,1251,99,1350,1350,0,0
7552,2019-03-01,1167,0,1167,93,1260,1260,0,0
7553,2019-03-01,359,0,359,11,370,370,0,0
7554,2019-03-01,352,0,352,28,380,380,0,0
7555,2019-03-01,880,0,880,70,950,950,0,0
7556,2019-03-01,547,0,547,43,590,590,0,0
7557,2019-03-02,630,0,630,50,680,680,0,0
7558,2019-03-02,788,0,788,62,850,850,0,0
7559,2019-03-02,908,0,908,72,980,980,0,0
7560,2019-03-02,565,0,565,45,610,610,0,0
7561,2019-03-02,584,0,584,46,630,630,0,0
7562,2019-03-02,2723,0,2723,217,2940,2940,0,0
7563,2019-03-02,538,0,538,42,580,580,0,0
7564,2019-03-02,1815,0,1815,145,1960,1960,0,0
7565,2019-03-02,1194,0,1194,86,1280,1280,0,0
7566,2019-03-02,1547,0,1547,123,1670,1670,0,0
7567,2019-03-02,2129,0,2129,161,2290,2290,0,0
7568,2019-03-02,667,0,667,53,720,720,0,0
7569,2019-03-02,713,0,713,57,770,770,0,0
7570,2019-03-02,612,0,612,48,660,660,0,0
7571,2019-03-02,501,0,501,39,540,540,0,0
7572,2019-03-02,380,0,380,30,410,410,0,0
7573,2019-03-02,899,0,899,71,970,970,0,0
7574,2019-03-02,852,0,852,68,920,920,0,0
7575,2019-03-02,482,0,482,38,520,520,0,0
7576,2019-03-02,806,0,806,64,870,870,0,0
7577,2019-03-02,834,0,834,66,900,900,0,0
7578,2019-03-02,1815,0,1815,145,1960,1960,0,0
7579,2019-03-02,463,0,463,37,500,500,0,0
7580,2019-03-02,547,0,547,43,590,590,0,0
7581,2019-03-02,399,0,399,31,430,430,0,0
7582,2019-03-02,371,0,371,29,400,400,0,0
7583,2019-03-02,510,0,510,40,550,550,0,0
7584,2019-03-02,886,0,886,44,930,930,0,0
7585,2019-03-02,1676,0,1676,134,1810,0,1810,0
7586,2019-03-02,149,0,149,11,160,160,0,0
7587,2019-03-02,186,0,186,14,200,200,0,0
7588,2019-03-02,426,0,426,34,460,460,0,0
7589,2019-03-02,1130,0,1130,90,1220,0,1220,0
7590,2019-03-02,908,0,908,72,980,980,0,0
7591,2019-03-02,1778,0,1778,142,1920,1920,0,0
7592,2019-03-02,1815,0,1815,145,1960,1960,0,0
7593,2019-03-02,278,0,278,22,300,300,0,0
7594,2019-03-02,1510,0,1510,120,1630,1630,0,0
7595,2019-03-02,1001,0,1001,79,1080,1080,0,0
7596,2019-03-02,241,0,241,19,260,260,0,0
7597,2019-03-02,1815,0,1815,145,1960,1960,0,0
7598,2019-03-02,1334,0,1334,106,1440,1440,0,0
7599,2019-03-02,1084,0,1084,86,1170,1170,0,0
7600,2019-03-02,658,0,658,52,710,710,0,0
7601,2019-03-02,426,0,426,34,460,460,0,0
7602,2019-03-02,908,0,908,72,980,980,0,0
7603,2019-03-02,3630,0,3630,290,3920,3920,0,0
7604,2019-03-02,556,0,556,44,600,600,0,0
7605,2019-03-02,463,0,463,37,500,500,0,0
7606,2019-03-02,639,0,639,51,690,690,0,0
7607,2019-03-02,491,0,491,39,530,530,0,0
7608,2019-03-02,130,0,130,10,140,140,0,0
7609,2019-03-02,649,0,649,51,700,700,0,0
7610,2019-03-02,445,0,445,35,480,480,0,0
7611,2019-03-02,269,0,269,21,290,290,0,0
7612,2019-03-02,908,0,908,72,980,980,0,0
7613,2019-03-02,1825,0,1825,145,1970,1970,0,0
7614,2019-03-02,908,0,908,72,980,980,0,0
7615,2019-03-02,1278,0,1278,102,1380,1380,0,0
7616,2019-03-02,1815,0,1815,145,1960,1960,0,0
7617,2019-03-02,241,0,241,19,260,260,0,0
7618,2019-03-02,908,0,908,72,980,980,0,0
7619,2019-03-02,1908,0,1908,152,2060,2060,0,0
7620,2019-03-02,1167,0,1167,93,1260,1260,0,0
7621,2019-03-02,306,0,306,24,330,330,0,0
7622,2019-03-02,607,0,607,48,655,655,0,0
7623,2019-03-02,533,0,533,42,575,575,0,0
7624,2019-03-02,899,0,899,71,970,970,0,0
7625,2019-03-02,315,0,315,25,340,340,0,0
7626,2019-03-02,815,0,815,65,880,880,0,0
7627,2019-03-02,278,0,278,22,300,300,0,0
7628,2019-03-02,731,0,731,49,780,780,0,0
7629,2019-03-02,297,0,297,23,320,320,0,0
7630,2019-03-02,797,0,797,63,860,860,0,0
7631,2019-03-02,232,0,232,18,250,250,0,0
7632,2019-03-02,834,0,834,66,900,900,0,0
7633,2019-03-02,1889,0,1889,151,2040,2040,0,0
7634,2019-03-02,481,0,481,29,510,510,0,0
7635,2019-03-02,676,0,676,54,730,730,0,0
7636,2019-03-02,630,0,630,50,680,680,0,0
7637,2019-03-02,806,0,806,64,870,870,0,0
7638,2019-03-02,908,0,908,72,980,980,0,0
7639,2019-03-02,556,0,556,44,600,600,0,0
7640,2019-03-02,584,0,584,46,630,630,0,0
7641,2019-03-02,778,0,778,62,840,840,0,0
7642,2019-03-02,360,0,360,20,380,380,0,0
7643,2019-03-02,1815,0,1815,145,1960,1960,0,0
7644,2019-03-02,334,0,334,26,360,360,0,0
7645,2019-03-02,362,0,362,28,390,390,0,0
7646,2019-03-02,232,0,232,18,250,250,0,0
7647,2019-03-02,473,0,473,37,510,510,0,0
7648,2019-03-02,453,0,453,27,480,480,0,0
7649,2019-03-02,1815,0,1815,145,1960,1960,0,0
7650,2019-03-02,306,0,306,24,330,330,0,0
7651,2019-03-02,167,0,167,13,180,180,0,0
7652,2019-03-02,547,0,547,43,590,590,0,0
7653,2019-03-02,389,0,389,31,420,420,0,0
7654,2019-03-02,195,0,195,15,210,210,0,0
7655,2019-03-02,251,0,251,19,270,270,0,0
7656,2019-03-02,1019,0,1019,81,1100,1100,0,0
7657,2019-03-02,519,0,519,41,560,560,0,0
7658,2019-03-02,241,0,241,19,260,260,0,0
7659,2019-03-02,2315,0,2315,185,2500,2500,0,0
7660,2019-03-02,264,-56,208,16,224,224,0,0
7661,2019-03-02,269,0,269,21,290,290,0,0
7662,2019-03-02,204,0,204,16,220,220,0,0
7663,2019-03-02,389,0,389,31,420,420,0,0
7664,2019-03-02,297,0,297,23,320,320,0,0
7665,2019-03-02,112,0,112,8,120,120,0,0
7666,2019-03-02,1667,0,1667,133,1800,0,1800,0
7667,2019-03-02,1232,0,1232,98,1330,1330,0,0
7668,2019-03-02,741,0,741,59,800,800,0,0
7669,2019-03-02,565,0,565,45,610,610,0,0
7670,2019-03-02,871,0,871,69,940,940,0,0
7671,2019-03-02,1260,0,1260,100,1360,1360,0,0
7672,2019-03-02,399,0,399,31,430,430,0,0
7673,2019-03-02,639,0,639,51,690,690,0,0
7674,2019-03-02,260,0,260,20,280,280,0,0
7675,2019-03-02,751,0,751,59,810,810,0,0
7676,2019-03-02,445,0,445,35,480,480,0,0
7677,2019-03-02,139,0,139,11,150,150,0,0
7678,2019-03-02,584,0,584,46,630,630,0,0
7679,2019-03-02,862,0,862,68,930,930,0,0
7680,2019-03-02,510,0,510,40,550,550,0,0
7681,2019-03-02,167,0,167,13,180,180,0,0
7682,2019-03-02,269,0,269,21,290,290,0,0
7683,2019-03-02,491,0,491,39,530,530,0,0
7684,2019-03-02,450,0,450,35,485,485,0,0
7685,2019-03-02,491,0,491,39,530,530,0,0
7686,2019-03-02,232,0,232,18,250,250,0,0
7687,2019-03-02,2056,0,2056,164,2220,2220,0,0
7688,2019-03-02,713,0,713,57,770,770,0,0
7689,2019-03-02,445,0,445,35,480,480,0,0
7690,2019-03-02,454,0,454,36,490,490,0,0
7691,2019-03-02,172,0,172,13,185,185,0,0
7692,2019-03-02,167,0,167,13,180,180,0,0
7693,2019-03-02,889,0,889,71,960,960,0,0
7694,2019-03-02,4899,0,4899,391,5290,5290,0,0
7695,2019-03-02,371,0,371,29,400,400,0,0
7696,2019-03-02,538,0,538,42,580,580,0,0
7697,2019-03-02,2241,0,2241,179,2420,2420,0,0
7698,2019-03-02,1213,0,1213,97,1310,1310,0,0
7699,2019-03-02,278,0,278,22,300,300,0,0
7700,2019-03-02,1806,0,1806,144,1950,0,1950,0
7701,2019-03-02,1575,0,1575,125,1700,1700,0,0
7702,2019-03-02,1575,0,1575,125,1700,1700,0,0
7703,2019-03-02,954,0,954,76,1030,1030,0,0
7704,2019-03-02,2362,0,2362,188,2550,2550,0,0
7705,2019-03-02,1575,0,1575,125,1700,1700,0,0
7706,2019-03-02,1612,0,1612,128,1740,0,1740,0
7707,2019-03-02,1121,0,1121,89,1210,1210,0,0
7708,2019-03-02,1112,0,1112,88,1200,1200,0,0
7709,2019-03-02,343,0,343,27,370,370,0,0
7710,2019-03-02,408,0,408,32,440,440,0,0
7711,2019-03-02,1575,0,1575,125,1700,0,1700,0
7712,2019-03-02,778,0,778,62,840,840,0,0
7713,2019-03-02,1445,0,1445,115,1560,1560,0,0
7714,2019-03-02,1277,0,1277,93,1370,1370,0,0
7715,2019-03-02,1362,0,1362,108,1470,1470,0,0
7716,2019-03-02,260,0,260,20,280,280,0,0
7717,2019-03-02,232,0,232,18,250,250,0,0
7718,2019-03-02,491,0,491,39,530,530,0,0
7719,2019-03-02,954,0,954,76,1030,1030,0,0
7720,2019-03-02,1445,0,1445,115,1560,1560,0,0
7721,2019-03-02,306,0,306,24,330,330,0,0
7722,2019-03-02,667,0,667,53,720,720,0,0
7723,2019-03-02,2130,0,2130,170,2300,2300,0,0
7724,2019-03-02,649,0,649,51,700,700,0,0
7725,2019-03-02,93,0,93,7,100,100,0,0
7726,2019-03-02,1575,0,1575,125,1700,1700,0,0
7727,2019-03-02,788,0,788,62,850,850,0,0
7728,2019-03-02,2223,0,2223,177,2400,0,2400,0
7729,2019-03-02,352,0,352,28,380,380,0,0
7730,2019-03-02,908,0,908,72,980,980,0,0
7731,2019-03-02,899,0,899,71,970,970,0,0
7732,2019-03-02,1223,0,1223,97,1320,1320,0,0
7733,2019-03-02,2130,0,2130,170,2300,0,2300,0
7734,2019-03-02,788,0,788,62,850,850,0,0
7735,2019-03-02,788,0,788,62,850,850,0,0
7736,2019-03-02,788,0,788,62,850,850,0,0
7737,2019-03-02,612,0,612,48,660,660,0,0
7738,2019-03-02,676,0,676,54,730,730,0,0
7739,2019-03-02,1575,0,1575,125,1700,1700,0,0
7740,2019-03-02,741,0,741,59,800,800,0,0
7741,2019-03-02,695,0,695,55,750,750,0,0
7742,2019-03-02,788,0,788,62,850,850,0,0
7743,2019-03-02,1315,0,1315,105,1420,1420,0,0
7744,2019-03-03,510,0,510,40,550,550,0,0
7745,2019-03-03,658,0,658,52,710,710,0,0
7746,2019-03-03,426,0,426,34,460,460,0,0
7747,2019-03-03,1121,0,1121,89,1210,1210,0,0
7748,2019-03-03,334,0,334,26,360,360,0,0
7749,2019-03-03,417,0,417,33,450,450,0,0
7750,2019-03-03,398,0,398,22,420,420,0,0
7751,2019-03-03,760,0,760,60,820,820,0,0
7752,2019-03-03,584,0,584,46,630,630,0,0
7753,2019-03-03,260,0,260,20,280,280,0,0
7754,2019-03-03,334,0,334,26,360,360,0,0
7755,2019-03-03,565,0,565,45,610,610,0,0
7756,2019-03-03,575,0,575,45,620,620,0,0
7757,2019-03-03,1473,0,1473,117,1590,1590,0,0
7758,2019-03-03,491,0,491,39,530,530,0,0
7759,2019-03-03,1019,0,1019,81,1100,1100,0,0
7760,2019-03-03,769,0,769,61,830,830,0,0
7761,2019-03-03,556,0,556,44,600,600,0,0
7762,2019-03-03,426,0,426,34,460,460,0,0
7763,2019-03-03,797,0,797,63,860,860,0,0
7764,2019-03-03,658,0,658,52,710,710,0,0
7765,2019-03-03,908,0,908,72,980,980,0,0
7766,2019-03-03,2130,0,2130,170,2300,2300,0,0
7767,2019-03-03,167,0,167,13,180,180,0,0
7768,2019-03-03,1861,0,1861,139,2000,2000,0,0
7769,2019-03-03,908,0,908,72,980,980,0,0
7770,2019-03-03,371,0,371,29,400,400,0,0
7771,2019-03-03,908,0,908,72,980,980,0,0
7772,2019-03-03,1815,0,1815,145,1960,1960,0,0
7773,2019-03-03,3121,0,3121,249,3370,3370,0,0
7774,2019-03-03,352,0,352,28,380,380,0,0
7775,2019-03-03,389,0,389,31,420,420,0,0
7776,2019-03-03,686,0,686,54,740,740,0,0
7777,2019-03-03,389,0,389,31,420,420,0,0
7778,2019-03-03,269,0,269,21,290,290,0,0
7779,2019-03-03,315,0,315,25,340,340,0,0
7780,2019-03-03,917,0,917,73,990,990,0,0
7781,2019-03-03,1065,0,1065,85,1150,1150,0,0
7782,2019-03-03,1092,0,1092,78,1170,1170,0,0
7783,2019-03-03,519,0,519,41,560,560,0,0
7784,2019-03-03,334,0,334,26,360,360,0,0
7785,2019-03-03,510,0,510,40,550,550,0,0
7786,2019-03-03,686,0,686,54,740,740,0,0
7787,2019-03-03,852,0,852,68,920,920,0,0
7788,2019-03-03,213,0,213,17,230,230,0,0
7789,2019-03-03,343,0,343,27,370,370,0,0
7790,2019-03-03,362,0,362,28,390,390,0,0
7791,2019-03-03,621,0,621,49,670,670,0,0
7792,2019-03-03,926,0,926,74,1000,1000,0,0
7793,2019-03-03,417,0,417,33,450,450,0,0
7794,2019-03-03,2704,0,2704,216,2920,2920,0,0
7795,2019-03-03,1815,0,1815,145,1960,1960,0,0
7796,2019-03-03,1075,0,1075,85,1160,1160,0,0
7797,2019-03-03,908,0,908,72,980,980,0,0
7798,2019-03-03,797,0,797,63,860,860,0,0
7799,2019-03-03,1667,0,1667,133,1800,1800,0,0
7800,2019-03-03,1815,0,1815,145,1960,1960,0,0
7801,2019-03-03,112,0,112,8,120,120,0,0
7802,2019-03-03,112,0,112,8,120,120,0,0
7803,2019-03-03,778,0,778,62,840,840,0,0
7804,2019-03-03,1825,0,1825,145,1970,1970,0,0
7805,2019-03-03,852,0,852,68,920,920,0,0
7806,2019-03-03,658,0,658,52,710,710,0,0
7807,2019-03-03,547,0,547,43,590,590,0,0
7808,2019-03-03,556,0,556,44,600,600,0,0
7809,2019-03-03,362,0,362,28,390,390,0,0
7810,2019-03-03,471,-100,371,29,400,400,0,0
7811,2019-03-03,260,0,260,20,280,280,0,0
7812,2019-03-03,639,0,639,51,690,690,0,0
7813,2019-03-03,639,0,639,51,690,690,0,0
7814,2019-03-03,1093,0,1093,87,1180,1180,0,0
7815,2019-03-03,139,0,139,11,150,150,0,0
7816,2019-03-03,584,0,584,46,630,630,0,0
7817,2019-03-03,482,0,482,38,520,520,0,0
7818,2019-03-03,621,0,621,49,670,670,0,0
7819,2019-03-03,297,0,297,23,320,320,0,0
7820,2019-03-03,278,0,278,22,300,300,0,0
7821,2019-03-03,269,0,269,21,290,290,0,0
7822,2019-03-03,797,0,797,63,860,0,860,0
7823,2019-03-03,2084,0,2084,166,2250,2250,0,0
7824,2019-03-03,2630,0,2630,210,2840,2840,0,0
7825,2019-03-03,167,0,167,13,180,180,0,0
7826,2019-03-03,186,0,186,14,200,200,0,0
7827,2019-03-03,1010,0,1010,80,1090,1090,0,0
7828,2019-03-03,1010,0,1010,80,1090,1090,0,0
7829,2019-03-03,473,0,473,37,510,510,0,0
7830,2019-03-03,133,0,133,10,143,143,0,0
7831,2019-03-03,1278,0,1278,102,1380,1380,0,0
7832,2019-03-03,278,0,278,22,300,300,0,0
7833,2019-03-03,334,0,334,26,360,360,0,0
7834,2019-03-03,251,0,251,19,270,270,0,0
7835,2019-03-03,501,0,501,39,540,540,0,0
7836,2019-03-03,687,0,687,54,741,741,0,0
7837,2019-03-03,1010,0,1010,80,1090,1090,0,0
7838,2019-03-03,908,0,908,72,980,980,0,0
7839,2019-03-03,686,0,686,54,740,740,0,0
7840,2019-03-03,788,0,788,62,850,850,0,0
7841,2019-03-03,788,0,788,62,850,850,0,0
7842,2019-03-03,269,0,269,21,290,290,0,0
7843,2019-03-03,399,0,399,31,430,430,0,0
7844,2019-03-03,1879,0,1879,141,2020,2020,0,0
7845,2019-03-03,1575,0,1575,125,1700,1700,0,0
7846,2019-03-03,899,0,899,71,970,970,0,0
7847,2019-03-03,315,0,315,25,340,340,0,0
7848,2019-03-03,407,0,407,23,430,430,0,0
7849,2019-03-03,1575,0,1575,125,1700,1700,0,0
7850,2019-03-03,936,0,936,74,1010,1010,0,0
7851,2019-03-03,538,0,538,42,580,580,0,0
7852,2019-03-03,362,0,362,28,390,390,0,0
7853,2019-03-03,936,0,936,74,1010,1010,0,0
7854,2019-03-03,713,0,713,57,770,770,0,0
7855,2019-03-03,260,0,260,20,280,280,0,0
7856,2019-03-03,1575,0,1575,125,1700,1700,0,0
7857,2019-03-03,658,0,658,52,710,710,0,0
7858,2019-03-03,2362,0,2362,188,2550,2550,0,0
7859,2019-03-03,1575,0,1575,125,1700,1700,0,0
7860,2019-03-03,673,0,673,27,700,700,0,0
7861,2019-03-03,1575,0,1575,125,1700,1700,0,0
7862,2019-03-03,1056,0,1056,84,1140,1140,0,0
7863,2019-03-03,1047,0,1047,83,1130,1130,0,0
7864,2019-03-03,1084,0,1084,86,1170,1170,0,0
7865,2019-03-03,417,0,417,33,450,450,0,0
7866,2019-03-03,315,0,315,25,340,340,0,0
7867,2019-03-03,1843,0,1843,147,1990,1990,0,0
7868,2019-03-04,481,0,481,29,510,510,0,0
7869,2019-03-04,482,0,482,38,520,520,0,0
7870,2019-03-04,501,0,501,39,540,540,0,0
7871,2019-03-04,463,0,463,37,500,500,0,0
7872,2019-03-04,593,0,593,47,640,640,0,0
7873,2019-03-04,908,0,908,72,980,980,0,0
7874,2019-03-04,1667,0,1667,133,1800,1800,0,0
7875,2019-03-04,139,0,139,11,150,150,0,0
7876,2019-03-04,528,0,528,42,570,570,0,0
7877,2019-03-04,1815,0,1815,145,1960,1960,0,0
7878,2019-03-04,676,0,676,54,730,730,0,0
7879,2019-03-04,945,0,945,75,1020,1020,0,0
7880,2019-03-04,207,-44,163,13,176,0,176,0
7881,2019-03-04,269,0,269,21,290,290,0,0
7882,2019-03-04,445,0,445,35,480,480,0,0
7883,2019-03-04,315,0,315,25,340,340,0,0
7884,2019-03-04,1815,0,1815,145,1960,1960,0,0
7885,2019-03-04,797,0,797,63,860,860,0,0
7886,2019-03-04,1815,0,1815,145,1960,1960,0,0
7887,2019-03-04,334,0,334,26,360,360,0,0
7888,2019-03-04,658,0,658,52,710,710,0,0
7889,2019-03-04,260,0,260,20,280,280,0,0
7890,2019-03-04,908,0,908,72,980,980,0,0
7891,2019-03-04,-1815,0,-1815,-145,-1960,-1960,0,0
7892,2019-03-04,315,0,315,25,340,340,0,0
7893,2019-03-04,788,0,788,62,850,850,0,0
7894,2019-03-04,362,0,362,28,390,390,0,0
7895,2019-03-04,676,0,676,54,730,730,0,0
7896,2019-03-04,1343,0,1343,107,1450,1450,0,0
7897,2019-03-04,491,0,491,39,530,530,0,0
7898,2019-03-04,676,0,676,54,730,730,0,0
7899,2019-03-04,629,0,629,41,670,670,0,0
7900,2019-03-04,908,0,908,72,980,980,0,0
7901,2019-03-04,288,0,288,22,310,310,0,0
7902,2019-03-04,334,0,334,26,360,360,0,0
7903,2019-03-04,547,0,547,43,590,590,0,0
7904,2019-03-04,1264,0,1264,101,1365,1365,0,0
7905,2019-03-04,639,0,639,51,690,690,0,0
7906,2019-03-04,232,0,232,18,250,250,0,0
7907,2019-03-04,602,0,602,48,650,650,0,0
7908,2019-03-04,584,0,584,46,630,630,0,0
7909,2019-03-04,908,0,908,72,980,980,0,0
7910,2019-03-04,908,0,908,72,980,980,0,0
7911,2019-03-04,1112,0,1112,88,1200,1200,0,0
7912,2019-03-04,1167,0,1167,93,1260,1260,0,0
7913,2019-03-04,649,0,649,51,700,700,0,0
7914,2019-03-04,908,0,908,72,980,980,0,0
7915,2019-03-04,584,0,584,46,630,630,0,0
7916,2019-03-04,481,0,481,29,510,0,510,0
7917,2019-03-04,908,0,908,72,980,980,0,0
7918,2019-03-04,908,0,908,72,980,980,0,0
7919,2019-03-04,908,0,908,72,980,980,0,0
7920,2019-03-04,241,0,241,19,260,260,0,0
7921,2019-03-04,555,0,555,35,590,590,0,0
7922,2019-03-04,908,0,908,72,980,980,0,0
7923,2019-03-04,288,0,288,22,310,310,0,0
7924,2019-03-04,195,0,195,15,210,210,0,0
7925,2019-03-04,1093,-1000,93,7,100,100,0,0
7926,2019-03-04,477,0,477,38,515,515,0,0
7927,2019-03-04,852,0,852,68,920,920,0,0
7928,2019-03-04,352,0,352,28,380,380,0,0
7929,2019-03-04,1010,0,1010,80,1090,1090,0,0
7930,2019-03-04,612,0,612,48,660,660,0,0
7931,2019-03-04,741,0,741,59,800,800,0,0
7932,2019-03-04,528,0,528,42,570,570,0,0
7933,2019-03-04,371,0,371,29,400,400,0,0
7934,2019-03-04,1815,0,1815,145,1960,1960,0,0
7935,2019-03-04,269,0,269,21,290,290,0,0
7936,2019-03-04,473,0,473,37,510,510,0,0
7937,2019-03-04,251,0,251,19,270,270,0,0
7938,2019-03-04,908,0,908,72,980,980,0,0
7939,2019-03-04,1463,0,1463,117,1580,1580,0,0
7940,2019-03-04,1028,0,1028,82,1110,1110,0,0
7941,2019-03-04,1815,0,1815,145,1960,1960,0,0
7942,2019-03-04,1815,0,1815,145,1960,1960,0,0
7943,2019-03-04,862,0,862,68,930,930,0,0
7944,2019-03-04,880,0,880,70,950,950,0,0
7945,2019-03-04,777,0,777,53,830,830,0,0
7946,2019-03-04,871,0,871,69,940,940,0,0
7947,2019-03-04,1167,0,1167,93,1260,1260,0,0
7948,2019-03-04,491,0,491,39,530,530,0,0
7949,2019-03-04,991,0,991,79,1070,1070,0,0
7950,2019-03-04,-1167,0,-1167,-93,-1260,-1260,0,0
7951,2019-03-04,186,0,186,14,200,200,0,0
7952,2019-03-04,389,0,389,31,420,420,0,0
7953,2019-03-04,399,0,399,31,430,430,0,0
7954,2019-03-04,963,0,963,77,1040,1040,0,0
7955,2019-03-04,621,0,621,49,670,670,0,0
7956,2019-03-04,288,0,288,22,310,310,0,0
7957,2019-03-04,149,0,149,11,160,160,0,0
7958,2019-03-04,1167,0,1167,93,1260,1260,0,0
7959,2019-03-04,1645,0,1645,105,1750,1750,0,0
7960,2019-03-04,399,0,399,31,430,430,0,0
7961,2019-03-04,1176,0,1176,94,1270,1270,0,0
7962,2019-03-04,149,0,149,11,160,160,0,0
7963,2019-03-04,186,0,186,14,200,200,0,0
7964,2019-03-04,1028,0,1028,82,1110,1110,0,0
7965,2019-03-04,186,0,186,14,200,200,0,0
7966,2019-03-04,139,0,139,11,150,150,0,0
7967,2019-03-04,269,0,269,21,290,290,0,0
7968,2019-03-04,186,0,186,14,200,200,0,0
7969,2019-03-04,102,0,102,8,110,110,0,0
7970,2019-03-04,167,0,167,13,180,180,0,0
7971,2019-03-04,186,0,186,14,200,200,0,0
7972,2019-03-04,362,0,362,28,390,390,0,0
7973,2019-03-04,139,0,139,11,150,150,0,0
7974,2019-03-04,112,0,112,8,120,120,0,0
7975,2019-03-04,241,0,241,19,260,260,0,0
7976,2019-03-04,112,0,112,8,120,120,0,0
7977,2019-03-04,250,0,250,20,270,270,0,0
7978,2019-03-04,167,0,167,13,180,180,0,0
7979,2019-03-04,658,0,658,52,710,710,0,0
7980,2019-03-04,417,0,417,33,450,450,0,0
7981,2019-03-04,149,0,149,11,160,160,0,0
7982,2019-03-04,110,0,110,0,110,110,0,0
7983,2019-03-04,843,0,843,67,910,910,0,0
7984,2019-03-04,454,0,454,36,490,490,0,0
7985,2019-03-04,760,0,760,60,820,820,0,0
7986,2019-03-04,760,0,760,60,820,820,0,0
7987,2019-03-04,445,0,445,35,480,480,0,0
7988,2019-03-04,371,0,371,29,400,400,0,0
7989,2019-03-04,398,0,398,22,420,420,0,0
7990,2019-03-04,1899,0,1899,151,2050,2050,0,0
7991,2019-03-04,926,0,926,74,1000,1000,0,0
7992,2019-03-04,260,0,260,20,280,280,0,0
7993,2019-03-04,463,0,463,37,500,500,0,0
7994,2019-03-04,510,0,510,40,550,550,0,0
7995,2019-03-04,269,0,269,21,290,290,0,0
7996,2019-03-04,500,0,500,40,540,540,0,0
7997,2019-03-04,371,0,371,29,400,400,0,0
7998,2019-03-04,1001,0,1001,79,1080,1080,0,0
7999,2019-03-04,982,0,982,78,1060,1060,0,0
8000,2019-03-04,1121,0,1121,89,1210,1210,0,0
8001,2019-03-04,519,0,519,41,560,560,0,0
8002,2019-03-04,1194,0,1194,86,1280,1280,0,0
8003,2019-03-04,908,0,908,72,980,980,0,0
8004,2019-03-04,110,0,110,0,110,110,0,0
8005,2019-03-04,278,0,278,22,300,300,0,0
8006,2019-03-04,788,0,788,62,850,850,0,0
8007,2019-03-04,908,0,908,72,980,980,0,0
8008,2019-03-04,139,0,139,11,150,150,0,0
8009,2019-03-04,741,0,741,59,800,800,0,0
8010,2019-03-04,1176,0,1176,94,1270,1270,0,0
8011,2019-03-04,371,0,371,29,400,400,0,0
8012,2019-03-04,1306,0,1306,104,1410,1410,0,0
8013,2019-03-04,593,0,593,47,640,640,0,0
8014,2019-03-04,639,0,639,51,690,690,0,0
8015,2019-03-04,612,0,612,48,660,660,0,0
8016,2019-03-04,408,0,408,32,440,440,0,0
8017,2019-03-04,1112,0,1112,88,1200,1200,0,0
8018,2019-03-04,1389,0,1389,111,1500,1500,0,0
8019,2019-03-04,306,0,306,24,330,330,0,0
8020,2019-03-04,806,0,806,64,870,870,0,0
8021,2019-03-04,454,0,454,36,490,490,0,0
8022,2019-03-04,889,0,889,71,960,960,0,0
8023,2019-03-04,1084,0,1084,86,1170,1170,0,0
8024,2019-03-04,1269,0,1269,101,1370,1370,0,0
8025,2019-03-04,704,0,704,56,760,760,0,0
8026,2019-03-04,232,0,232,18,250,250,0,0
8027,2019-03-04,2723,0,2723,217,2940,2940,0,0
8028,2019-03-04,510,0,510,40,550,550,0,0
8029,2019-03-04,519,0,519,41,560,560,0,0
8030,2019-03-04,602,0,602,48,650,650,0,0
8031,2019-03-04,834,0,834,66,900,900,0,0
8032,2019-03-04,380,0,380,30,410,410,0,0
8033,2019-03-04,788,0,788,62,850,850,0,0
8034,2019-03-04,1575,0,1575,125,1700,0,1700,0
8035,2019-03-04,2001,0,2001,159,2160,2160,0,0
8036,2019-03-04,1814,0,1814,136,1950,1950,0,0
8037,2019-03-04,556,0,556,44,600,600,0,0
8038,2019-03-04,658,0,658,52,710,710,0,0
8039,2019-03-04,998,-212,786,62,848,848,0,0
8040,2019-03-04,1575,0,1575,125,1700,1700,0,0
8041,2019-03-04,315,0,315,25,340,340,0,0
8042,2019-03-04,751,0,751,59,810,810,0,0
8043,2019-03-04,3195,0,3195,255,3450,3450,0,0
8044,2019-03-04,889,0,889,71,960,960,0,0
8045,2019-03-04,917,0,917,73,990,990,0,0
8046,2019-03-04,528,0,528,42,570,570,0,0
8047,2019-03-04,445,0,445,35,480,480,0,0
8048,2019-03-04,473,0,473,37,510,510,0,0
8049,2019-03-04,806,0,806,64,870,870,0,0
8050,2019-03-04,954,0,954,76,1030,1030,0,0
8051,2019-03-04,815,0,815,65,880,880,0,0
8052,2019-03-04,278,0,278,22,300,300,0,0
8053,2019-03-04,889,0,889,71,960,0,960,0
8054,2019-03-05,269,0,269,21,290,290,0,0
8055,2019-03-05,491,0,491,39,530,530,0,0
8056,2019-03-05,741,0,741,59,800,800,0,0
8057,2019-03-05,334,0,334,26,360,360,0,0
8058,2019-03-05,491,0,491,39,530,530,0,0
8059,2019-03-05,271,-29,242,19,261,261,0,0
8060,2019-03-05,241,0,241,19,260,260,0,0
8061,2019-03-05,269,0,269,21,290,290,0,0
8062,2019-03-05,825,0,825,65,890,890,0,0
8063,2019-03-05,1195,0,1195,95,1290,1290,0,0
8064,2019-03-05,501,0,501,39,540,540,0,0
8065,2019-03-05,362,0,362,28,390,390,0,0
8066,2019-03-05,112,0,112,8,120,120,0,0
8067,2019-03-05,223,0,223,17,240,240,0,0
8068,2019-03-05,482,0,482,38,520,520,0,0
8069,2019-03-05,56,0,56,4,60,60,0,0
8070,2019-03-05,352,0,352,28,380,380,0,0
8071,2019-03-05,1232,0,1232,98,1330,1330,0,0
8072,2019-03-06,1815,0,1815,145,1960,1960,0,0
8073,2019-03-06,575,0,575,45,620,620,0,0
8074,2019-03-06,612,0,612,48,660,660,0,0
8075,2019-03-06,778,0,778,62,840,840,0,0
8076,2019-03-06,936,0,936,74,1010,1010,0,0
8077,2019-03-06,1148,0,1148,82,1230,1230,0,0
8078,2019-03-06,2825,0,2825,225,3050,3050,0,0
8079,2019-03-06,306,0,306,24,330,330,0,0
8080,2019-03-06,1815,0,1815,145,1960,1960,0,0
8081,2019-03-06,380,0,380,30,410,410,0,0
8082,2019-03-06,908,0,908,72,980,980,0,0
8083,2019-03-06,443,-94,349,27,376,376,0,0
8084,2019-03-06,435,0,435,25,460,460,0,0
8085,2019-03-06,602,0,602,48,650,650,0,0
8086,2019-03-06,538,0,538,42,580,580,0,0
8087,2019-03-06,371,0,371,29,400,400,0,0
8088,2019-03-06,1575,0,1575,125,1700,1700,0,0
8089,2019-03-06,1001,0,1001,79,1080,1080,0,0
8090,2019-03-06,325,0,325,25,350,350,0,0
8091,2019-03-06,769,0,769,61,830,830,0,0
8092,2019-03-06,639,0,639,51,690,690,0,0
8093,2019-03-06,1139,0,1139,91,1230,1230,0,0
8094,2019-03-06,250,0,250,20,270,270,0,0
8095,2019-03-06,686,0,686,54,740,740,0,0
8096,2019-03-06,389,0,389,31,420,420,0,0
8097,2019-03-06,639,0,639,51,690,690,0,0
8098,2019-03-06,3630,0,3630,290,3920,3920,0,0
8099,2019-03-06,751,0,751,59,810,810,0,0
8100,2019-03-06,260,0,260,20,280,280,0,0
8101,2019-03-06,426,0,426,34,460,460,0,0
8102,2019-03-06,797,0,797,63,860,860,0,0
8103,2019-03-06,491,0,491,39,530,530,0,0
8104,2019-03-06,176,0,176,14,190,190,0,0
8105,2019-03-06,658,0,658,52,710,710,0,0
8106,2019-03-06,1251,0,1251,99,1350,0,1350,0
8107,2019-03-06,769,0,769,61,830,830,0,0
8108,2019-03-06,556,0,556,44,600,600,0,0
8109,2019-03-06,388,0,388,22,410,0,410,0
8110,2019-03-06,908,0,908,72,980,980,0,0
8111,2019-03-06,371,0,371,29,400,400,0,0
8112,2019-03-06,1602,0,1602,128,1730,1730,0,0
8113,2019-03-06,343,0,343,27,370,370,0,0
8114,2019-03-06,788,0,788,62,850,850,0,0
8115,2019-03-06,417,0,417,33,450,450,0,0
8116,2019-03-06,500,0,500,40,540,540,0,0
8117,2019-03-06,352,0,352,28,380,380,0,0
8118,2019-03-06,778,0,778,62,840,840,0,0
8119,2019-03-06,519,0,519,41,560,560,0,0
8120,2019-03-06,139,0,139,11,150,150,0,0
8121,2019-03-06,1065,0,1065,85,1150,1150,0,0
8122,2019-03-06,788,0,788,62,850,850,0,0
8123,2019-03-06,788,0,788,62,850,850,0,0
8124,2019-03-06,380,0,380,30,410,410,0,0
8125,2019-03-06,788,0,788,62,850,850,0,0
8126,2019-03-06,121,0,121,9,130,130,0,0
8127,2019-03-06,1204,0,1204,96,1300,1300,0,0
8128,2019-03-06,612,0,612,48,660,660,0,0
8129,2019-03-06,1065,0,1065,85,1150,1150,0,0
8130,2019-03-06,380,0,380,30,410,410,0,0
8131,2019-03-06,417,0,417,33,450,450,0,0
8132,2019-03-06,713,0,713,57,770,770,0,0
8133,2019-03-06,602,0,602,48,650,650,0,0
8134,2019-03-06,547,0,547,43,590,590,0,0
8135,2019-03-06,528,0,528,42,570,570,0,0
8136,2019-03-06,491,0,491,39,530,530,0,0
8137,2019-03-06,1501,0,1501,119,1620,1620,0,0
8138,2019-03-06,991,0,991,79,1070,1070,0,0
8139,2019-03-06,278,0,278,22,300,300,0,0
8140,2019-03-06,667,0,667,53,720,720,0,0
8141,2019-03-06,1547,0,1547,123,1670,0,1670,0
8142,2019-03-06,777,0,777,53,830,830,0,0
8143,2019-03-06,778,0,778,62,840,840,0,0
8144,2019-03-06,565,0,565,45,610,610,0,0
8145,2019-03-06,723,0,723,57,780,780,0,0
8146,2019-03-06,547,0,547,43,590,590,0,0
8147,2019-03-06,1343,0,1343,107,1450,1450,0,0
8148,2019-03-07,908,0,908,72,980,980,0,0
8149,2019-03-07,833,0,833,57,890,890,0,0
8150,2019-03-07,760,0,760,60,820,820,0,0
8151,2019-03-07,139,0,139,11,150,150,0,0
8152,2019-03-07,1278,0,1278,102,1380,1380,0,0
8153,2019-03-07,1815,0,1815,145,1960,1960,0,0
8154,2019-03-07,473,0,473,37,510,510,0,0
8155,2019-03-07,325,0,325,25,350,350,0,0
8156,2019-03-07,538,0,538,42,580,580,0,0
8157,2019-03-07,334,0,334,26,360,360,0,0
8158,2019-03-07,1538,0,1538,122,1660,1660,0,0
8159,2019-03-07,149,0,149,11,160,160,0,0
8160,2019-03-07,1195,0,1195,95,1290,1290,0,0
8161,2019-03-07,1019,0,1019,81,1100,1100,0,0
8162,2019-03-07,908,0,908,72,980,980,0,0
8163,2019-03-07,908,0,908,72,980,980,0,0
8164,2019-03-07,908,0,908,72,980,980,0,0
8165,2019-03-07,908,0,908,72,980,980,0,0
8166,2019-03-07,908,0,908,72,980,980,0,0
8167,2019-03-07,232,0,232,18,250,250,0,0
8168,2019-03-07,352,0,352,28,380,380,0,0
8169,2019-03-07,528,0,528,42,570,570,0,0
8170,2019-03-07,788,0,788,62,850,850,0,0
8171,2019-03-07,250,0,250,20,270,270,0,0
8172,2019-03-07,436,0,436,34,470,470,0,0
8173,2019-03-07,908,0,908,72,980,980,0,0
8174,2019-03-07,908,0,908,72,980,980,0,0
8175,2019-03-07,260,0,260,20,280,280,0,0
8176,2019-03-07,278,0,278,22,300,0,300,0
8177,2019-03-07,1815,0,1815,145,1960,1960,0,0
8178,2019-03-07,575,0,575,45,620,620,0,0
8179,2019-03-07,1112,0,1112,88,1200,1200,0,0
8180,2019-03-07,852,0,852,68,920,920,0,0
8181,2019-03-07,653,0,653,52,705,705,0,0
8182,2019-03-07,1334,0,1334,106,1440,1440,0,0
8183,2019-03-07,1362,0,1362,108,1470,1470,0,0
8184,2019-03-07,760,0,760,60,820,820,0,0
8185,2019-03-07,167,0,167,13,180,180,0,0
8186,2019-03-07,852,0,852,68,920,920,0,0
8187,2019-03-07,260,0,260,20,280,280,0,0
8188,2019-03-07,491,0,491,39,530,530,0,0
8189,2019-03-07,371,0,371,29,400,400,0,0
8190,2019-03-07,1241,0,1241,99,1340,1340,0,0
8191,2019-03-07,1112,0,1112,88,1200,1200,0,0
8192,2019-03-07,547,0,547,43,590,590,0,0
8193,2019-03-07,602,0,602,48,650,650,0,0
8194,2019-03-07,621,0,621,49,670,670,0,0
8195,2019-03-07,538,0,538,42,580,580,0,0
8196,2019-03-07,306,0,306,24,330,330,0,0
8197,2019-03-07,1269,0,1269,101,1370,1370,0,0
8198,2019-03-07,556,0,556,44,600,600,0,0
8199,2019-03-07,602,0,602,48,650,650,0,0
8200,2019-03-07,1630,0,1630,130,1760,1760,0,0
8201,2019-03-07,1093,0,1093,87,1180,1180,0,0
8202,2019-03-07,852,0,852,68,920,920,0,0
8203,2019-03-07,1454,0,1454,116,1570,1570,0,0
8204,2019-03-07,519,0,519,41,560,560,0,0
8205,2019-03-07,380,0,380,30,410,410,0,0
8206,2019-03-07,575,0,575,45,620,620,0,0
8207,2019-03-07,908,0,908,72,980,980,0,0
8208,2019-03-07,1852,0,1852,148,2000,2000,0,0
8209,2019-03-07,241,0,241,19,260,260,0,0
8210,2019-03-07,658,0,658,52,710,710,0,0
8211,2019-03-07,3149,0,3149,251,3400,3400,0,0
8212,2019-03-07,612,0,612,48,660,660,0,0
8213,2019-03-07,2362,0,2362,188,2550,2550,0,0
8214,2019-03-07,788,0,788,62,850,850,0,0
8215,2019-03-07,788,0,788,62,850,850,0,0
8216,2019-03-07,306,0,306,24,330,330,0,0
8217,2019-03-07,269,0,269,21,290,290,0,0
8218,2019-03-07,139,0,139,11,150,150,0,0
8219,2019-03-07,389,0,389,31,420,420,0,0
8220,2019-03-07,408,0,408,32,440,440,0,0
8221,2019-03-07,639,0,639,51,690,690,0,0
8222,2019-03-07,751,0,751,59,810,810,0,0
8223,2019-03-07,417,0,417,33,450,450,0,0
8224,2019-03-07,343,0,343,27,370,370,0,0
8225,2019-03-07,621,0,621,49,670,670,0,0
8226,2019-03-07,186,0,186,14,200,200,0,0
8227,2019-03-07,1602,0,1602,128,1730,1730,0,0
8228,2019-03-07,1121,0,1121,89,1210,1210,0,0
8229,2019-03-07,861,0,861,59,920,920,0,0
8230,2019-03-07,556,0,556,44,600,600,0,0
8231,2019-03-07,297,0,297,23,320,320,0,0
8232,2019-03-07,2019,0,2019,161,2180,2180,0,0
8233,2019-03-07,334,0,334,26,360,360,0,0
8234,2019-03-07,991,0,991,79,1070,1070,0,0
8235,2019-03-07,462,0,462,28,490,0,490,0
8236,2019-03-07,232,0,232,18,250,250,0,0
8237,2019-03-07,1231,0,1231,89,1320,1320,0,0
8238,2019-03-07,908,0,908,72,980,980,0,0
8239,2019-03-07,760,0,760,60,820,820,0,0
8240,2019-03-07,176,0,176,14,190,190,0,0
8241,2019-03-07,676,0,676,54,730,730,0,0
8242,2019-03-07,1408,0,1408,112,1520,1520,0,0
8243,2019-03-07,732,0,732,58,790,790,0,0
8244,2019-03-07,260,0,260,20,280,280,0,0
8245,2019-03-07,834,0,834,66,900,0,900,0
8246,2019-03-07,741,0,741,59,800,800,0,0
8247,2019-03-07,1352,0,1352,108,1460,1460,0,0
8248,2019-03-07,1269,0,1269,101,1370,1370,0,0
8249,2019-03-07,2047,0,2047,163,2210,2210,0,0
8250,2019-03-07,667,0,667,53,720,720,0,0
8251,2019-03-07,371,0,371,29,400,400,0,0
8252,2019-03-07,704,0,704,56,760,760,0,0
8253,2019-03-07,1575,0,1575,125,1700,1700,0,0
8254,2019-03-07,713,0,713,57,770,770,0,0
8255,2019-03-07,602,0,602,48,650,650,0,0
8256,2019-03-07,269,0,269,21,290,290,0,0
8257,2019-03-07,278,0,278,22,300,300,0,0
8258,2019-03-07,899,0,899,71,970,970,0,0
8259,2019-03-07,1501,0,1501,119,1620,1620,0,0
8260,2019-03-07,629,0,629,41,670,670,0,0
8261,2019-03-07,232,0,232,18,250,250,0,0
8262,2019-03-07,204,0,204,16,220,220,0,0
8263,2019-03-07,778,0,778,62,840,840,0,0
8264,2019-03-07,1028,0,1028,82,1110,1110,0,0
8265,2019-03-07,713,0,713,57,770,770,0,0
8266,2019-03-08,139,0,139,11,150,150,0,0
8267,2019-03-08,908,0,908,72,980,980,0,0
8268,2019-03-08,343,0,343,27,370,370,0,0
8269,2019-03-08,862,0,862,68,930,930,0,0
8270,2019-03-08,519,0,519,41,560,560,0,0
8271,2019-03-08,1815,0,1815,145,1960,1960,0,0
8272,2019-03-08,1815,0,1815,145,1960,1960,0,0
8273,2019-03-08,908,0,908,72,980,980,0,0
8274,2019-03-08,538,0,538,42,580,580,0,0
8275,2019-03-08,528,0,528,42,570,570,0,0
8276,2019-03-08,538,0,538,42,580,580,0,0
8277,2019-03-08,149,0,149,11,160,160,0,0
8278,2019-03-08,1815,0,1815,145,1960,1960,0,0
8279,2019-03-08,843,0,843,67,910,910,0,0
8280,2019-03-08,593,0,593,47,640,640,0,0
8281,2019-03-08,944,0,944,66,1010,1010,0,0
8282,2019-03-08,528,0,528,42,570,570,0,0
8283,2019-03-08,220,0,220,0,220,220,0,0
8284,2019-03-08,417,0,417,33,450,450,0,0
8285,2019-03-08,1028,0,1028,82,1110,1110,0,0
8286,2019-03-08,362,0,362,28,390,390,0,0
8287,2019-03-08,908,0,908,72,980,980,0,0
8288,2019-03-08,2612,0,2612,208,2820,2820,0,0
8289,2019-03-08,760,0,760,60,820,820,0,0
8290,2019-03-08,1371,0,1371,109,1480,1480,0,0
8291,2019-03-08,630,0,630,50,680,680,0,0
8292,2019-03-08,575,0,575,45,620,620,0,0
8293,2019-03-08,1075,0,1075,85,1160,1160,0,0
8294,2019-03-08,639,0,639,51,690,690,0,0
8295,2019-03-08,1871,0,1871,149,2020,2020,0,0
8296,2019-03-08,1249,0,1249,91,1340,1340,0,0
8297,2019-03-08,1723,0,1723,137,1860,1860,0,0
8298,2019-03-08,1010,0,1010,80,1090,1090,0,0
8299,2019-03-08,1176,0,1176,94,1270,1270,0,0
8300,2019-03-08,1732,0,1732,138,1870,1870,0,0
8301,2019-03-08,1268,0,1268,92,1360,1360,0,0
8302,2019-03-08,325,0,325,25,350,350,0,0
8303,2019-03-08,1815,0,1815,145,1960,1960,0,0
8304,2019-03-08,1399,0,1399,111,1510,1510,0,0
8305,2019-03-08,908,0,908,72,980,980,0,0
8306,2019-03-08,1352,0,1352,108,1460,1460,0,0
8307,2019-03-08,649,0,649,51,700,700,0,0
8308,2019-03-08,250,0,250,20,270,270,0,0
8309,2019-03-08,1139,0,1139,91,1230,1230,0,0
8310,2019-03-08,204,0,204,16,220,220,0,0
8311,2019-03-08,731,0,731,49,780,780,0,0
8312,2019-03-08,232,0,232,18,250,250,0,0
8313,2019-03-08,723,0,723,57,780,780,0,0
8314,2019-03-08,315,0,315,25,340,340,0,0
8315,2019-03-08,1112,0,1112,88,1200,1200,0,0
8316,2019-03-08,1038,0,1038,82,1120,1120,0,0
8317,2019-03-08,639,0,639,51,690,690,0,0
8318,2019-03-08,1373,0,1373,109,1482,1482,0,0
8319,2019-03-08,398,0,398,22,420,420,0,0
8320,2019-03-08,491,0,491,39,530,530,0,0
8321,2019-03-08,1065,0,1065,85,1150,1150,0,0
8322,2019-03-08,1315,0,1315,105,1420,1420,0,0
8323,2019-03-08,260,0,260,20,280,280,0,0
8324,2019-03-08,408,0,408,32,440,440,0,0
8325,2019-03-08,2038,0,2038,162,2200,2200,0,0
8326,2019-03-08,575,0,575,45,620,620,0,0
8327,2019-03-08,954,0,954,76,1030,1030,0,0
8328,2019-03-08,334,0,334,26,360,360,0,0
8329,2019-03-08,436,0,436,34,470,470,0,0
8330,2019-03-08,445,0,445,35,480,480,0,0
8331,2019-03-08,2788,0,2788,222,3010,3010,0,0
8332,2019-03-08,232,0,232,18,250,250,0,0
8333,2019-03-08,1815,0,1815,145,1960,1960,0,0
8334,2019-03-08,871,0,871,69,940,940,0,0
8335,2019-03-08,695,0,695,55,750,750,0,0
8336,2019-03-08,186,0,186,14,200,200,0,0
8337,2019-03-08,2129,0,2129,161,2290,2290,0,0
8338,2019-03-08,1278,0,1278,102,1380,1380,0,0
8339,2019-03-08,528,0,528,42,570,570,0,0
8340,2019-03-08,815,0,815,65,880,880,0,0
8341,2019-03-08,2056,0,2056,164,2220,2220,0,0
8342,2019-03-08,1024,0,1024,81,1105,1105,0,0
8343,2019-03-08,121,0,121,9,130,130,0,0
8344,2019-03-08,399,0,399,31,430,430,0,0
8345,2019-03-08,695,0,695,55,750,750,0,0
8346,2019-03-08,1491,0,1491,119,1610,1610,0,0
8347,2019-03-08,519,0,519,41,560,0,560,0
8348,2019-03-08,362,0,362,28,390,390,0,0
8349,2019-03-08,167,0,167,13,180,180,0,0
8350,2019-03-08,389,0,389,31,420,420,0,0
8351,2019-03-08,297,0,297,23,320,320,0,0
8352,2019-03-08,232,0,232,18,250,250,0,0
8353,2019-03-08,306,0,306,24,330,330,0,0
8354,2019-03-08,232,0,232,18,250,250,0,0
8355,2019-03-08,236,-50,186,14,200,200,0,0
8356,2019-03-08,236,-50,186,14,200,200,0,0
8357,2019-03-08,612,0,612,48,660,660,0,0
8358,2019-03-08,843,0,843,67,910,910,0,0
8359,2019-03-08,491,0,491,39,530,530,0,0
8360,2019-03-08,788,0,788,62,850,850,0,0
8361,2019-03-08,667,0,667,53,720,720,0,0
8362,2019-03-08,116,0,116,9,125,125,0,0
8363,2019-03-08,1861,0,1861,139,2000,2000,0,0
8364,2019-03-08,422,0,422,33,455,455,0,0
8365,2019-03-08,953,0,953,67,1020,1020,0,0
8366,2019-03-08,288,0,288,22,310,310,0,0
8367,2019-03-08,408,0,408,32,440,440,0,0
8368,2019-03-08,852,0,852,68,920,920,0,0
8369,2019-03-08,445,0,445,35,480,480,0,0
8370,2019-03-08,149,0,149,11,160,160,0,0
8371,2019-03-08,2547,0,2547,203,2750,2750,0,0
8372,2019-03-08,871,0,871,69,940,940,0,0
8373,2019-03-08,213,0,213,17,230,230,0,0
8374,2019-03-08,260,0,260,20,280,280,0,0
8375,2019-03-08,315,0,315,25,340,340,0,0
8376,2019-03-08,334,0,334,26,360,360,0,0
8377,2019-03-08,556,0,556,44,600,600,0,0
8378,2019-03-08,389,0,389,31,420,420,0,0
8379,2019-03-08,463,0,463,37,500,500,0,0
8380,2019-03-08,519,0,519,41,560,560,0,0
8381,2019-03-08,389,0,389,31,420,420,0,0
8382,2019-03-08,510,0,510,40,550,550,0,0
8383,2019-03-08,306,0,306,24,330,330,0,0
8384,2019-03-08,232,0,232,18,250,250,0,0
8385,2019-03-08,1001,0,1001,79,1080,1080,0,0
8386,2019-03-08,362,0,362,28,390,390,0,0
8387,2019-03-08,1195,0,1195,95,1290,0,1290,0
8388,2019-03-08,936,0,936,74,1010,1010,0,0
8389,2019-03-08,741,0,741,59,800,800,0,0
8390,2019-03-08,2130,0,2130,170,2300,2300,0,0
8391,2019-03-08,741,0,741,59,800,800,0,0
8392,2019-03-08,741,0,741,59,800,800,0,0
8393,2019-03-08,1852,0,1852,148,2000,0,2000,0
8394,2019-03-08,1426,0,1426,114,1540,1540,0,0
8395,2019-03-08,732,0,732,58,790,790,0,0
8396,2019-03-08,371,0,371,29,400,400,0,0
8397,2019-03-08,797,0,797,63,860,860,0,0
8398,2019-03-08,462,0,462,28,490,490,0,0
8399,2019-03-08,306,0,306,24,330,330,0,0
8400,2019-03-08,1575,0,1575,125,1700,1700,0,0
8401,2019-03-08,2047,0,2047,163,2210,2210,0,0
8402,2019-03-08,1084,0,1084,86,1170,1170,0,0
8403,2019-03-08,371,0,371,29,400,400,0,0
8404,2019-03-08,889,0,889,71,960,960,0,0
8405,2019-03-08,612,0,612,48,660,660,0,0
8406,2019-03-08,538,0,538,42,580,580,0,0
8407,2019-03-08,1482,0,1482,118,1600,1600,0,0
8408,2019-03-08,3204,0,3204,256,3460,3460,0,0
8409,2019-03-08,1306,0,1306,104,1410,1410,0,0
8410,2019-03-08,639,0,639,51,690,690,0,0
8411,2019-03-08,1852,0,1852,148,2000,2000,0,0
8412,2019-03-08,306,0,306,24,330,330,0,0
8413,2019-03-08,788,0,788,62,850,850,0,0
8414,2019-03-08,1575,0,1575,125,1700,1700,0,0
8415,2019-03-08,815,0,815,65,880,880,0,0
8416,2019-03-08,491,0,491,39,530,530,0,0
8417,2019-03-08,2297,0,2297,183,2480,2480,0,0
8418,2019-03-08,954,0,954,76,1030,1030,0,0
8419,2019-03-08,639,0,639,51,690,690,0,0
8420,2019-03-08,575,0,575,45,620,620,0,0
8421,2019-03-08,788,0,788,62,850,850,0,0
8422,2019-03-08,751,0,751,59,810,810,0,0
8423,2019-03-08,676,0,676,54,730,730,0,0
8424,2019-03-08,463,0,463,37,500,500,0,0
8425,2019-03-08,2362,0,2362,188,2550,2550,0,0
8426,2019-03-08,676,0,676,54,730,730,0,0
8427,2019-03-08,325,0,325,25,350,350,0,0
8428,2019-03-08,1575,0,1575,125,1700,1700,0,0
8429,2019-03-08,667,0,667,53,720,720,0,0
8430,2019-03-08,788,0,788,62,850,850,0,0
8431,2019-03-08,2362,0,2362,188,2550,2550,0,0
8432,2019-03-08,788,0,788,62,850,850,0,0
8433,2019-03-09,1011,-18,993,79,1072,1072,0,0
8434,2019-03-09,417,0,417,33,450,450,0,0
8435,2019-03-09,1065,0,1065,85,1150,1150,0,0
8436,2019-03-09,1528,0,1528,122,1650,1650,0,0
8437,2019-03-09,285,0,285,22,307,307,0,0
8438,2019-03-09,2204,0,2204,176,2380,0,2380,0
8439,2019-03-09,417,0,417,33,450,450,0,0
8440,2019-03-09,1130,0,1130,90,1220,1220,0,0
8441,2019-03-09,612,0,612,48,660,660,0,0
8442,2019-03-09,1010,0,1010,80,1090,1090,0,0
8443,2019-03-09,769,0,769,61,830,830,0,0
8444,2019-03-09,260,0,260,20,280,280,0,0
8445,2019-03-09,1630,0,1630,130,1760,1760,0,0
8446,2019-03-09,1195,0,1195,95,1290,1290,0,0
8447,2019-03-09,463,0,463,37,500,500,0,0
8448,2019-03-09,315,0,315,25,340,340,0,0
8449,2019-03-09,1815,0,1815,145,1960,0,1960,0
8450,2019-03-09,278,0,278,22,300,300,0,0
8451,2019-03-09,1815,0,1815,145,1960,1960,0,0
8452,2019-03-09,519,0,519,41,560,560,0,0
8453,2019-03-09,232,0,232,18,250,250,0,0
8454,2019-03-09,2269,0,2269,181,2450,2450,0,0
8455,2019-03-09,713,0,713,57,770,770,0,0
8456,2019-03-09,1815,0,1815,145,1960,1960,0,0
8457,2019-03-09,612,0,612,48,660,660,0,0
8458,2019-03-09,417,0,417,33,450,450,0,0
8459,2019-03-09,926,0,926,74,1000,1000,0,0
8460,2019-03-09,1609,0,1609,111,1720,1720,0,0
8461,2019-03-09,1139,0,1139,91,1230,1230,0,0
8462,2019-03-09,362,0,362,28,390,390,0,0
8463,2019-03-09,1630,0,1630,130,1760,1760,0,0
8464,2019-03-09,547,0,547,43,590,590,0,0
8465,2019-03-09,2038,0,2038,162,2200,2200,0,0
8466,2019-03-09,510,0,510,40,550,550,0,0
8467,2019-03-09,1482,0,1482,118,1600,1600,0,0
8468,2019-03-09,399,0,399,31,430,430,0,0
8469,2019-03-09,278,0,278,22,300,300,0,0
8470,2019-03-09,1019,0,1019,81,1100,1100,0,0
8471,2019-03-09,380,0,380,30,410,410,0,0
8472,2019-03-09,315,0,315,25,340,340,0,0
8473,2019-03-09,769,0,769,61,830,830,0,0
8474,2019-03-09,315,0,315,25,340,340,0,0
8475,2019-03-09,908,0,908,72,980,980,0,0
8476,2019-03-09,1713,0,1713,137,1850,0,1850,0
8477,2019-03-09,306,0,306,24,330,330,0,0
8478,2019-03-09,584,0,584,46,630,630,0,0
8479,2019-03-09,908,0,908,72,980,980,0,0
8480,2019-03-09,732,0,732,58,790,0,790,0
8481,2019-03-09,908,0,908,72,980,980,0,0
8482,2019-03-09,713,0,713,57,770,0,770,0
8483,2019-03-09,945,0,945,75,1020,1020,0,0
8484,2019-03-09,806,0,806,64,870,870,0,0
8485,2019-03-09,1463,0,1463,117,1580,1580,0,0
8486,2019-03-09,584,0,584,46,630,630,0,0
8487,2019-03-09,278,0,278,22,300,300,0,0
8488,2019-03-09,806,0,806,64,870,870,0,0
8489,2019-03-09,538,0,538,42,580,580,0,0
8490,2019-03-09,547,0,547,43,590,590,0,0
8491,2019-03-09,630,0,630,50,680,680,0,0
8492,2019-03-09,741,0,741,59,800,800,0,0
8493,2019-03-09,269,0,269,21,290,290,0,0
8494,2019-03-09,102,0,102,8,110,110,0,0
8495,2019-03-09,167,0,167,13,180,180,0,0
8496,2019-03-09,2038,0,2038,162,2200,2200,0,0
8497,2019-03-09,639,0,639,51,690,690,0,0
8498,2019-03-09,306,0,306,24,330,330,0,0
8499,2019-03-09,760,0,760,60,820,820,0,0
8500,2019-03-09,278,0,278,22,300,300,0,0
8501,2019-03-09,954,0,954,76,1030,1030,0,0
8502,2019-03-09,223,0,223,17,240,240,0,0
8503,2019-03-09,278,0,278,22,300,300,0,0
8504,2019-03-09,908,0,908,72,980,980,0,0
8505,2019-03-09,704,0,704,56,760,760,0,0
8506,2019-03-09,408,0,408,32,440,440,0,0
8507,2019-03-09,1815,0,1815,145,1960,1960,0,0
8508,2019-03-09,1204,0,1204,96,1300,1300,0,0
8509,2019-03-09,352,0,352,28,380,380,0,0
8510,2019-03-09,2852,0,2852,228,3080,3080,0,0
8511,2019-03-09,232,0,232,18,250,250,0,0
8512,2019-03-09,1815,0,1815,145,1960,1960,0,0
8513,2019-03-09,1149,0,1149,91,1240,1240,0,0
8514,2019-03-09,908,0,908,72,980,980,0,0
8515,2019-03-09,908,0,908,72,980,980,0,0
8516,2019-03-09,2362,0,2362,188,2550,2550,0,0
8517,2019-03-09,825,0,825,65,890,890,0,0
8518,2019-03-09,686,0,686,54,740,740,0,0
8519,2019-03-09,825,0,825,65,890,890,0,0
8520,2019-03-09,278,0,278,22,300,0,300,0
8521,2019-03-09,325,0,325,25,350,350,0,0
8522,2019-03-09,2917,0,2917,233,3150,3150,0,0
8523,2019-03-09,556,0,556,44,600,600,0,0
8524,2019-03-09,362,0,362,28,390,390,0,0
8525,2019-03-09,713,0,713,57,770,770,0,0
8526,2019-03-09,954,0,954,76,1030,1030,0,0
8527,2019-03-09,658,0,658,52,710,710,0,0
8528,2019-03-09,1399,0,1399,111,1510,1510,0,0
8529,2019-03-09,489,0,489,21,510,510,0,0
8530,2019-03-09,260,0,260,20,280,280,0,0
8531,2019-03-09,1010,0,1010,80,1090,1090,0,0
8532,2019-03-09,741,0,741,59,800,800,0,0
8533,2019-03-09,417,0,417,33,450,450,0,0
8534,2019-03-09,334,0,334,26,360,360,0,0
8535,2019-03-09,371,0,371,29,400,400,0,0
8536,2019-03-09,417,0,417,33,450,450,0,0
8537,2019-03-09,445,0,445,35,480,480,0,0
8538,2019-03-09,519,0,519,41,560,560,0,0
8539,2019-03-09,102,0,102,8,110,110,0,0
8540,2019-03-09,334,0,334,26,360,360,0,0
8541,2019-03-09,232,0,232,18,250,250,0,0
8542,2019-03-09,139,0,139,11,150,150,0,0
8543,2019-03-09,343,0,343,27,370,370,0,0
8544,2019-03-09,112,0,112,8,120,120,0,0
8545,2019-03-09,139,0,139,11,150,150,0,0
8546,2019-03-09,283,0,283,22,305,305,0,0
8547,2019-03-09,538,0,538,42,580,580,0,0
8548,2019-03-09,463,0,463,37,500,500,0,0
8549,2019-03-09,232,0,232,18,250,250,0,0
8550,2019-03-09,269,0,269,21,290,290,0,0
8551,2019-03-09,1213,0,1213,97,1310,1310,0,0
8552,2019-03-09,371,0,371,29,400,400,0,0
8553,2019-03-09,825,0,825,65,890,890,0,0
8554,2019-03-09,760,0,760,60,820,820,0,0
8555,2019-03-09,445,0,445,35,480,480,0,0
8556,2019-03-09,547,0,547,43,590,590,0,0
8557,2019-03-09,1213,0,1213,97,1310,1310,0,0
8558,2019-03-09,1056,0,1056,84,1140,1140,0,0
8559,2019-03-09,649,0,649,51,700,700,0,0
8560,2019-03-09,639,0,639,51,690,690,0,0
8561,2019-03-09,250,0,250,20,270,270,0,0
8562,2019-03-09,1547,0,1547,123,1670,0,1670,0
8563,2019-03-09,982,0,982,78,1060,1060,0,0
8564,2019-03-09,278,0,278,22,300,300,0,0
8565,2019-03-09,880,0,880,70,950,950,0,0
8566,2019-03-09,269,0,269,21,290,290,0,0
8567,2019-03-09,649,0,649,51,700,700,0,0
8568,2019-03-09,935,0,935,65,1000,1000,0,0
8569,2019-03-09,408,0,408,32,440,440,0,0
8570,2019-03-09,139,0,139,11,150,150,0,0
8571,2019-03-09,473,0,473,37,510,510,0,0
8572,2019-03-09,334,0,334,26,360,360,0,0
8573,2019-03-09,371,0,371,29,400,400,0,0
8574,2019-03-09,788,0,788,62,850,850,0,0
8575,2019-03-09,528,0,528,42,570,570,0,0
8576,2019-03-09,501,0,501,39,540,540,0,0
8577,2019-03-09,510,0,510,40,550,550,0,0
8578,2019-03-09,1954,0,1954,156,2110,2110,0,0
8579,2019-03-09,362,0,362,28,390,390,0,0
8580,2019-03-09,473,0,473,37,510,510,0,0
8581,2019-03-09,56,0,56,4,60,60,0,0
8582,2019-03-09,538,0,538,42,580,580,0,0
8583,2019-03-09,1306,0,1306,104,1410,1410,0,0
8584,2019-03-09,1213,0,1213,97,1310,1310,0,0
8585,2019-03-09,686,0,686,54,740,740,0,0
8586,2019-03-09,1047,0,1047,83,1130,1130,0,0
8587,2019-03-09,306,0,306,24,330,330,0,0
8588,2019-03-09,676,0,676,54,730,730,0,0
8589,2019-03-09,1575,0,1575,125,1700,0,1700,0
8590,2019-03-09,612,0,612,48,660,660,0,0
8591,2019-03-09,167,0,167,13,180,180,0,0
8592,2019-03-09,1186,0,1186,94,1280,0,1280,0
8593,2019-03-09,584,0,584,46,630,630,0,0
8594,2019-03-09,1075,0,1075,85,1160,0,1160,0
8595,2019-03-09,538,0,538,42,580,580,0,0
8596,2019-03-09,306,0,306,24,330,330,0,0
8597,2019-03-09,602,0,602,48,650,650,0,0
8598,2019-03-09,841,0,841,49,890,890,0,0
8599,2019-03-09,2001,0,2001,159,2160,2160,0,0
8600,2019-03-09,278,0,278,22,300,300,0,0
8601,2019-03-09,232,0,232,18,250,250,0,0
8602,2019-03-09,232,0,232,18,250,0,250,0
8603,2019-03-09,269,0,269,21,290,290,0,0
8604,2019-03-09,463,0,463,37,500,500,0,0
8605,2019-03-09,1963,0,1963,157,2120,2120,0,0
8606,2019-03-09,2371,0,2371,189,2560,2560,0,0
8607,2019-03-09,306,0,306,24,330,330,0,0
8608,2019-03-09,297,0,297,23,320,320,0,0
8609,2019-03-09,250,0,250,20,270,270,0,0
8610,2019-03-09,1278,0,1278,102,1380,1380,0,0
8611,2019-03-09,788,0,788,62,850,850,0,0
8612,2019-03-09,806,0,806,64,870,870,0,0
8613,2019-03-09,788,0,788,62,850,850,0,0
8614,2019-03-09,788,0,788,62,850,850,0,0
8615,2019-03-09,1575,0,1575,125,1700,1700,0,0
8616,2019-03-09,1575,0,1575,125,1700,1700,0,0
8617,2019-03-09,556,0,556,44,600,600,0,0
8618,2019-03-09,788,0,788,62,850,850,0,0
8619,2019-03-09,1195,0,1195,95,1290,1290,0,0
8620,2019-03-09,788,0,788,62,850,850,0,0
8621,2019-03-09,1444,0,1444,106,1550,1550,0,0
8622,2019-03-09,1575,0,1575,125,1700,1700,0,0
8623,2019-03-09,2130,0,2130,170,2300,2300,0,0
8624,2019-03-09,473,0,473,37,510,510,0,0
8625,2019-03-09,1213,0,1213,97,1310,1310,0,0
8626,2019-03-09,1417,0,1417,113,1530,1530,0,0
8627,2019-03-09,1575,0,1575,125,1700,1700,0,0
8628,2019-03-09,899,0,899,71,970,970,0,0
8629,2019-03-10,778,0,778,62,840,840,0,0
8630,2019-03-10,278,0,278,22,300,300,0,0
8631,2019-03-10,584,0,584,46,630,630,0,0
8632,2019-03-10,1121,0,1121,89,1210,1210,0,0
8633,2019-03-10,176,0,176,14,190,190,0,0
8634,2019-03-10,297,0,297,23,320,320,0,0
8635,2019-03-10,1241,0,1241,99,1340,1340,0,0
8636,2019-03-10,1102,0,1102,88,1190,0,1190,0
8637,2019-03-10,778,0,778,62,840,840,0,0
8638,2019-03-10,1491,0,1491,119,1610,1610,0,0
8639,2019-03-10,102,0,102,8,110,110,0,0
8640,2019-03-10,1047,0,1047,83,1130,1130,0,0
8641,2019-03-10,658,0,658,52,710,710,0,0
8642,2019-03-10,621,0,621,49,670,670,0,0
8643,2019-03-10,565,0,565,45,610,610,0,0
8644,2019-03-10,713,0,713,57,770,770,0,0
8645,2019-03-10,704,0,704,56,760,760,0,0
8646,2019-03-10,908,0,908,72,980,980,0,0
8647,2019-03-10,908,0,908,72,980,980,0,0
8648,2019-03-10,908,0,908,72,980,980,0,0
8649,2019-03-10,695,0,695,55,750,750,0,0
8650,2019-03-10,315,0,315,25,340,340,0,0
8651,2019-03-10,788,0,788,62,850,850,0,0
8652,2019-03-10,334,0,334,26,360,360,0,0
8653,2019-03-10,408,0,408,32,440,440,0,0
8654,2019-03-10,371,0,371,29,400,400,0,0
8655,2019-03-10,371,0,371,29,400,400,0,0
8656,2019-03-10,778,0,778,62,840,840,0,0
8657,2019-03-10,491,0,491,39,530,530,0,0
8658,2019-03-10,371,0,371,29,400,400,0,0
8659,2019-03-10,371,0,371,29,400,400,0,0
8660,2019-03-10,2723,0,2723,217,2940,2940,0,0
8661,2019-03-10,491,0,491,39,530,530,0,0
8662,2019-03-10,593,0,593,47,640,640,0,0
8663,2019-03-10,176,0,176,14,190,190,0,0
8664,2019-03-10,121,0,121,9,130,130,0,0
8665,2019-03-10,834,0,834,66,900,900,0,0
8666,2019-03-10,908,0,908,72,980,980,0,0
8667,2019-03-10,1485,-159,1326,105,1431,1431,0,0
8668,2019-03-10,417,0,417,33,450,450,0,0
8669,2019-03-10,426,0,426,34,460,460,0,0
8670,2019-03-10,181,0,181,14,195,195,0,0
8671,2019-03-10,416,0,416,24,440,440,0,0
8672,2019-03-10,306,0,306,24,330,330,0,0
8673,2019-03-10,1445,0,1445,115,1560,1560,0,0
8674,2019-03-10,1815,0,1815,145,1960,1960,0,0
8675,2019-03-10,315,0,315,25,340,340,0,0
8676,2019-03-10,862,0,862,68,930,930,0,0
8677,2019-03-10,454,0,454,36,490,490,0,0
8678,2019-03-10,334,0,334,26,360,360,0,0
8679,2019-03-10,463,0,463,37,500,500,0,0
8680,2019-03-10,371,0,371,29,400,400,0,0
8681,2019-03-10,649,0,649,51,700,700,0,0
8682,2019-03-10,371,0,371,29,400,400,0,0
8683,2019-03-10,1075,0,1075,85,1160,1160,0,0
8684,2019-03-10,1288,0,1288,102,1390,0,1390,0
8685,2019-03-10,843,0,843,67,910,910,0,0
8686,2019-03-10,260,0,260,20,280,280,0,0
8687,2019-03-10,1538,0,1538,122,1660,1660,0,0
8688,2019-03-10,139,0,139,11,150,150,0,0
8689,2019-03-10,1621,0,1621,129,1750,1750,0,0
8690,2019-03-10,269,0,269,21,290,290,0,0
8691,2019-03-10,232,0,232,18,250,250,0,0
8692,2019-03-10,602,0,602,48,650,650,0,0
8693,2019-03-10,695,0,695,55,750,750,0,0
8694,2019-03-10,362,0,362,28,390,390,0,0
8695,2019-03-10,788,0,788,62,850,850,0,0
8696,2019-03-10,167,0,167,13,180,0,180,0
8697,2019-03-10,843,0,843,67,910,910,0,0
8698,2019-03-10,3352,0,3352,268,3620,3620,0,0
8699,2019-03-10,269,0,269,21,290,290,0,0
8700,2019-03-10,769,0,769,61,830,830,0,0
8701,2019-03-10,204,0,204,16,220,220,0,0
8702,2019-03-10,213,0,213,17,230,230,0,0
8703,2019-03-10,352,0,352,28,380,380,0,0
8704,2019-03-10,1139,0,1139,91,1230,0,1230,0
8705,2019-03-10,491,0,491,39,530,530,0,0
8706,2019-03-10,2639,0,2639,211,2850,2850,0,0
8707,2019-03-10,880,0,880,70,950,950,0,0
8708,2019-03-10,2019,0,2019,161,2180,2180,0,0
8709,2019-03-10,1575,0,1575,125,1700,1700,0,0
8710,2019-03-10,1723,0,1723,137,1860,0,1860,0
8711,2019-03-10,306,0,306,24,330,330,0,0
8712,2019-03-10,528,0,528,42,570,570,0,0
8713,2019-03-10,788,0,788,62,850,850,0,0
8714,2019-03-10,676,0,676,54,730,730,0,0
8715,2019-03-10,1232,0,1232,98,1330,1330,0,0
8716,2019-03-10,676,0,676,54,730,730,0,0
8717,2019-03-10,593,0,593,47,640,640,0,0
8718,2019-03-10,102,0,102,8,110,110,0,0
8719,2019-03-10,713,0,713,57,770,770,0,0
8720,2019-03-10,565,0,565,45,610,610,0,0
8721,2019-03-10,2065,0,2065,165,2230,2230,0,0
8722,2019-03-10,343,0,343,27,370,370,0,0
8723,2019-03-10,1056,0,1056,84,1140,1140,0,0
8724,2019-03-10,269,0,269,21,290,290,0,0
8725,2019-03-10,1334,0,1334,106,1440,1440,0,0
8726,2019-03-10,889,0,889,71,960,960,0,0
8727,2019-03-10,473,0,473,37,510,510,0,0
8728,2019-03-10,1575,0,1575,125,1700,0,1700,0
8729,2019-03-10,399,0,399,31,430,430,0,0
8730,2019-03-10,334,0,334,26,360,360,0,0
8731,2019-03-10,454,0,454,36,490,490,0,0
8732,2019-03-10,204,0,204,16,220,220,0,0
8733,2019-03-10,482,0,482,38,520,520,0,0
8734,2019-03-10,843,0,843,67,910,910,0,0
8735,2019-03-10,649,0,649,51,700,700,0,0
8736,2019-03-10,936,0,936,74,1010,1010,0,0
8737,2019-03-10,991,0,991,79,1070,0,1070,0
8738,2019-03-11,269,0,269,21,290,290,0,0
8739,2019-03-11,602,0,602,48,650,650,0,0
8740,2019-03-11,260,0,260,20,280,280,0,0
8741,2019-03-11,149,0,149,11,160,160,0,0
8742,2019-03-11,1213,0,1213,97,1310,1310,0,0
8743,2019-03-11,686,0,686,54,740,740,0,0
8744,2019-03-11,278,0,278,22,300,300,0,0
8745,2019-03-11,102,0,102,8,110,110,0,0
8746,2019-03-11,649,0,649,51,700,700,0,0
8747,2019-03-11,852,0,852,68,920,920,0,0
8748,2019-03-11,538,0,538,42,580,580,0,0
8749,2019-03-11,93,0,93,7,100,100,0,0
8750,2019-03-11,630,0,630,50,680,680,0,0
8751,2019-03-11,788,0,788,62,850,850,0,0
8752,2019-03-11,1815,0,1815,145,1960,1960,0,0
8753,2019-03-11,788,0,788,62,850,850,0,0
8754,2019-03-11,306,0,306,24,330,330,0,0
8755,2019-03-11,788,0,788,62,850,850,0,0
8756,2019-03-11,481,0,481,29,510,510,0,0
8757,2019-03-11,473,0,473,37,510,510,0,0
8758,2019-03-11,1815,0,1815,145,1960,1960,0,0
8759,2019-03-11,973,0,973,77,1050,1050,0,0
8760,2019-03-11,260,0,260,20,280,280,0,0
8761,2019-03-11,371,0,371,29,400,400,0,0
8762,2019-03-11,408,0,408,32,440,440,0,0
8763,2019-03-11,1815,0,1815,145,1960,1960,0,0
8764,2019-03-11,250,0,250,20,270,270,0,0
8765,2019-03-11,797,0,797,63,860,860,0,0
8766,2019-03-11,297,0,297,23,320,320,0,0
8767,2019-03-11,908,0,908,72,980,980,0,0
8768,2019-03-11,908,0,908,72,980,980,0,0
8769,2019-03-11,315,0,315,25,340,340,0,0
8770,2019-03-11,93,0,93,7,100,100,0,0
8771,2019-03-11,260,0,260,20,280,280,0,0
8772,2019-03-11,463,0,463,37,500,500,0,0
8773,2019-03-11,110,0,110,0,110,110,0,0
8774,2019-03-11,139,0,139,11,150,150,0,0
8775,2019-03-11,1815,0,1815,145,1960,1960,0,0
8776,2019-03-11,1760,0,1760,140,1900,1900,0,0
8777,2019-03-11,908,0,908,72,980,980,0,0
8778,2019-03-11,269,0,269,21,290,290,0,0
8779,2019-03-11,462,0,462,28,490,490,0,0
8780,2019-03-11,482,0,482,38,520,520,0,0
8781,2019-03-11,1556,0,1556,124,1680,1680,0,0
8782,2019-03-11,1084,0,1084,86,1170,1170,0,0
8783,2019-03-11,723,0,723,57,780,780,0,0
8784,2019-03-11,408,0,408,32,440,440,0,0
8785,2019-03-11,232,0,232,18,250,250,0,0
8786,2019-03-11,741,0,741,59,800,800,0,0
8787,2019-03-11,649,0,649,51,700,700,0,0
8788,2019-03-11,343,0,343,27,370,370,0,0
8789,2019-03-11,408,0,408,32,440,440,0,0
8790,2019-03-11,741,0,741,59,800,800,0,0
8791,2019-03-11,288,0,288,22,310,310,0,0
8792,2019-03-11,445,0,445,35,480,480,0,0
8793,2019-03-11,297,0,297,23,320,320,0,0
8794,2019-03-11,538,0,538,42,580,580,0,0
8795,2019-03-11,834,0,834,66,900,900,0,0
8796,2019-03-11,278,0,278,22,300,300,0,0
8797,2019-03-11,889,0,889,71,960,960,0,0
8798,2019-03-11,722,0,722,48,770,770,0,0
8799,2019-03-11,426,0,426,34,460,460,0,0
8800,2019-03-11,593,0,593,47,640,640,0,0
8801,2019-03-11,389,0,389,31,420,420,0,0
8802,2019-03-11,389,0,389,31,420,420,0,0
8803,2019-03-11,547,0,547,43,590,590,0,0
8804,2019-03-11,306,0,306,24,330,330,0,0
8805,2019-03-11,399,0,399,31,430,430,0,0
8806,2019-03-11,621,0,621,49,670,670,0,0
8807,2019-03-11,982,0,982,78,1060,1060,0,0
8808,2019-03-11,834,0,834,66,900,900,0,0
8809,2019-03-11,116,0,116,9,125,125,0,0
8810,2019-03-11,815,0,815,65,880,880,0,0
8811,2019-03-11,528,0,528,42,570,570,0,0
8812,2019-03-11,320,0,320,25,345,345,0,0
8813,2019-03-11,408,0,408,32,440,440,0,0
8814,2019-03-11,343,0,343,27,370,370,0,0
8815,2019-03-11,149,0,149,11,160,160,0,0
8816,2019-03-11,649,0,649,51,700,700,0,0
8817,2019-03-11,145,0,145,11,156,156,0,0
8818,2019-03-11,538,0,538,42,580,580,0,0
8819,2019-03-11,1251,0,1251,99,1350,1350,0,0
8820,2019-03-11,482,0,482,38,520,520,0,0
8821,2019-03-11,501,0,501,39,540,540,0,0
8822,2019-03-11,362,0,362,28,390,390,0,0
8823,2019-03-11,334,0,334,26,360,360,0,0
8824,2019-03-11,510,0,510,40,550,550,0,0
8825,2019-03-11,510,0,510,40,550,550,0,0
8826,2019-03-11,491,0,491,39,530,530,0,0
8827,2019-03-11,825,0,825,65,890,890,0,0
8828,2019-03-11,216,0,216,17,233,233,0,0
8829,2019-03-11,269,0,269,21,290,290,0,0
8830,2019-03-11,723,0,723,57,780,780,0,0
8831,2019-03-11,741,0,741,59,800,800,0,0
8832,2019-03-11,371,0,371,29,400,400,0,0
8833,2019-03-11,288,0,288,22,310,310,0,0
8834,2019-03-11,260,0,260,20,280,280,0,0
8835,2019-03-11,713,0,713,57,770,770,0,0
8836,2019-03-11,343,0,343,27,370,370,0,0
8837,2019-03-11,408,0,408,32,440,440,0,0
8838,2019-03-11,371,0,371,29,400,400,0,0
8839,2019-03-11,362,0,362,28,390,390,0,0
8840,2019-03-11,667,0,667,53,720,720,0,0
8841,2019-03-11,510,0,510,40,550,550,0,0
8842,2019-03-11,556,0,556,44,600,600,0,0
8843,2019-03-11,297,0,297,23,320,320,0,0
8844,2019-03-11,334,0,334,26,360,360,0,0
8845,2019-03-11,445,0,445,35,480,480,0,0
8846,2019-03-11,1621,0,1621,129,1750,1750,0,0
8847,2019-03-11,1056,0,1056,84,1140,1140,0,0
8848,2019-03-11,454,0,454,36,490,490,0,0
8849,2019-03-11,658,0,658,52,710,710,0,0
8850,2019-03-11,695,0,695,55,750,750,0,0
8851,2019-03-11,380,0,380,30,410,410,0,0
8852,2019-03-11,760,0,760,60,820,820,0,0
8853,2019-03-11,723,0,723,57,780,780,0,0
8854,2019-03-11,843,0,843,67,910,910,0,0
8855,2019-03-11,1482,0,1482,118,1600,1600,0,0
8856,2019-03-11,1107,0,1107,88,1195,1195,0,0
8857,2019-03-11,2778,0,2778,222,3000,3000,0,0
8858,2019-03-11,945,0,945,75,1020,1020,0,0
8859,2019-03-11,806,0,806,64,870,870,0,0
8860,2019-03-11,436,0,436,34,470,470,0,0
8861,2019-03-11,426,0,426,34,460,460,0,0
8862,2019-03-11,408,0,408,32,440,440,0,0
8863,2019-03-11,936,0,936,74,1010,1010,0,0
8864,2019-03-11,723,0,723,57,780,780,0,0
8865,2019-03-11,315,0,315,25,340,340,0,0
8866,2019-03-11,1084,0,1084,86,1170,1170,0,0
8867,2019-03-11,250,0,250,20,270,270,0,0
8868,2019-03-11,676,0,676,54,730,730,0,0
8869,2019-03-11,1436,0,1436,114,1550,1550,0,0
8870,2019-03-11,788,0,788,62,850,850,0,0
8871,2019-03-11,167,0,167,13,180,180,0,0
8872,2019-03-11,1417,0,1417,113,1530,1530,0,0
8873,2019-03-11,723,0,723,57,780,780,0,0
8874,2019-03-11,408,0,408,32,440,440,0,0
8875,2019-03-11,843,0,843,67,910,910,0,0
8876,2019-03-11,1602,0,1602,128,1730,1730,0,0
8877,2019-03-11,852,0,852,68,920,920,0,0
8878,2019-03-12,362,0,362,28,390,390,0,0
8879,2019-03-12,399,0,399,31,430,430,0,0
8880,2019-03-12,297,0,297,23,320,320,0,0
8881,2019-03-12,612,0,612,48,660,660,0,0
8882,2019-03-12,713,0,713,57,770,770,0,0
8883,2019-03-12,236,-50,186,14,200,200,0,0
8884,2019-03-12,352,0,352,28,380,380,0,0
8885,2019-03-12,1311,0,1311,104,1415,1415,0,0
8886,2019-03-12,593,0,593,47,640,640,0,0
8887,2019-03-12,269,0,269,21,290,290,0,0
8888,2019-03-12,463,0,463,37,500,500,0,0
8889,2019-03-12,1473,0,1473,117,1590,1590,0,0
8890,2019-03-12,408,0,408,32,440,440,0,0
8891,2019-03-12,269,0,269,21,290,290,0,0
8892,2019-03-12,251,0,251,19,270,270,0,0
8893,2019-03-12,315,0,315,25,340,340,0,0
8894,2019-03-12,452,0,452,18,470,470,0,0
8895,2019-03-12,454,0,454,36,490,490,0,0
8896,2019-03-12,232,0,232,18,250,250,0,0
8897,2019-03-12,121,0,121,9,130,130,0,0
8898,2019-03-12,666,0,666,44,710,710,0,0
8899,2019-03-12,491,0,491,39,530,530,0,0
8900,2019-03-12,278,0,278,22,300,300,0,0
8901,2019-03-13,825,0,825,65,890,890,0,0
8902,2019-03-13,575,0,575,45,620,620,0,0
8903,2019-03-13,2723,0,2723,217,2940,2940,0,0
8904,2019-03-13,1815,0,1815,145,1960,1960,0,0
8905,2019-03-13,204,0,204,16,220,220,0,0
8906,2019-03-13,1917,0,1917,153,2070,2070,0,0
8907,2019-03-13,593,0,593,47,640,640,0,0
8908,2019-03-13,667,0,667,53,720,720,0,0
8909,2019-03-13,223,0,223,17,240,240,0,0
8910,2019-03-13,1815,0,1815,145,1960,1960,0,0
8911,2019-03-13,788,0,788,62,850,850,0,0
8912,2019-03-13,314,0,314,16,330,330,0,0
8913,2019-03-13,1102,0,1102,88,1190,1190,0,0
8914,2019-03-13,908,0,908,72,980,980,0,0
8915,2019-03-13,592,0,592,38,630,630,0,0
8916,2019-03-13,751,0,751,59,810,810,0,0
8917,2019-03-13,1251,0,1251,99,1350,1350,0,0
8918,2019-03-13,343,0,343,27,370,370,0,0
8919,2019-03-13,889,0,889,71,960,960,0,0
8920,2019-03-13,899,0,899,71,970,970,0,0
8921,2019-03-13,889,0,889,71,960,960,0,0
8922,2019-03-13,1093,0,1093,87,1180,1180,0,0
8923,2019-03-13,834,0,834,66,900,900,0,0
8924,2019-03-13,388,0,388,22,410,410,0,0
8925,2019-03-13,797,0,797,63,860,860,0,0
8926,2019-03-13,325,0,325,25,350,350,0,0
8927,2019-03-13,778,0,778,62,840,840,0,0
8928,2019-03-13,343,0,343,27,370,370,0,0
8929,2019-03-13,121,0,121,9,130,130,0,0
8930,2019-03-13,139,0,139,11,150,150,0,0
8931,2019-03-13,1453,0,1453,107,1560,1560,0,0
8932,2019-03-13,1315,0,1315,105,1420,1420,0,0
8933,2019-03-13,1084,0,1084,86,1170,1170,0,0
8934,2019-03-13,1325,0,1325,105,1430,0,1430,0
8935,2019-03-13,149,0,149,11,160,160,0,0
8936,2019-03-13,213,0,213,17,230,230,0,0
8937,2019-03-13,1075,0,1075,85,1160,1160,0,0
8938,2019-03-13,889,0,889,71,960,960,0,0
8939,2019-03-13,1973,0,1973,157,2130,0,2130,0
8940,2019-03-13,612,0,612,48,660,660,0,0
8941,2019-03-13,399,0,399,31,430,430,0,0
8942,2019-03-13,908,0,908,72,980,980,0,0
8943,2019-03-13,501,0,501,39,540,540,0,0
8944,2019-03-13,825,0,825,65,890,890,0,0
8945,2019-03-13,1815,0,1815,145,1960,1960,0,0
8946,2019-03-13,806,0,806,64,870,870,0,0
8947,2019-03-13,2084,0,2084,166,2250,2250,0,0
8948,2019-03-13,278,0,278,22,300,300,0,0
8949,2019-03-13,676,0,676,54,730,730,0,0
8950,2019-03-13,2268,0,2268,172,2440,2440,0,0
8951,2019-03-13,1158,0,1158,92,1250,1250,0,0
8952,2019-03-13,555,0,555,35,590,590,0,0
8953,2019-03-13,538,0,538,42,580,580,0,0
8954,2019-03-13,1575,0,1575,125,1700,1700,0,0
8955,2019-03-13,232,0,232,18,250,250,0,0
8956,2019-03-13,388,0,388,22,410,410,0,0
8957,2019-03-13,1612,0,1612,128,1740,1740,0,0
8958,2019-03-13,1084,0,1084,86,1170,0,1170,0
8959,2019-03-13,575,0,575,45,620,620,0,0
8960,2019-03-13,1352,0,1352,108,1460,1460,0,0
8961,2019-03-13,713,0,713,57,770,770,0,0
8962,2019-03-13,519,0,519,41,560,560,0,0
8963,2019-03-13,436,0,436,34,470,470,0,0
8964,2019-03-13,260,0,260,20,280,280,0,0
8965,2019-03-13,491,0,491,39,530,530,0,0
8966,2019-03-13,491,0,491,39,530,530,0,0
8967,2019-03-13,630,0,630,50,680,680,0,0
8968,2019-03-13,1260,0,1260,100,1360,0,1360,0
8969,2019-03-13,788,0,788,62,850,850,0,0
8970,2019-03-13,788,0,788,62,850,850,0,0
8971,2019-03-13,528,0,528,42,570,570,0,0
8972,2019-03-13,1297,0,1297,103,1400,1400,0,0
8973,2019-03-13,538,0,538,42,580,580,0,0
8974,2019-03-13,325,0,325,25,350,350,0,0
8975,2019-03-13,3038,0,3038,242,3280,3280,0,0
8976,2019-03-13,639,0,639,51,690,690,0,0
8977,2019-03-13,584,0,584,46,630,630,0,0
8978,2019-03-13,565,0,565,45,610,610,0,0
8979,2019-03-13,445,0,445,35,480,480,0,0
8980,2019-03-13,1991,0,1991,159,2150,2150,0,0
8981,2019-03-13,463,0,463,37,500,500,0,0
8982,2019-03-13,389,0,389,31,420,420,0,0
8983,2019-03-13,908,0,908,72,980,980,0,0
8984,2019-03-13,1815,0,1815,145,1960,1960,0,0
8985,2019-03-13,260,0,260,20,280,280,0,0
8986,2019-03-13,1903,0,1903,152,2055,2055,0,0
8987,2019-03-13,908,0,908,72,980,980,0,0
8988,2019-03-13,417,0,417,33,450,450,0,0
8989,2019-03-13,769,0,769,61,830,830,0,0
8990,2019-03-13,843,0,843,67,910,910,0,0
8991,2019-03-13,204,0,204,16,220,220,0,0
8992,2019-03-13,649,0,649,51,700,700,0,0
8993,2019-03-13,908,0,908,72,980,980,0,0
8994,2019-03-13,908,0,908,72,980,980,0,0
8995,2019-03-13,519,0,519,41,560,560,0,0
8996,2019-03-13,806,0,806,64,870,870,0,0
8997,2019-03-13,417,0,417,33,450,450,0,0
8998,2019-03-13,788,0,788,62,850,850,0,0
8999,2019-03-14,1565,0,1565,125,1690,1690,0,0
9000,2019-03-14,1232,0,1232,98,1330,0,1330,0
9001,2019-03-14,204,0,204,16,220,220,0,0
9002,2019-03-14,306,0,306,24,330,330,0,0
9003,2019-03-14,936,0,936,74,1010,1010,0,0
9004,2019-03-14,686,0,686,54,740,740,0,0
9005,2019-03-14,556,0,556,44,600,600,0,0
9006,2019-03-14,1288,0,1288,102,1390,1390,0,0
9007,2019-03-14,510,0,510,40,550,550,0,0
9008,2019-03-14,499,0,499,31,530,530,0,0
9009,2019-03-14,260,0,260,20,280,280,0,0
9010,2019-03-14,629,0,629,41,670,670,0,0
9011,2019-03-14,908,0,908,72,980,980,0,0
9012,2019-03-14,399,0,399,31,430,430,0,0
9013,2019-03-14,481,0,481,29,510,510,0,0
9014,2019-03-14,639,0,639,51,690,690,0,0
9015,2019-03-14,565,0,565,45,610,610,0,0
9016,2019-03-14,547,0,547,43,590,590,0,0
9017,2019-03-14,1815,0,1815,145,1960,1960,0,0
9018,2019-03-14,436,0,436,34,470,470,0,0
9019,2019-03-14,806,0,806,64,870,870,0,0
9020,2019-03-14,232,0,232,18,250,250,0,0
9021,2019-03-14,286,0,286,14,300,300,0,0
9022,2019-03-14,501,0,501,39,540,540,0,0
9023,2019-03-14,1889,0,1889,151,2040,2040,0,0
9024,2019-03-14,482,0,482,38,520,520,0,0
9025,2019-03-14,575,0,575,45,620,620,0,0
9026,2019-03-14,1815,0,1815,145,1960,1960,0,0
9027,2019-03-14,380,0,380,30,410,410,0,0
9028,2019-03-14,713,0,713,57,770,770,0,0
9029,2019-03-14,538,0,538,42,580,580,0,0
9030,2019-03-14,362,0,362,28,390,390,0,0
9031,2019-03-14,621,0,621,49,670,670,0,0
9032,2019-03-14,288,0,288,22,310,310,0,0
9033,2019-03-14,908,0,908,72,980,980,0,0
9034,2019-03-14,501,0,501,39,540,540,0,0
9035,2019-03-14,1260,0,1260,100,1360,1360,0,0
9036,2019-03-14,232,0,232,18,250,250,0,0
9037,2019-03-14,1593,0,1593,127,1720,1720,0,0
9038,2019-03-14,1158,0,1158,92,1250,1250,0,0
9039,2019-03-14,533,0,533,42,575,575,0,0
9040,2019-03-14,1499,0,1499,111,1610,1610,0,0
9041,2019-03-14,399,0,399,31,430,430,0,0
9042,2019-03-14,723,0,723,57,780,780,0,0
9043,2019-03-14,297,0,297,23,320,320,0,0
9044,2019-03-14,1204,0,1204,96,1300,1300,0,0
9045,2019-03-14,954,0,954,76,1030,1030,0,0
9046,2019-03-14,501,0,501,39,540,540,0,0
9047,2019-03-14,343,0,343,27,370,370,0,0
9048,2019-03-14,352,0,352,28,380,380,0,0
9049,2019-03-14,908,0,908,72,980,980,0,0
9050,2019-03-14,908,0,908,72,980,980,0,0
9051,2019-03-14,278,0,278,22,300,300,0,0
9052,2019-03-14,482,0,482,38,520,520,0,0
9053,2019-03-14,1695,0,1695,135,1830,1830,0,0
9054,2019-03-14,908,0,908,72,980,980,0,0
9055,2019-03-14,1047,0,1047,83,1130,1130,0,0
9056,2019-03-14,1130,0,1130,90,1220,1220,0,0
9057,2019-03-14,788,0,788,62,850,850,0,0
9058,2019-03-14,788,0,788,62,850,850,0,0
9059,2019-03-14,538,0,538,42,580,580,0,0
9060,2019-03-14,167,0,167,13,180,180,0,0
9061,2019-03-14,269,0,269,21,290,290,0,0
9062,2019-03-14,278,0,278,22,300,300,0,0
9063,2019-03-14,139,0,139,11,150,150,0,0
9064,2019-03-14,2889,0,2889,231,3120,3120,0,0
9065,2019-03-14,482,0,482,38,520,520,0,0
9066,2019-03-14,334,0,334,26,360,360,0,0
9067,2019-03-14,232,0,232,18,250,250,0,0
9068,2019-03-14,216,0,216,17,233,233,0,0
9069,2019-03-14,639,0,639,51,690,690,0,0
9070,2019-03-14,371,0,371,29,400,400,0,0
9071,2019-03-14,408,0,408,32,440,440,0,0
9072,2019-03-14,426,0,426,34,460,460,0,0
9073,2019-03-14,880,0,880,70,950,950,0,0
9074,2019-03-14,676,0,676,54,730,730,0,0
9075,2019-03-14,158,0,158,12,170,170,0,0
9076,2019-03-14,759,0,759,51,810,810,0,0
9077,2019-03-14,149,0,149,11,160,160,0,0
9078,2019-03-14,899,0,899,71,970,970,0,0
9079,2019-03-14,260,0,260,20,280,280,0,0
9080,2019-03-14,1019,0,1019,81,1100,1100,0,0
9081,2019-03-14,436,0,436,34,470,470,0,0
9082,2019-03-14,908,0,908,72,980,980,0,0
9083,2019-03-14,593,0,593,47,640,640,0,0
9084,2019-03-14,1334,0,1334,106,1440,1440,0,0
9085,2019-03-14,556,0,556,44,600,600,0,0
9086,2019-03-14,788,0,788,62,850,850,0,0
9087,2019-03-14,788,0,788,62,850,850,0,0
9088,2019-03-14,908,0,908,72,980,980,0,0
9089,2019-03-14,982,0,982,78,1060,1060,0,0
9090,2019-03-14,695,0,695,55,750,750,0,0
9091,2019-03-14,426,0,426,34,460,460,0,0
9092,2019-03-14,1815,0,1815,145,1960,1960,0,0
9093,2019-03-14,445,0,445,35,480,480,0,0
9094,2019-03-14,963,0,963,77,1040,1040,0,0
9095,2019-03-14,212,0,212,8,220,220,0,0
9096,2019-03-14,426,0,426,34,460,460,0,0
9097,2019-03-14,330,-70,260,20,280,280,0,0
9098,2019-03-14,1204,0,1204,96,1300,1300,0,0
9099,2019-03-14,963,0,963,77,1040,1040,0,0
9100,2019-03-14,417,0,417,33,450,450,0,0
9101,2019-03-14,1176,0,1176,94,1270,1270,0,0
9102,2019-03-14,1371,0,1371,109,1480,1480,0,0
9103,2019-03-14,343,0,343,27,370,370,0,0
9104,2019-03-14,538,0,538,42,580,580,0,0
9105,2019-03-14,166,0,166,4,170,170,0,0
9106,2019-03-14,1926,0,1926,154,2080,2080,0,0
9107,2019-03-14,954,0,954,76,1030,1030,0,0
9108,2019-03-14,380,0,380,30,410,410,0,0
9109,2019-03-14,501,0,501,39,540,540,0,0
9110,2019-03-14,788,0,788,62,850,850,0,0
9111,2019-03-14,268,0,268,12,280,280,0,0
9112,2019-03-14,908,0,908,72,980,980,0,0
9113,2019-03-14,788,0,788,62,850,850,0,0
9114,2019-03-15,167,0,167,13,180,180,0,0
9115,2019-03-15,554,0,554,26,580,580,0,0
9116,2019-03-15,139,0,139,11,150,150,0,0
9117,2019-03-15,899,0,899,71,970,970,0,0
9118,2019-03-15,658,0,658,52,710,710,0,0
9119,2019-03-15,278,0,278,22,300,300,0,0
9120,2019-03-15,1815,0,1815,145,1960,1960,0,0
9121,2019-03-15,908,0,908,72,980,980,0,0
9122,2019-03-15,472,0,472,28,500,500,0,0
9123,2019-03-15,408,0,408,32,440,440,0,0
9124,2019-03-15,954,0,954,76,1030,1030,0,0
9125,2019-03-15,695,0,695,55,750,750,0,0
9126,2019-03-15,1815,0,1815,145,1960,1960,0,0
9127,2019-03-15,908,0,908,72,980,980,0,0
9128,2019-03-15,723,0,723,57,780,780,0,0
9129,2019-03-15,251,0,251,19,270,270,0,0
9130,2019-03-15,1149,0,1149,91,1240,1240,0,0
9131,2019-03-15,1139,0,1139,91,1230,1230,0,0
9132,2019-03-15,315,0,315,25,340,340,0,0
9133,2019-03-15,1490,0,1490,110,1600,1600,0,0
9134,2019-03-15,1223,0,1223,97,1320,1320,0,0
9135,2019-03-15,556,0,556,44,600,600,0,0
9136,2019-03-15,1047,0,1047,83,1130,1130,0,0
9137,2019-03-15,1454,0,1454,116,1570,1570,0,0
9138,2019-03-15,584,0,584,46,630,0,630,0
9139,2019-03-15,1251,0,1251,99,1350,1350,0,0
9140,2019-03-15,1815,0,1815,145,1960,1960,0,0
9141,2019-03-15,768,0,768,52,820,820,0,0
9142,2019-03-15,945,0,945,75,1020,1020,0,0
9143,2019-03-15,334,0,334,26,360,360,0,0
9144,2019-03-15,695,0,695,55,750,750,0,0
9145,2019-03-15,1463,0,1463,117,1580,1580,0,0
9146,2019-03-15,944,0,944,66,1010,1010,0,0
9147,2019-03-15,417,0,417,33,450,450,0,0
9148,2019-03-15,426,0,426,34,460,460,0,0
9149,2019-03-15,139,0,139,11,150,150,0,0
9150,2019-03-15,1815,0,1815,145,1960,1960,0,0
9151,2019-03-15,389,0,389,31,420,420,0,0
9152,2019-03-15,1112,0,1112,88,1200,1200,0,0
9153,2019-03-15,528,0,528,42,570,570,0,0
9154,2019-03-15,584,0,584,46,630,630,0,0
9155,2019-03-15,399,0,399,31,430,430,0,0
9156,2019-03-15,825,0,825,65,890,890,0,0
9157,2019-03-15,945,0,945,75,1020,1020,0,0
9158,2019-03-15,667,0,667,53,720,720,0,0
9159,2019-03-15,908,0,908,72,980,980,0,0
9160,2019-03-15,908,0,908,72,980,980,0,0
9161,2019-03-15,825,0,825,65,890,890,0,0
9162,2019-03-15,121,0,121,9,130,130,0,0
9163,2019-03-15,278,0,278,22,300,300,0,0
9164,2019-03-15,445,0,445,35,480,480,0,0
9165,2019-03-15,1054,0,1054,66,1120,1120,0,0
9166,2019-03-15,112,0,112,8,120,120,0,0
9167,2019-03-15,1084,0,1084,86,1170,1170,0,0
9168,2019-03-15,1815,0,1815,145,1960,1960,0,0
9169,2019-03-15,963,0,963,77,1040,1040,0,0
9170,2019-03-15,528,0,528,42,570,570,0,0
9171,2019-03-15,454,0,454,36,490,490,0,0
9172,2019-03-15,269,0,269,21,290,290,0,0
9173,2019-03-15,1214,-130,1084,86,1170,1170,0,0
9174,2019-03-15,584,0,584,46,630,630,0,0
9175,2019-03-15,797,0,797,63,860,860,0,0
9176,2019-03-15,343,0,343,27,370,370,0,0
9177,2019-03-15,371,0,371,29,400,400,0,0
9178,2019-03-15,510,0,510,40,550,550,0,0
9179,2019-03-15,952,0,952,58,1010,1010,0,0
9180,2019-03-15,862,0,862,68,930,930,0,0
9181,2019-03-15,352,0,352,28,380,380,0,0
9182,2019-03-15,278,0,278,22,300,300,0,0
9183,2019-03-15,1186,0,1186,94,1280,1280,0,0
9184,2019-03-15,2130,0,2130,170,2300,2300,0,0
9185,2019-03-15,788,0,788,62,850,850,0,0
9186,2019-03-15,612,0,612,48,660,660,0,0
9187,2019-03-15,649,0,649,51,700,700,0,0
9188,2019-03-15,1575,0,1575,125,1700,1700,0,0
9189,2019-03-15,788,0,788,62,850,850,0,0
9190,2019-03-15,788,0,788,62,850,850,0,0
9191,2019-03-15,1575,0,1575,125,1700,1700,0,0
9192,2019-03-15,1028,0,1028,82,1110,1110,0,0
9193,2019-03-15,788,0,788,62,850,850,0,0
9194,2019-03-15,3149,0,3149,251,3400,3400,0,0
9195,2019-03-15,788,0,788,62,850,850,0,0
9196,2019-03-15,269,0,269,21,290,290,0,0
9197,2019-03-15,652,0,652,52,704,704,0,0
9198,2019-03-15,1186,0,1186,94,1280,1280,0,0
9199,2019-03-15,538,0,538,42,580,580,0,0
9200,2019-03-15,871,0,871,69,940,940,0,0
9201,2019-03-15,232,0,232,18,250,250,0,0
9202,2019-03-15,797,0,797,63,860,860,0,0
9203,2019-03-15,1139,0,1139,91,1230,1230,0,0
9204,2019-03-15,815,0,815,65,880,880,0,0
9205,2019-03-15,982,0,982,78,1060,1060,0,0
9206,2019-03-15,278,0,278,22,300,300,0,0
9207,2019-03-15,862,0,862,68,930,930,0,0
9208,2019-03-15,315,0,315,25,340,340,0,0
9209,2019-03-15,1251,0,1251,99,1350,1350,0,0
9210,2019-03-15,149,0,149,11,160,160,0,0
9211,2019-03-15,306,0,306,24,330,330,0,0
9212,2019-03-15,389,0,389,31,420,420,0,0
9213,2019-03-15,777,0,777,53,830,830,0,0
9214,2019-03-15,260,0,260,20,280,280,0,0
9215,2019-03-15,2899,0,2899,231,3130,3130,0,0
9216,2019-03-15,510,0,510,40,550,550,0,0
9217,2019-03-15,788,0,788,62,850,850,0,0
9218,2019-03-15,908,0,908,72,980,980,0,0
9219,2019-03-15,908,0,908,72,980,980,0,0
9220,2019-03-15,445,0,445,35,480,480,0,0
9221,2019-03-15,176,0,176,14,190,190,0,0
9222,2019-03-15,1130,0,1130,90,1220,1220,0,0
9223,2019-03-15,788,0,788,62,850,850,0,0
9224,2019-03-15,491,0,491,39,530,530,0,0
9225,2019-03-15,47,0,47,3,50,50,0,0
9226,2019-03-15,1593,0,1593,127,1720,1720,0,0
9227,2019-03-15,1899,0,1899,151,2050,2050,0,0
9228,2019-03-15,269,0,269,21,290,290,0,0
9229,2019-03-15,1149,0,1149,91,1240,1240,0,0
9230,2019-03-15,788,0,788,62,850,850,0,0
9231,2019-03-15,139,0,139,11,150,150,0,0
9232,2019-03-15,788,0,788,62,850,850,0,0
9233,2019-03-15,139,0,139,11,150,150,0,0
9234,2019-03-15,538,0,538,42,580,580,0,0
9235,2019-03-15,630,0,630,50,680,680,0,0
9236,2019-03-15,389,0,389,31,420,420,0,0
9237,2019-03-15,630,0,630,50,680,680,0,0
9238,2019-03-15,445,0,445,35,480,480,0,0
9239,2019-03-15,704,0,704,56,760,760,0,0
9240,2019-03-15,852,0,852,68,920,920,0,0
9241,2019-03-15,251,0,251,19,270,270,0,0
9242,2019-03-15,649,0,649,51,700,700,0,0
9243,2019-03-15,565,0,565,45,610,610,0,0
9244,2019-03-15,1575,0,1575,125,1700,1700,0,0
9245,2019-03-15,315,0,315,25,340,340,0,0
9246,2019-03-15,602,0,602,48,650,650,0,0
9247,2019-03-16,1010,0,1010,80,1090,1090,0,0
9248,2019-03-16,686,0,686,54,740,740,0,0
9249,2019-03-16,149,0,149,11,160,160,0,0
9250,2019-03-16,2501,0,2501,199,2700,2700,0,0
9251,2019-03-16,556,0,556,44,600,600,0,0
9252,2019-03-16,510,0,510,40,550,550,0,0
9253,2019-03-16,1176,0,1176,94,1270,1270,0,0
9254,2019-03-16,334,0,334,26,360,360,0,0
9255,2019-03-16,306,0,306,24,330,330,0,0
9256,2019-03-16,871,0,871,69,940,0,940,0
9257,2019-03-16,527,0,527,33,560,560,0,0
9258,2019-03-16,1815,0,1815,145,1960,0,1960,0
9259,2019-03-16,963,0,963,77,1040,1040,0,0
9260,2019-03-16,1093,0,1093,87,1180,1180,0,0
9261,2019-03-16,1297,0,1297,103,1400,1400,0,0
9262,2019-03-16,1167,0,1167,93,1260,1260,0,0
9263,2019-03-16,260,0,260,20,280,280,0,0
9264,2019-03-16,2723,0,2723,217,2940,2940,0,0
9265,2019-03-16,399,0,399,31,430,430,0,0
9266,2019-03-16,269,0,269,21,290,290,0,0
9267,2019-03-16,277,0,277,13,290,290,0,0
9268,2019-03-16,269,0,269,21,290,290,0,0
9269,2019-03-16,871,0,871,69,940,940,0,0
9270,2019-03-16,1343,0,1343,107,1450,1450,0,0
9271,2019-03-16,639,0,639,51,690,690,0,0
9272,2019-03-16,953,0,953,67,1020,1020,0,0
9273,2019-03-16,1084,0,1084,86,1170,1170,0,0
9274,2019-03-16,1342,0,1342,98,1440,1440,0,0
9275,2019-03-16,917,0,917,73,990,990,0,0
9276,2019-03-16,1028,0,1028,82,1110,1110,0,0
9277,2019-03-16,908,0,908,72,980,980,0,0
9278,2019-03-16,1473,0,1473,117,1590,1590,0,0
9279,2019-03-16,399,0,399,31,430,430,0,0
9280,2019-03-16,926,0,926,74,1000,1000,0,0
9281,2019-03-16,676,0,676,54,730,730,0,0
9282,2019-03-16,1815,0,1815,145,1960,1960,0,0
9283,2019-03-16,186,0,186,14,200,200,0,0
9284,2019-03-16,713,0,713,57,770,770,0,0
9285,2019-03-16,510,0,510,40,550,550,0,0
9286,2019-03-16,269,0,269,21,290,290,0,0
9287,2019-03-16,269,0,269,21,290,290,0,0
9288,2019-03-16,269,0,269,21,290,290,0,0
9289,2019-03-16,815,0,815,65,880,880,0,0
9290,2019-03-16,3630,0,3630,290,3920,3920,0,0
9291,2019-03-16,362,0,362,28,390,390,0,0
9292,2019-03-16,1815,0,1815,145,1960,1960,0,0
9293,2019-03-16,232,0,232,18,250,250,0,0
9294,2019-03-16,1362,0,1362,108,1470,1470,0,0
9295,2019-03-16,1139,0,1139,91,1230,1230,0,0
9296,2019-03-16,139,0,139,11,150,150,0,0
9297,2019-03-16,870,0,870,60,930,930,0,0
9298,2019-03-16,269,0,269,21,290,290,0,0
9299,2019-03-16,649,0,649,51,700,700,0,0
9300,2019-03-16,371,0,371,29,400,400,0,0
9301,2019-03-16,778,0,778,62,840,840,0,0
9302,2019-03-16,251,0,251,19,270,270,0,0
9303,2019-03-16,315,0,315,25,340,340,0,0
9304,2019-03-16,519,0,519,41,560,560,0,0
9305,2019-03-16,139,0,139,11,150,150,0,0
9306,2019-03-16,445,0,445,35,480,480,0,0
9307,2019-03-16,565,0,565,45,610,610,0,0
9308,2019-03-16,371,0,371,29,400,400,0,0
9309,2019-03-16,315,0,315,25,340,340,0,0
9310,2019-03-16,1102,0,1102,88,1190,1190,0,0
9311,2019-03-16,5445,0,5445,435,5880,5880,0,0
9312,2019-03-16,760,0,760,60,820,820,0,0
9313,2019-03-16,454,0,454,36,490,490,0,0
9314,2019-03-16,538,0,538,42,580,580,0,0
9315,2019-03-16,538,0,538,42,580,580,0,0
9316,2019-03-16,1815,0,1815,145,1960,1960,0,0
9317,2019-03-16,380,0,380,30,410,0,410,0
9318,2019-03-16,454,0,454,36,490,490,0,0
9319,2019-03-16,1815,0,1815,145,1960,1960,0,0
9320,2019-03-16,621,0,621,49,670,670,0,0
9321,2019-03-16,306,0,306,24,330,330,0,0
9322,2019-03-16,528,0,528,42,570,570,0,0
9323,2019-03-16,2723,0,2723,217,2940,2940,0,0
9324,2019-03-16,362,0,362,28,390,390,0,0
9325,2019-03-16,991,0,991,79,1070,1070,0,0
9326,2019-03-16,1740,0,1740,130,1870,1870,0,0
9327,2019-03-16,491,0,491,39,530,530,0,0
9328,2019-03-16,908,0,908,72,980,980,0,0
9329,2019-03-16,495,0,495,39,534,534,0,0
9330,2019-03-16,315,0,315,25,340,340,0,0
9331,2019-03-16,306,0,306,24,330,330,0,0
9332,2019-03-16,473,0,473,37,510,510,0,0
9333,2019-03-16,1056,0,1056,84,1140,1140,0,0
9334,2019-03-16,371,0,371,29,400,400,0,0
9335,2019-03-16,1815,0,1815,145,1960,1960,0,0
9336,2019-03-16,1547,0,1547,123,1670,1670,0,0
9337,2019-03-16,343,0,343,27,370,370,0,0
9338,2019-03-16,944,0,944,66,1010,1010,0,0
9339,2019-03-16,501,0,501,39,540,540,0,0
9340,2019-03-16,899,0,899,71,970,970,0,0
9341,2019-03-16,501,0,501,39,540,540,0,0
9342,2019-03-16,565,0,565,45,610,610,0,0
9343,2019-03-16,676,0,676,54,730,730,0,0
9344,2019-03-16,593,0,593,47,640,640,0,0
9345,2019-03-16,815,0,815,65,880,880,0,0
9346,2019-03-16,352,0,352,28,380,380,0,0
9347,2019-03-16,723,0,723,57,780,780,0,0
9348,2019-03-16,380,0,380,30,410,410,0,0
9349,2019-03-16,315,0,315,25,340,340,0,0
9350,2019-03-16,2130,0,2130,170,2300,2300,0,0
9351,2019-03-16,2130,0,2130,170,2300,2300,0,0
9352,2019-03-16,917,0,917,73,990,990,0,0
9353,2019-03-16,630,0,630,50,680,680,0,0
9354,2019-03-16,1417,0,1417,113,1530,1530,0,0
9355,2019-03-16,1028,0,1028,82,1110,1110,0,0
9356,2019-03-16,1575,0,1575,125,1700,1700,0,0
9357,2019-03-16,788,0,788,62,850,850,0,0
9358,2019-03-16,723,0,723,57,780,780,0,0
9359,2019-03-16,788,0,788,62,850,850,0,0
9360,2019-03-16,843,0,843,67,910,910,0,0
9361,2019-03-16,686,0,686,54,740,740,0,0
9362,2019-03-16,371,0,371,29,400,400,0,0
9363,2019-03-16,926,0,926,74,1000,1000,0,0
9364,2019-03-16,528,0,528,42,570,570,0,0
9365,2019-03-16,1240,0,1240,90,1330,1330,0,0
9366,2019-03-16,260,0,260,20,280,280,0,0
9367,2019-03-16,334,0,334,26,360,360,0,0
9368,2019-03-16,176,0,176,14,190,190,0,0
9369,2019-03-16,1325,0,1325,105,1430,1430,0,0
9370,2019-03-16,843,0,843,67,910,910,0,0
9371,2019-03-16,1417,0,1417,113,1530,1530,0,0
9372,2019-03-16,1741,0,1741,139,1880,1880,0,0
9373,2019-03-16,463,0,463,37,500,500,0,0
9374,2019-03-16,278,0,278,22,300,300,0,0
9375,2019-03-16,260,0,260,20,280,280,0,0
9376,2019-03-16,1186,0,1186,94,1280,1280,0,0
9377,2019-03-16,936,0,936,74,1010,1010,0,0
9378,2019-03-16,797,0,797,63,860,860,0,0
9379,2019-03-16,389,0,389,31,420,420,0,0
9380,2019-03-16,371,0,371,29,400,400,0,0
9381,2019-03-16,482,0,482,38,520,520,0,0
9382,2019-03-16,1970,-211,1759,140,1899,1899,0,0
9383,2019-03-16,213,0,213,17,230,230,0,0
9384,2019-03-16,490,0,490,30,520,520,0,0
9385,2019-03-16,269,0,269,21,290,290,0,0
9386,2019-03-16,907,0,907,63,970,970,0,0
9387,2019-03-16,973,0,973,77,1050,0,1050,0
9388,2019-03-16,278,0,278,22,300,300,0,0
9389,2019-03-16,788,0,788,62,850,0,850,0
9390,2019-03-16,297,0,297,23,320,320,0,0
9391,2019-03-16,362,0,362,28,390,390,0,0
9392,2019-03-16,1542,0,1542,88,1630,1630,0,0
9393,2019-03-16,352,0,352,28,380,380,0,0
9394,2019-03-16,1499,0,1499,111,1610,1610,0,0
9395,2019-03-16,1547,0,1547,123,1670,1670,0,0
9396,2019-03-16,612,0,612,48,660,660,0,0
9397,2019-03-16,417,0,417,33,450,450,0,0
9398,2019-03-16,573,0,573,37,610,610,0,0
9399,2019-03-16,334,0,334,26,360,360,0,0
9400,2019-03-16,1575,0,1575,125,1700,1700,0,0
9401,2019-03-16,1065,0,1065,85,1150,1150,0,0
9402,2019-03-16,1797,0,1797,143,1940,1940,0,0
9403,2019-03-16,241,0,241,19,260,260,0,0
9404,2019-03-16,788,0,788,62,850,850,0,0
9405,2019-03-16,667,0,667,53,720,720,0,0
9406,2019-03-16,1547,0,1547,123,1670,1670,0,0
9407,2019-03-16,584,0,584,46,630,630,0,0
9408,2019-03-16,908,0,908,72,980,980,0,0
9409,2019-03-16,528,0,528,42,570,570,0,0
9410,2019-03-16,1167,0,1167,93,1260,1260,0,0
9411,2019-03-16,788,0,788,62,850,850,0,0
9412,2019-03-16,788,0,788,62,850,850,0,0
9413,2019-03-16,426,0,426,34,460,460,0,0
9414,2019-03-16,630,0,630,50,680,680,0,0
9415,2019-03-16,167,0,167,13,180,180,0,0
9416,2019-03-16,139,0,139,11,150,150,0,0
9417,2019-03-16,1575,0,1575,125,1700,0,1700,0
9418,2019-03-16,1482,0,1482,118,1600,1600,0,0
9419,2019-03-16,1575,0,1575,125,1700,1700,0,0
9420,2019-03-16,195,0,195,15,210,210,0,0
9421,2019-03-16,639,0,639,51,690,690,0,0
9422,2019-03-16,908,0,908,72,980,980,0,0
9423,2019-03-16,510,0,510,40,550,550,0,0
9424,2019-03-16,1575,0,1575,125,1700,1700,0,0
9425,2019-03-16,2038,0,2038,162,2200,2200,0,0
9426,2019-03-16,815,0,815,65,880,880,0,0
9427,2019-03-16,1575,0,1575,125,1700,1700,0,0
9428,2019-03-16,1204,0,1204,96,1300,1300,0,0
9429,2019-03-17,500,0,500,40,540,540,0,0
9430,2019-03-17,889,0,889,71,960,960,0,0
9431,2019-03-17,935,0,935,65,1000,1000,0,0
9432,2019-03-17,621,0,621,49,670,670,0,0
9433,2019-03-17,593,0,593,47,640,640,0,0
9434,2019-03-17,1638,0,1638,122,1760,0,1760,0
9435,2019-03-17,834,0,834,66,900,900,0,0
9436,2019-03-17,315,0,315,25,340,340,0,0
9437,2019-03-17,2722,0,2722,218,2940,2940,0,0
9438,2019-03-17,250,0,250,20,270,270,0,0
9439,2019-03-17,167,0,167,13,180,180,0,0
9440,2019-03-17,2723,0,2723,217,2940,2940,0,0
9441,2019-03-17,1314,0,1314,96,1410,1410,0,0
9442,2019-03-17,1426,0,1426,114,1540,1540,0,0
9443,2019-03-17,306,0,306,24,330,330,0,0
9444,2019-03-17,667,0,667,53,720,720,0,0
9445,2019-03-17,908,0,908,72,980,980,0,0
9446,2019-03-17,269,0,269,21,290,290,0,0
9447,2019-03-17,1010,0,1010,80,1090,1090,0,0
9448,2019-03-17,667,0,667,53,720,720,0,0
9449,2019-03-17,1463,0,1463,117,1580,1580,0,0
9450,2019-03-17,695,0,695,55,750,750,0,0
9451,2019-03-17,1399,0,1399,111,1510,0,1510,0
9452,2019-03-17,297,0,297,23,320,320,0,0
9453,2019-03-17,463,0,463,37,500,500,0,0
9454,2019-03-17,306,0,306,24,330,330,0,0
9455,2019-03-17,880,0,880,70,950,950,0,0
9456,2019-03-17,1815,0,1815,145,1960,1960,0,0
9457,2019-03-17,482,0,482,38,520,520,0,0
9458,2019-03-17,1010,0,1010,80,1090,1090,0,0
9459,2019-03-17,1260,0,1260,100,1360,1360,0,0
9460,2019-03-17,908,0,908,72,980,980,0,0
9461,2019-03-17,519,0,519,41,560,560,0,0
9462,2019-03-17,2723,0,2723,217,2940,2940,0,0
9463,2019-03-17,778,0,778,62,840,840,0,0
9464,2019-03-17,417,0,417,33,450,450,0,0
9465,2019-03-17,760,0,760,60,820,820,0,0
9466,2019-03-17,288,0,288,22,310,310,0,0
9467,2019-03-17,593,0,593,47,640,640,0,0
9468,2019-03-17,2149,0,2149,171,2320,2320,0,0
9469,2019-03-17,47,0,47,3,50,50,0,0
9470,2019-03-17,1815,0,1815,145,1960,1960,0,0
9471,2019-03-17,399,0,399,31,430,0,430,0
9472,2019-03-17,584,0,584,46,630,630,0,0
9473,2019-03-17,797,0,797,63,860,860,0,0
9474,2019-03-17,454,0,454,36,490,490,0,0
9475,2019-03-17,334,0,334,26,360,360,0,0
9476,2019-03-17,482,0,482,38,520,520,0,0
9477,2019-03-17,1000,0,1000,80,1080,1080,0,0
9478,2019-03-17,741,0,741,59,800,800,0,0
9479,2019-03-17,260,0,260,20,280,280,0,0
9480,2019-03-17,593,0,593,47,640,640,0,0
9481,2019-03-17,325,0,325,25,350,350,0,0
9482,2019-03-17,676,0,676,54,730,730,0,0
9483,2019-03-17,1047,0,1047,83,1130,1130,0,0
9484,2019-03-17,167,0,167,13,180,180,0,0
9485,2019-03-17,649,0,649,51,700,700,0,0
9486,2019-03-17,1065,0,1065,85,1150,1150,0,0
9487,2019-03-17,491,0,491,39,530,530,0,0
9488,2019-03-17,112,0,112,8,120,120,0,0
9489,2019-03-17,389,0,389,31,420,420,0,0
9490,2019-03-17,269,0,269,21,290,290,0,0
9491,2019-03-17,1139,0,1139,91,1230,1230,0,0
9492,2019-03-17,491,0,491,39,530,530,0,0
9493,2019-03-17,778,0,778,62,840,840,0,0
9494,2019-03-17,510,0,510,40,550,550,0,0
9495,2019-03-17,297,0,297,23,320,320,0,0
9496,2019-03-17,241,0,241,19,260,260,0,0
9497,2019-03-17,362,0,362,28,390,390,0,0
9498,2019-03-17,260,0,260,20,280,280,0,0
9499,2019-03-17,1815,0,1815,145,1960,1960,0,0
9500,2019-03-17,732,0,732,58,790,790,0,0
9501,2019-03-17,288,0,288,22,310,310,0,0
9502,2019-03-17,436,0,436,34,470,470,0,0
9503,2019-03-17,1019,0,1019,81,1100,1100,0,0
9504,2019-03-17,343,0,343,27,370,370,0,0
9505,2019-03-17,1815,0,1815,145,1960,1960,0,0
9506,2019-03-17,547,0,547,43,590,590,0,0
9507,2019-03-17,1602,0,1602,128,1730,1730,0,0
9508,2019-03-17,112,0,112,8,120,120,0,0
9509,2019-03-17,565,0,565,45,610,610,0,0
9510,2019-03-17,751,0,751,59,810,810,0,0
9511,2019-03-17,602,0,602,48,650,650,0,0
9512,2019-03-17,741,0,741,59,800,800,0,0
9513,2019-03-17,371,0,371,29,400,400,0,0
9514,2019-03-17,269,0,269,21,290,290,0,0
9515,2019-03-17,908,0,908,72,980,980,0,0
9516,2019-03-17,593,0,593,47,640,640,0,0
9517,2019-03-17,112,0,112,8,120,120,0,0
9518,2019-03-17,917,0,917,73,990,990,0,0
9519,2019-03-17,426,0,426,34,460,460,0,0
9520,2019-03-17,889,0,889,71,960,960,0,0
9521,2019-03-17,676,0,676,54,730,730,0,0
9522,2019-03-17,232,0,232,18,250,250,0,0
9523,2019-03-17,852,0,852,68,920,920,0,0
9524,2019-03-17,963,0,963,77,1040,1040,0,0
9525,2019-03-17,519,0,519,41,560,560,0,0
9526,2019-03-17,380,0,380,30,410,410,0,0
9527,2019-03-17,1213,0,1213,97,1310,1310,0,0
9528,2019-03-17,334,0,334,26,360,360,0,0
9529,2019-03-17,278,0,278,22,300,300,0,0
9530,2019-03-17,788,0,788,62,850,850,0,0
9531,2019-03-17,732,0,732,58,790,790,0,0
9532,2019-03-17,732,0,732,58,790,790,0,0
9533,2019-03-17,389,0,389,31,420,420,0,0
9534,2019-03-17,491,0,491,39,530,530,0,0
9535,2019-03-17,649,0,649,51,700,700,0,0
9536,2019-03-17,908,0,908,72,980,980,0,0
9537,2019-03-17,269,0,269,21,290,290,0,0
9538,2019-03-17,538,0,538,42,580,580,0,0
9539,2019-03-17,510,0,510,40,550,550,0,0
9540,2019-03-17,436,0,436,34,470,470,0,0
9541,2019-03-17,1973,0,1973,157,2130,2130,0,0
9542,2019-03-17,602,0,602,48,650,650,0,0
9543,2019-03-17,602,0,602,48,650,650,0,0
9544,2019-03-17,473,0,473,37,510,510,0,0
9545,2019-03-17,649,0,649,51,700,700,0,0
9546,2019-03-17,334,0,334,26,360,360,0,0
9547,2019-03-17,862,0,862,68,930,0,930,0
9548,2019-03-17,825,0,825,65,890,890,0,0
9549,2019-03-17,149,0,149,11,160,160,0,0
9550,2019-03-17,463,0,463,37,500,500,0,0
9551,2019-03-17,232,0,232,18,250,250,0,0
9552,2019-03-17,834,0,834,66,900,900,0,0
9553,2019-03-17,528,0,528,42,570,570,0,0
9554,2019-03-17,593,0,593,47,640,640,0,0
9555,2019-03-17,260,0,260,20,280,280,0,0
9556,2019-03-17,1399,0,1399,111,1510,0,1510,0
9557,2019-03-17,917,0,917,73,990,990,0,0
9558,2019-03-17,528,0,528,42,570,570,0,0
9559,2019-03-17,621,0,621,49,670,670,0,0
9560,2019-03-17,1899,0,1899,151,2050,2050,0,0
9561,2019-03-17,825,0,825,65,890,890,0,0
9562,2019-03-17,1112,0,1112,88,1200,1200,0,0
9563,2019-03-17,547,0,547,43,590,590,0,0
9564,2019-03-17,545,0,545,25,570,570,0,0
9565,2019-03-17,1130,0,1130,90,1220,1220,0,0
9566,2019-03-17,232,0,232,18,250,250,0,0
9567,2019-03-17,454,0,454,36,490,490,0,0
9568,2019-03-17,510,0,510,40,550,550,0,0
9569,2019-03-17,288,0,288,22,310,310,0,0
9570,2019-03-17,1001,0,1001,79,1080,1080,0,0
9571,2019-03-17,1100,0,1100,70,1170,0,1170,0
9572,2019-03-17,1815,0,1815,145,1960,1960,0,0
9573,2019-03-17,908,0,908,72,980,980,0,0
9574,2019-03-17,908,0,908,72,980,980,0,0
9575,2019-03-17,936,0,936,74,1010,1010,0,0
9576,2019-03-17,584,0,584,46,630,630,0,0
9577,2019-03-17,371,0,371,29,400,400,0,0
9578,2019-03-17,1703,0,1703,127,1830,1830,0,0
9579,2019-03-17,343,0,343,27,370,370,0,0
9580,2019-03-17,573,0,573,37,610,610,0,0
9581,2019-03-17,278,0,278,22,300,300,0,0
9582,2019-03-17,426,0,426,34,460,460,0,0
9583,2019-03-17,547,0,547,43,590,590,0,0
9584,2019-03-17,371,0,371,29,400,400,0,0
9585,2019-03-17,788,0,788,62,850,850,0,0
9586,2019-03-17,1463,0,1463,117,1580,1580,0,0
9587,2019-03-17,1575,0,1575,125,1700,0,1700,0
9588,2019-03-17,278,0,278,22,300,300,0,0
9589,2019-03-17,788,0,788,62,850,850,0,0
9590,2019-03-17,1575,0,1575,125,1700,0,1700,0
9591,2019-03-17,269,0,269,21,290,290,0,0
9592,2019-03-17,825,0,825,65,890,890,0,0
9593,2019-03-17,176,0,176,14,190,190,0,0
9594,2019-03-17,417,0,417,33,450,450,0,0
9595,2019-03-17,139,0,139,11,150,150,0,0
9596,2019-03-17,575,0,575,45,620,620,0,0
9597,2019-03-17,56,0,56,4,60,60,0,0
9598,2019-03-17,565,0,565,45,610,610,0,0
9599,2019-03-18,269,0,269,21,290,290,0,0
9600,2019-03-18,1620,0,1620,120,1740,1740,0,0
9601,2019-03-18,991,0,991,79,1070,1070,0,0
9602,2019-03-18,621,0,621,49,670,670,0,0
9603,2019-03-18,1436,0,1436,114,1550,1550,0,0
9604,2019-03-18,362,0,362,28,390,390,0,0
9605,2019-03-18,778,0,778,62,840,840,0,0
9606,2019-03-18,1815,0,1815,145,1960,1960,0,0
9607,2019-03-18,602,0,602,48,650,650,0,0
9608,2019-03-18,575,0,575,45,620,620,0,0
9609,2019-03-18,686,0,686,54,740,740,0,0
9610,2019-03-18,908,0,908,72,980,980,0,0
9611,2019-03-18,954,0,954,76,1030,1030,0,0
9612,2019-03-18,102,0,102,8,110,110,0,0
9613,2019-03-18,575,0,575,45,620,620,0,0
9614,2019-03-18,788,0,788,62,850,850,0,0
9615,2019-03-18,862,0,862,68,930,930,0,0
9616,2019-03-18,908,0,908,72,980,980,0,0
9617,2019-03-18,908,0,908,72,980,980,0,0
9618,2019-03-18,908,0,908,72,980,980,0,0
9619,2019-03-18,482,0,482,38,520,520,0,0
9620,2019-03-18,908,0,908,72,980,980,0,0
9621,2019-03-18,851,0,851,59,910,910,0,0
9622,2019-03-18,1815,0,1815,145,1960,1960,0,0
9623,2019-03-18,538,0,538,42,580,580,0,0
9624,2019-03-18,315,0,315,25,340,340,0,0
9625,2019-03-18,639,0,639,51,690,690,0,0
9626,2019-03-18,510,0,510,40,550,550,0,0
9627,2019-03-18,630,0,630,50,680,680,0,0
9628,2019-03-18,741,0,741,59,800,800,0,0
9629,2019-03-18,510,0,510,40,550,550,0,0
9630,2019-03-18,149,0,149,11,160,160,0,0
9631,2019-03-18,260,0,260,20,280,280,0,0
9632,2019-03-18,306,0,306,24,330,330,0,0
9633,2019-03-18,334,0,334,26,360,360,0,0
9634,2019-03-18,843,0,843,67,910,910,0,0
9635,2019-03-18,260,0,260,20,280,280,0,0
9636,2019-03-18,251,0,251,19,270,270,0,0
9637,2019-03-18,467,0,467,37,504,504,0,0
9638,2019-03-18,731,0,731,49,780,780,0,0
9639,2019-03-18,167,0,167,13,180,180,0,0
9640,2019-03-18,936,0,936,74,1010,1010,0,0
9641,2019-03-18,325,0,325,25,350,350,0,0
9642,2019-03-18,102,0,102,8,110,110,0,0
9643,2019-03-18,156,0,156,12,168,168,0,0
9644,2019-03-18,751,0,751,59,810,810,0,0
9645,2019-03-18,269,0,269,21,290,290,0,0
9646,2019-03-18,463,0,463,37,500,500,0,0
9647,2019-03-18,269,0,269,21,290,290,0,0
9648,2019-03-18,963,0,963,77,1040,1040,0,0
9649,2019-03-18,676,0,676,54,730,730,0,0
9650,2019-03-18,315,0,315,25,340,340,0,0
9651,2019-03-18,436,0,436,34,470,470,0,0
9652,2019-03-18,936,0,936,74,1010,1010,0,0
9653,2019-03-18,1556,0,1556,124,1680,1680,0,0
9654,2019-03-18,1825,0,1825,145,1970,1970,0,0
9655,2019-03-18,491,0,491,39,530,530,0,0
9656,2019-03-18,306,0,306,24,330,330,0,0
9657,2019-03-18,380,0,380,30,410,410,0,0
9658,2019-03-18,130,0,130,10,140,140,0,0
9659,2019-03-18,575,0,575,45,620,620,0,0
9660,2019-03-18,343,0,343,27,370,370,0,0
9661,2019-03-18,1852,0,1852,148,2000,2000,0,0
9662,2019-03-18,695,0,695,55,750,750,0,0
9663,2019-03-18,788,0,788,62,850,850,0,0
9664,2019-03-18,788,0,788,62,850,850,0,0
9665,2019-03-18,1047,0,1047,83,1130,1130,0,0
9666,2019-03-18,519,0,519,41,560,560,0,0
9667,2019-03-18,2130,0,2130,170,2300,2300,0,0
9668,2019-03-18,426,0,426,34,460,460,0,0
9669,2019-03-18,371,0,371,29,400,400,0,0
9670,2019-03-18,112,0,112,8,120,120,0,0
9671,2019-03-18,260,0,260,20,280,280,0,0
9672,2019-03-18,297,0,297,23,320,320,0,0
9673,2019-03-18,454,0,454,36,490,490,0,0
9674,2019-03-18,616,0,616,49,665,665,0,0
9675,2019-03-18,399,0,399,31,430,430,0,0
9676,2019-03-18,769,0,769,61,830,830,0,0
9677,2019-03-18,93,0,93,7,100,100,0,0
9678,2019-03-18,399,0,399,31,430,430,0,0
9679,2019-03-18,658,0,658,52,710,710,0,0
9680,2019-03-18,630,0,630,50,680,680,0,0
9681,2019-03-18,723,0,723,57,780,780,0,0
9682,2019-03-18,538,0,538,42,580,580,0,0
9683,2019-03-18,371,0,371,29,400,400,0,0
9684,2019-03-18,575,0,575,45,620,620,0,0
9685,2019-03-18,315,0,315,25,340,340,0,0
9686,2019-03-18,222,0,222,8,230,230,0,0
9687,2019-03-18,649,0,649,51,700,700,0,0
9688,2019-03-18,426,0,426,34,460,460,0,0
9689,2019-03-18,1815,0,1815,145,1960,1960,0,0
9690,2019-03-18,1999,0,1999,151,2150,2150,0,0
9691,2019-03-18,797,0,797,63,860,860,0,0
9692,2019-03-18,2286,0,2286,174,2460,2460,0,0
9693,2019-03-18,1815,0,1815,145,1960,1960,0,0
9694,2019-03-18,260,0,260,20,280,280,0,0
9695,2019-03-18,176,0,176,14,190,190,0,0
9696,2019-03-18,861,0,861,59,920,920,0,0
9697,2019-03-18,1482,0,1482,118,1600,1600,0,0
9698,2019-03-18,273,-58,215,17,232,232,0,0
9699,2019-03-18,2115,-225,1890,135,2025,2025,0,0
9700,2019-03-18,842,0,842,58,900,900,0,0
9701,2019-03-18,788,0,788,62,850,850,0,0
9702,2019-03-18,436,0,436,34,470,470,0,0
9703,2019-03-18,1445,0,1445,115,1560,1560,0,0
9704,2019-03-18,686,0,686,54,740,740,0,0
9705,2019-03-18,760,0,760,60,820,820,0,0
9706,2019-03-18,1047,0,1047,83,1130,1130,0,0
9707,2019-03-18,1240,0,1240,90,1330,1330,0,0
9708,2019-03-18,593,0,593,47,640,640,0,0
9709,2019-03-18,806,0,806,64,870,870,0,0
9710,2019-03-18,788,0,788,62,850,850,0,0
9711,2019-03-18,1963,0,1963,157,2120,2120,0,0
9712,2019-03-18,334,0,334,26,360,360,0,0
9713,2019-03-19,334,0,334,26,360,360,0,0
9714,2019-03-19,389,0,389,31,420,420,0,0
9715,2019-03-19,973,0,973,77,1050,1050,0,0
9716,2019-03-19,456,0,456,36,492,492,0,0
9717,2019-03-19,130,0,130,10,140,140,0,0
9718,2019-03-19,519,0,519,41,560,560,0,0
9719,2019-03-19,380,0,380,30,410,410,0,0
9720,2019-03-19,1001,0,1001,79,1080,1080,0,0
9721,2019-03-19,269,0,269,21,290,290,0,0
9722,2019-03-19,510,0,510,40,550,550,0,0
9723,2019-03-19,1118,0,1118,89,1207,1207,0,0
9724,2019-03-19,1232,0,1232,98,1330,1330,0,0
9725,2019-03-19,1038,0,1038,82,1120,1120,0,0
9726,2019-03-19,269,0,269,21,290,290,0,0
9727,2019-03-19,167,0,167,13,180,180,0,0
9728,2019-03-19,1056,0,1056,84,1140,1140,0,0
9729,2019-03-19,380,0,380,30,410,410,0,0
9730,2019-03-19,314,0,314,16,330,330,0,0
9731,2019-03-19,167,0,167,13,180,180,0,0
9732,2019-03-19,482,0,482,38,520,520,0,0
9733,2019-03-19,1519,0,1519,121,1640,1640,0,0
9734,2019-03-19,612,0,612,48,660,660,0,0
9735,2019-03-19,260,0,260,20,280,280,0,0
9736,2019-03-19,334,0,334,26,360,360,0,0
9737,2019-03-19,112,0,112,8,120,120,0,0
9738,2019-03-19,408,0,408,32,440,440,0,0
9739,2019-03-20,908,0,908,72,980,980,0,0
9740,2019-03-20,908,0,908,72,980,980,0,0
9741,2019-03-20,371,0,371,29,400,400,0,0
9742,2019-03-20,110,0,110,0,110,110,0,0
9743,2019-03-20,908,0,908,72,980,980,0,0
9744,2019-03-20,630,0,630,50,680,680,0,0
9745,2019-03-20,2001,0,2001,159,2160,2160,0,0
9746,2019-03-20,556,0,556,44,600,600,0,0
9747,2019-03-20,491,0,491,39,530,530,0,0
9748,2019-03-20,1852,0,1852,148,2000,2000,0,0
9749,2019-03-20,260,0,260,20,280,280,0,0
9750,2019-03-20,121,0,121,9,130,130,0,0
9751,2019-03-20,278,0,278,22,300,300,0,0
9752,2019-03-20,249,0,249,11,260,260,0,0
9753,2019-03-20,389,0,389,31,420,420,0,0
9754,2019-03-20,2723,0,2723,217,2940,0,2940,0
9755,2019-03-20,1121,0,1121,89,1210,1210,0,0
9756,2019-03-20,1815,0,1815,145,1960,1960,0,0
9757,2019-03-20,1834,0,1834,146,1980,1980,0,0
9758,2019-03-20,445,0,445,35,480,480,0,0
9759,2019-03-20,1288,0,1288,102,1390,1390,0,0
9760,2019-03-20,852,0,852,68,920,920,0,0
9761,2019-03-20,749,0,749,51,800,0,800,0
9762,2019-03-20,297,0,297,23,320,320,0,0
9763,2019-03-20,982,0,982,78,1060,1060,0,0
9764,2019-03-20,260,0,260,20,280,280,0,0
9765,2019-03-20,501,0,501,39,540,540,0,0
9766,2019-03-20,741,0,741,59,800,800,0,0
9767,2019-03-20,2175,0,2175,165,2340,2340,0,0
9768,2019-03-20,908,0,908,72,980,980,0,0
9769,2019-03-20,1028,0,1028,82,1110,1110,0,0
9770,2019-03-20,565,0,565,45,610,610,0,0
9771,2019-03-20,444,0,444,26,470,470,0,0
9772,2019-03-20,2723,0,2723,217,2940,2940,0,0
9773,2019-03-20,389,0,389,31,420,420,0,0
9774,2019-03-20,1473,0,1473,117,1590,1590,0,0
9775,2019-03-20,510,0,510,40,550,550,0,0
9776,2019-03-20,528,0,528,42,570,570,0,0
9777,2019-03-20,889,0,889,71,960,960,0,0
9778,2019-03-20,556,0,556,44,600,600,0,0
9779,2019-03-20,2093,0,2093,167,2260,2260,0,0
9780,2019-03-20,251,0,251,19,270,270,0,0
9781,2019-03-20,139,0,139,11,150,150,0,0
9782,2019-03-20,297,0,297,23,320,320,0,0
9783,2019-03-20,510,0,510,40,550,550,0,0
9784,2019-03-20,371,0,371,29,400,400,0,0
9785,2019-03-20,908,0,908,72,980,980,0,0
9786,2019-03-20,241,0,241,19,260,260,0,0
9787,2019-03-20,908,0,908,72,980,980,0,0
9788,2019-03-20,408,0,408,32,440,440,0,0
9789,2019-03-20,723,0,723,57,780,780,0,0
9790,2019-03-20,1241,0,1241,99,1340,1340,0,0
9791,2019-03-20,556,0,556,44,600,600,0,0
9792,2019-03-20,473,0,473,37,510,510,0,0
9793,2019-03-20,667,0,667,53,720,720,0,0
9794,2019-03-20,639,0,639,51,690,690,0,0
9795,2019-03-20,695,0,695,55,750,750,0,0
9796,2019-03-20,908,0,908,72,980,980,0,0
9797,2019-03-20,510,0,510,40,550,550,0,0
9798,2019-03-20,741,0,741,59,800,800,0,0
9799,2019-03-20,2723,0,2723,217,2940,2940,0,0
9800,2019-03-20,639,0,639,51,690,690,0,0
9801,2019-03-20,112,0,112,8,120,120,0,0
9802,2019-03-20,1815,0,1815,145,1960,1960,0,0
9803,2019-03-20,362,0,362,28,390,390,0,0
9804,2019-03-20,491,0,491,39,530,530,0,0
9805,2019-03-20,676,0,676,54,730,730,0,0
9806,2019-03-20,2389,0,2389,191,2580,0,2580,0
9807,2019-03-20,778,0,778,62,840,840,0,0
9808,2019-03-20,880,0,880,70,950,950,0,0
9809,2019-03-20,269,0,269,21,290,290,0,0
9810,2019-03-20,788,0,788,62,850,850,0,0
9811,2019-03-20,788,0,788,62,850,850,0,0
9812,2019-03-20,1575,0,1575,125,1700,1700,0,0
9813,2019-03-20,547,0,547,43,590,590,0,0
9814,2019-03-20,565,0,565,45,610,610,0,0
9815,2019-03-20,1073,0,1073,77,1150,1150,0,0
9816,2019-03-20,1639,0,1639,131,1770,1770,0,0
9817,2019-03-20,1575,0,1575,125,1700,1700,0,0
9818,2019-03-20,899,0,899,71,970,970,0,0
9819,2019-03-20,2038,0,2038,162,2200,2200,0,0
9820,2019-03-20,788,0,788,62,850,850,0,0
9821,2019-03-20,1463,0,1463,117,1580,1580,0,0
9822,2019-03-20,565,0,565,45,610,610,0,0
9823,2019-03-20,723,0,723,57,780,780,0,0
9824,2019-03-20,362,0,362,28,390,390,0,0
9825,2019-03-20,1334,0,1334,106,1440,1440,0,0
9826,2019-03-20,389,0,389,31,420,420,0,0
9827,2019-03-20,825,0,825,65,890,890,0,0
9828,2019-03-20,2491,0,2491,199,2690,2690,0,0
9829,2019-03-20,1186,0,1186,94,1280,0,1280,0
9830,2019-03-20,788,0,788,62,850,850,0,0
9831,2019-03-20,788,0,788,62,850,850,0,0
9832,2019-03-20,371,0,371,29,400,400,0,0
9833,2019-03-20,102,0,102,8,110,110,0,0
9834,2019-03-20,834,0,834,66,900,900,0,0
9835,2019-03-20,3149,0,3149,251,3400,3400,0,0
9836,2019-03-20,1538,0,1538,122,1660,1660,0,0
9837,2019-03-20,713,0,713,57,770,770,0,0
9838,2019-03-20,825,0,825,65,890,890,0,0
9839,2019-03-20,204,0,204,16,220,220,0,0
9840,2019-03-20,501,0,501,39,540,540,0,0
9841,2019-03-20,1593,0,1593,127,1720,1720,0,0
9842,2019-03-20,602,0,602,48,650,650,0,0
9843,2019-03-20,926,0,926,74,1000,1000,0,0
9844,2019-03-20,232,0,232,18,250,250,0,0
9845,2019-03-20,473,0,473,37,510,510,0,0
9846,2019-03-20,-1815,0,-1815,-145,-1960,-1960,0,0
9847,2019-03-20,880,0,880,70,950,950,0,0
9848,2019-03-20,1815,0,1815,145,1960,1960,0,0
9849,2019-03-20,963,0,963,77,1040,1040,0,0
9850,2019-03-20,547,0,547,43,590,590,0,0
9851,2019-03-20,1251,0,1251,99,1350,1350,0,0
9852,2019-03-20,1389,0,1389,111,1500,1500,0,0
9853,2019-03-20,1584,0,1584,126,1710,1710,0,0
9854,2019-03-20,639,0,639,51,690,690,0,0
9855,2019-03-20,1674,0,1674,116,1790,1790,0,0
9856,2019-03-20,778,0,778,62,840,840,0,0
9857,2019-03-20,362,0,362,28,390,390,0,0
9858,2019-03-20,1065,0,1065,85,1150,1150,0,0
9859,2019-03-20,1676,0,1676,134,1810,1810,0,0
9860,2019-03-20,417,0,417,33,450,450,0,0
9861,2019-03-20,1501,0,1501,119,1620,1620,0,0
9862,2019-03-20,1575,0,1575,125,1700,1700,0,0
9863,2019-03-20,1084,0,1084,86,1170,1170,0,0
9864,2019-03-20,222,0,222,8,230,230,0,0
9865,2019-03-20,788,0,788,62,850,850,0,0
9866,2019-03-20,3676,0,3676,294,3970,3970,0,0
9867,2019-03-20,1121,0,1121,89,1210,1210,0,0
9868,2019-03-20,436,0,436,34,470,470,0,0
9869,2019-03-20,639,0,639,51,690,690,0,0
9870,2019-03-20,501,0,501,39,540,540,0,0
9871,2019-03-20,399,0,399,31,430,430,0,0
9872,2019-03-20,788,0,788,62,850,850,0,0
9873,2019-03-21,241,0,241,19,260,260,0,0
9874,2019-03-21,3704,0,3704,296,4000,0,4000,0
9875,2019-03-21,371,0,371,29,400,400,0,0
9876,2019-03-21,371,0,371,29,400,400,0,0
9877,2019-03-21,250,0,250,20,270,270,0,0
9878,2019-03-21,2482,0,2482,198,2680,2680,0,0
9879,2019-03-21,908,0,908,72,980,980,0,0
9880,2019-03-21,445,0,445,35,480,480,0,0
9881,2019-03-21,1065,0,1065,85,1150,1150,0,0
9882,2019-03-21,371,0,371,29,400,400,0,0
9883,2019-03-21,1019,0,1019,81,1100,1100,0,0
9884,2019-03-21,908,0,908,72,980,980,0,0
9885,2019-03-21,334,0,334,26,360,0,360,0
9886,2019-03-21,306,0,306,24,330,330,0,0
9887,2019-03-21,2446,-520,1926,154,2080,2080,0,0
9888,2019-03-21,602,0,602,48,650,650,0,0
9889,2019-03-21,519,0,519,41,560,560,0,0
9890,2019-03-21,519,0,519,41,560,560,0,0
9891,2019-03-21,575,0,575,45,620,620,0,0
9892,2019-03-21,176,0,176,14,190,190,0,0
9893,2019-03-21,908,0,908,72,980,980,0,0
9894,2019-03-21,1815,0,1815,145,1960,1960,0,0
9895,2019-03-21,510,0,510,40,550,550,0,0
9896,2019-03-21,908,0,908,72,980,980,0,0
9897,2019-03-21,389,0,389,31,420,420,0,0
9898,2019-03-21,1176,0,1176,94,1270,1270,0,0
9899,2019-03-21,1176,0,1176,94,1270,0,1270,0
9900,2019-03-21,453,0,453,27,480,480,0,0
9901,2019-03-21,1815,0,1815,145,1960,1960,0,0
9902,2019-03-21,889,0,889,71,960,960,0,0
9903,2019-03-21,1658,0,1658,132,1790,1790,0,0
9904,2019-03-21,1158,0,1158,92,1250,1250,0,0
9905,2019-03-21,315,0,315,25,340,340,0,0
9906,2019-03-21,666,0,666,44,710,710,0,0
9907,2019-03-21,436,0,436,34,470,470,0,0
9908,2019-03-21,908,0,908,72,980,980,0,0
9909,2019-03-21,686,0,686,54,740,740,0,0
9910,2019-03-21,1084,0,1084,86,1170,1170,0,0
9911,2019-03-21,686,0,686,54,740,740,0,0
9912,2019-03-21,547,0,547,43,590,590,0,0
9913,2019-03-21,278,0,278,22,300,300,0,0
9914,2019-03-21,399,0,399,31,430,430,0,0
9915,2019-03-21,1121,0,1121,89,1210,1210,0,0
9916,2019-03-21,491,0,491,39,530,530,0,0
9917,2019-03-21,926,0,926,74,1000,1000,0,0
9918,2019-03-21,232,0,232,18,250,250,0,0
9919,2019-03-21,260,0,260,20,280,280,0,0
9920,2019-03-21,908,0,908,72,980,980,0,0
9921,2019-03-21,1251,0,1251,99,1350,1350,0,0
9922,2019-03-21,917,0,917,73,990,990,0,0
9923,2019-03-21,334,0,334,26,360,360,0,0
9924,2019-03-21,426,0,426,34,460,460,0,0
9925,2019-03-21,908,0,908,72,980,980,0,0
9926,2019-03-21,236,-50,186,14,200,0,200,0
9927,2019-03-21,908,0,908,72,980,980,0,0
9928,2019-03-21,334,0,334,26,360,360,0,0
9929,2019-03-21,1362,0,1362,108,1470,1470,0,0
9930,2019-03-21,454,0,454,36,490,490,0,0
9931,2019-03-21,260,0,260,20,280,280,0,0
9932,2019-03-21,658,0,658,52,710,710,0,0
9933,2019-03-21,473,0,473,37,510,510,0,0
9934,2019-03-21,620,0,620,40,660,660,0,0
9935,2019-03-21,908,0,908,72,980,0,980,0
9936,2019-03-21,519,0,519,41,560,560,0,0
9937,2019-03-21,1408,0,1408,112,1520,1520,0,0
9938,2019-03-21,473,0,473,37,510,510,0,0
9939,2019-03-21,371,0,371,29,400,400,0,0
9940,2019-03-21,612,0,612,48,660,660,0,0
9941,2019-03-21,1352,0,1352,108,1460,1460,0,0
9942,2019-03-21,1075,0,1075,85,1160,1160,0,0
9943,2019-03-21,167,0,167,13,180,180,0,0
9944,2019-03-21,1241,0,1241,99,1340,1340,0,0
9945,2019-03-21,371,0,371,29,400,400,0,0
9946,2019-03-21,491,0,491,39,530,530,0,0
9947,2019-03-21,491,0,491,39,530,530,0,0
9948,2019-03-21,102,0,102,8,110,110,0,0
9949,2019-03-21,371,0,371,29,400,400,0,0
9950,2019-03-21,1065,0,1065,85,1150,1150,0,0
9951,2019-03-21,732,0,732,58,790,790,0,0
9952,2019-03-21,315,0,315,25,340,340,0,0
9953,2019-03-21,380,0,380,30,410,410,0,0
9954,2019-03-21,389,0,389,31,420,420,0,0
9955,2019-03-21,377,-80,297,23,320,320,0,0
9956,2019-03-21,621,0,621,49,670,670,0,0
9957,2019-03-21,389,0,389,31,420,420,0,0
9958,2019-03-21,908,0,908,72,980,980,0,0
9959,2019-03-21,1880,0,1880,150,2030,0,2030,0
9960,2019-03-21,732,0,732,58,790,790,0,0
9961,2019-03-21,704,0,704,56,760,760,0,0
9962,2019-03-21,703,0,703,47,750,750,0,0
9963,2019-03-21,593,0,593,47,640,640,0,0
9964,2019-03-21,741,0,741,59,800,800,0,0
9965,2019-03-21,1102,0,1102,88,1190,1190,0,0
9966,2019-03-21,417,0,417,33,450,450,0,0
9967,2019-03-21,436,0,436,34,470,470,0,0
9968,2019-03-21,362,0,362,28,390,390,0,0
9969,2019-03-21,399,0,399,31,430,430,0,0
9970,2019-03-21,371,0,371,29,400,400,0,0
9971,2019-03-21,491,0,491,39,530,530,0,0
9972,2019-03-21,204,0,204,16,220,220,0,0
9973,2019-03-21,760,0,760,60,820,820,0,0
9974,2019-03-21,547,0,547,43,590,590,0,0
9975,2019-03-21,334,0,334,26,360,360,0,0
9976,2019-03-21,602,0,602,48,650,650,0,0
9977,2019-03-21,843,0,843,67,910,910,0,0
9978,2019-03-21,232,0,232,18,250,250,0,0
9979,2019-03-21,278,0,278,22,300,300,0,0
9980,2019-03-21,112,0,112,8,120,120,0,0
9981,2019-03-21,491,0,491,39,530,530,0,0
9982,2019-03-21,584,0,584,46,630,630,0,0
9983,2019-03-21,130,0,130,10,140,140,0,0
9984,2019-03-21,528,0,528,42,570,570,0,0
9985,2019-03-21,2149,0,2149,171,2320,2320,0,0
9986,2019-03-21,584,0,584,46,630,630,0,0
9987,2019-03-21,602,0,602,48,650,650,0,0
9988,2019-03-21,110,0,110,0,110,110,0,0
9989,2019-03-21,223,0,223,17,240,240,0,0
9990,2019-03-21,926,0,926,74,1000,1000,0,0
9991,2019-03-21,-926,0,-926,-74,-1000,-1000,0,0
9992,2019-03-21,454,0,454,36,490,490,0,0
9993,2019-03-21,850,-91,759,60,819,819,0,0
9994,2019-03-21,547,0,547,43,590,590,0,0
9995,2019-03-21,556,0,556,44,600,600,0,0
9996,2019-03-21,473,0,473,37,510,510,0,0
9997,2019-03-21,251,0,251,19,270,270,0,0
9998,2019-03-21,788,0,788,62,850,850,0,0
9999,2019-03-21,1065,0,1065,85,1150,1150,0,0
10000,2019-03-21,139,0,139,11,150,150,0,0
10001,2019-03-21,584,0,584,46,630,630,0,0
10002,2019-03-21,288,0,288,22,310,310,0,0
10003,2019-03-21,241,0,241,19,260,260,0,0
10004,2019-03-21,769,0,769,61,830,830,0,0
10005,2019-03-21,1204,0,1204,96,1300,1300,0,0
10006,2019-03-21,788,0,788,62,850,850,0,0
10007,2019-03-21,926,0,926,74,1000,1000,0,0
10008,2019-03-21,2130,0,2130,170,2300,2300,0,0
10009,2019-03-21,667,0,667,53,720,720,0,0
10010,2019-03-21,788,0,788,62,850,850,0,0
10011,2019-03-21,936,0,936,74,1010,1010,0,0
10012,2019-03-21,1130,0,1130,90,1220,1220,0,0
10013,2019-03-21,186,0,186,14,200,200,0,0
10014,2019-03-21,1047,0,1047,83,1130,1130,0,0
10015,2019-03-21,1399,0,1399,111,1510,1510,0,0
10016,2019-03-21,1584,0,1584,126,1710,1710,0,0
10017,2019-03-21,1575,0,1575,125,1700,1700,0,0
10018,2019-03-21,741,0,741,59,800,800,0,0
10019,2019-03-21,899,0,899,71,970,970,0,0
10020,2019-03-21,593,0,593,47,640,640,0,0
10021,2019-03-21,454,0,454,36,490,490,0,0
10022,2019-03-21,1606,-172,1434,114,1548,1548,0,0
10023,2019-03-21,547,0,547,43,590,590,0,0
10024,2019-03-21,908,0,908,72,980,980,0,0
10025,2019-03-21,232,0,232,18,250,250,0,0
10026,2019-03-21,813,0,813,47,860,860,0,0
10027,2019-03-21,657,0,657,43,700,700,0,0
10028,2019-03-21,852,0,852,68,920,920,0,0
10029,2019-03-21,1047,0,1047,83,1130,1130,0,0
10030,2019-03-21,1001,0,1001,79,1080,1080,0,0
10031,2019-03-21,676,0,676,54,730,730,0,0
10032,2019-03-21,250,0,250,20,270,270,0,0
10033,2019-03-21,1444,0,1444,106,1550,1550,0,0
10034,2019-03-21,3149,0,3149,251,3400,3400,0,0
10035,2019-03-21,2362,0,2362,188,2550,2550,0,0
10036,2019-03-21,788,0,788,62,850,850,0,0
10037,2019-03-21,769,0,769,61,830,830,0,0
10038,2019-03-21,1575,0,1575,125,1700,1700,0,0
10039,2019-03-21,797,0,797,63,860,860,0,0
10040,2019-03-21,1575,0,1575,125,1700,1700,0,0
10041,2019-03-21,1065,0,1065,85,1150,1150,0,0
10042,2019-03-21,788,0,788,62,850,850,0,0
10043,2019-03-21,778,0,778,62,840,840,0,0
10044,2019-03-21,1575,0,1575,125,1700,0,1700,0
10045,2019-03-21,482,0,482,38,520,520,0,0
10046,2019-03-21,445,0,445,35,480,480,0,0
10047,2019-03-21,399,0,399,31,430,430,0,0
10048,2019-03-21,899,0,899,71,970,970,0,0
10049,2019-03-21,2130,0,2130,170,2300,0,2300,0
10050,2019-03-21,352,0,352,28,380,380,0,0
10051,2019-03-21,3317,-353,2964,213,3177,3177,0,0
10052,2019-03-22,908,0,908,72,980,980,0,0
10053,2019-03-22,1288,0,1288,102,1390,1390,0,0
10054,2019-03-22,1084,0,1084,86,1170,1170,0,0
10055,2019-03-22,908,0,908,72,980,980,0,0
10056,2019-03-22,908,0,908,72,980,980,0,0
10057,2019-03-22,362,0,362,28,390,390,0,0
10058,2019-03-22,778,0,778,62,840,840,0,0
10059,2019-03-22,908,0,908,72,980,980,0,0
10060,2019-03-22,639,0,639,51,690,690,0,0
10061,2019-03-22,436,0,436,34,470,470,0,0
10062,2019-03-22,436,0,436,34,470,470,0,0
10063,2019-03-22,834,0,834,66,900,900,0,0
10064,2019-03-22,899,0,899,71,970,970,0,0
10065,2019-03-22,611,0,611,39,650,650,0,0
10066,2019-03-22,1399,0,1399,111,1510,1510,0,0
10067,2019-03-22,3630,0,3630,290,3920,0,3920,0
10068,2019-03-22,908,0,908,72,980,980,0,0
10069,2019-03-22,297,0,297,23,320,320,0,0
10070,2019-03-22,417,0,417,33,450,450,0,0
10071,2019-03-22,3630,0,3630,290,3920,3920,0,0
10072,2019-03-22,47,0,47,3,50,50,0,0
10073,2019-03-22,1232,0,1232,98,1330,1330,0,0
10074,2019-03-22,908,0,908,72,980,980,0,0
10075,2019-03-22,1325,0,1325,105,1430,1430,0,0
10076,2019-03-22,639,0,639,51,690,690,0,0
10077,2019-03-22,297,0,297,23,320,320,0,0
10078,2019-03-22,149,0,149,11,160,160,0,0
10079,2019-03-22,176,0,176,14,190,190,0,0
10080,2019-03-22,1130,0,1130,90,1220,1220,0,0
10081,2019-03-22,621,0,621,49,670,670,0,0
10082,2019-03-22,991,0,991,79,1070,1070,0,0
10083,2019-03-22,176,0,176,14,190,190,0,0
10084,2019-03-22,453,0,453,27,480,480,0,0
10085,2019-03-22,362,0,362,28,390,390,0,0
10086,2019-03-22,371,0,371,29,400,400,0,0
10087,2019-03-22,547,0,547,43,590,590,0,0
10088,2019-03-22,269,0,269,21,290,290,0,0
10089,2019-03-22,176,0,176,14,190,190,0,0
10090,2019-03-22,362,0,362,28,390,390,0,0
10091,2019-03-22,667,0,667,53,720,720,0,0
10092,2019-03-22,908,0,908,72,980,980,0,0
10093,2019-03-22,556,0,556,44,600,600,0,0
10094,2019-03-22,425,0,425,25,450,450,0,0
10095,2019-03-22,926,0,926,74,1000,1000,0,0
10096,2019-03-22,1565,0,1565,125,1690,1690,0,0
10097,2019-03-22,362,0,362,28,390,390,0,0
10098,2019-03-22,519,0,519,41,560,560,0,0
10099,2019-03-22,149,0,149,11,160,160,0,0
10100,2019-03-22,389,0,389,31,420,0,420,0
10101,2019-03-22,510,0,510,40,550,550,0,0
10102,2019-03-22,584,0,584,46,630,630,0,0
10103,2019-03-22,491,0,491,39,530,530,0,0
10104,2019-03-22,371,0,371,29,400,400,0,0
10105,2019-03-22,473,0,473,37,510,510,0,0
10106,2019-03-22,518,0,518,32,550,550,0,0
10107,2019-03-22,362,0,362,28,390,390,0,0
10108,2019-03-22,362,0,362,28,390,390,0,0
10109,2019-03-22,1278,0,1278,102,1380,1380,0,0
10110,2019-03-22,-362,0,-362,-28,-390,-390,0,0
10111,2019-03-22,417,0,417,33,450,450,0,0
10112,2019-03-22,528,0,528,42,570,570,0,0
10113,2019-03-22,352,0,352,28,380,380,0,0
10114,2019-03-22,408,0,408,32,440,440,0,0
10115,2019-03-22,482,0,482,38,520,520,0,0
10116,2019-03-22,491,0,491,39,530,530,0,0
10117,2019-03-22,2186,0,2186,174,2360,2360,0,0
10118,2019-03-22,834,0,834,66,900,900,0,0
10119,2019-03-22,778,0,778,62,840,840,0,0
10120,2019-03-22,760,0,760,60,820,820,0,0
10121,2019-03-22,362,0,362,28,390,390,0,0
10122,2019-03-22,1278,0,1278,102,1380,1380,0,0
10123,2019-03-22,1815,0,1815,145,1960,1960,0,0
10124,2019-03-22,575,0,575,45,620,0,620,0
10125,2019-03-22,519,0,519,41,560,560,0,0
10126,2019-03-22,1815,0,1815,145,1960,1960,0,0
10127,2019-03-22,371,0,371,29,400,400,0,0
10128,2019-03-22,260,0,260,20,280,280,0,0
10129,2019-03-22,1815,0,1815,145,1960,1960,0,0
10130,2019-03-22,315,0,315,25,340,340,0,0
10131,2019-03-22,473,0,473,37,510,510,0,0
10132,2019-03-22,112,0,112,8,120,120,0,0
10133,2019-03-22,1046,0,1046,74,1120,1120,0,0
10134,2019-03-22,519,0,519,41,560,560,0,0
10135,2019-03-22,908,0,908,72,980,980,0,0
10136,2019-03-22,232,0,232,18,250,250,0,0
10137,2019-03-22,991,0,991,79,1070,1070,0,0
10138,2019-03-22,260,0,260,20,280,280,0,0
10139,2019-03-22,163,0,163,12,175,175,0,0
10140,2019-03-22,4538,0,4538,362,4900,4900,0,0
10141,2019-03-22,788,0,788,62,850,850,0,0
10142,2019-03-22,1575,0,1575,125,1700,1700,0,0
10143,2019-03-22,297,0,297,23,320,320,0,0
10144,2019-03-22,2056,0,2056,164,2220,2220,0,0
10145,2019-03-22,1575,0,1575,125,1700,1700,0,0
10146,2019-03-22,1093,0,1093,87,1180,1180,0,0
10147,2019-03-22,1575,0,1575,125,1700,1700,0,0
10148,2019-03-22,694,0,694,46,740,0,740,0
10149,2019-03-22,1575,0,1575,125,1700,0,1700,0
10150,2019-03-22,1575,0,1575,125,1700,1700,0,0
10151,2019-03-22,1852,0,1852,148,2000,0,2000,0
10152,2019-03-22,667,0,667,53,720,720,0,0
10153,2019-03-22,1325,0,1325,105,1430,1430,0,0
10154,2019-03-22,1695,0,1695,135,1830,1830,0,0
10155,2019-03-22,195,0,195,15,210,210,0,0
10156,2019-03-22,408,0,408,32,440,440,0,0
10157,2019-03-22,612,0,612,48,660,660,0,0
10158,2019-03-22,1195,0,1195,95,1290,1290,0,0
10159,2019-03-22,1639,0,1639,131,1770,1770,0,0
10160,2019-03-22,797,0,797,63,860,860,0,0
10161,2019-03-22,2528,0,2528,202,2730,2730,0,0
10162,2019-03-22,278,0,278,22,300,300,0,0
10163,2019-03-22,269,0,269,21,290,290,0,0
10164,2019-03-22,1510,0,1510,120,1630,1630,0,0
10165,2019-03-22,704,0,704,56,760,760,0,0
10166,2019-03-22,723,0,723,57,780,780,0,0
10167,2019-03-22,788,0,788,62,850,850,0,0
10168,2019-03-22,547,0,547,43,590,590,0,0
10169,2019-03-22,620,0,620,40,660,660,0,0
10170,2019-03-22,333,0,333,17,350,350,0,0
10171,2019-03-22,649,0,649,51,700,700,0,0
10172,2019-03-22,630,0,630,50,680,680,0,0
10173,2019-03-22,112,0,112,8,120,120,0,0
10174,2019-03-22,139,0,139,11,150,150,0,0
10175,2019-03-22,602,0,602,48,650,650,0,0
10176,2019-03-22,408,0,408,32,440,440,0,0
10177,2019-03-22,538,0,538,42,580,580,0,0
10178,2019-03-22,1176,0,1176,94,1270,1270,0,0
10179,2019-03-22,102,0,102,8,110,110,0,0
10180,2019-03-22,732,0,732,58,790,0,790,0
10181,2019-03-22,167,0,167,13,180,0,180,0
10182,2019-03-22,1815,0,1815,145,1960,1960,0,0
10183,2019-03-22,1028,0,1028,82,1110,1110,0,0
10184,2019-03-22,1038,0,1038,82,1120,1120,0,0
10185,2019-03-22,963,0,963,77,1040,1040,0,0
10186,2019-03-22,1241,0,1241,99,1340,1340,0,0
10187,2019-03-22,1241,0,1241,99,1340,1340,0,0
10188,2019-03-22,593,0,593,47,640,640,0,0
10189,2019-03-22,1010,0,1010,80,1090,1090,0,0
10190,2019-03-22,862,0,862,68,930,930,0,0
10191,2019-03-22,740,0,740,50,790,790,0,0
10192,2019-03-22,1342,0,1342,98,1440,1440,0,0
10193,2019-03-22,251,0,251,19,270,270,0,0
10194,2019-03-22,241,0,241,19,260,260,0,0
10195,2019-03-22,584,0,584,46,630,630,0,0
10196,2019-03-22,491,0,491,39,530,530,0,0
10197,2019-03-22,667,0,667,53,720,720,0,0
10198,2019-03-22,417,0,417,33,450,450,0,0
10199,2019-03-22,417,0,417,33,450,450,0,0
10200,2019-03-22,695,0,695,55,750,750,0,0
10201,2019-03-22,1815,0,1815,145,1960,1960,0,0
10202,2019-03-22,2564,0,2564,196,2760,2760,0,0
10203,2019-03-22,639,0,639,51,690,690,0,0
10204,2019-03-22,806,0,806,64,870,870,0,0
10205,2019-03-22,778,0,778,62,840,840,0,0
10206,2019-03-22,917,0,917,73,990,990,0,0
10207,2019-03-22,269,0,269,21,290,290,0,0
10208,2019-03-22,102,0,102,8,110,110,0,0
10209,2019-03-22,973,0,973,77,1050,1050,0,0
10210,2019-03-22,954,0,954,76,1030,1030,0,0
10211,2019-03-22,139,0,139,11,150,150,0,0
10212,2019-03-22,751,0,751,59,810,810,0,0
10213,2019-03-22,788,0,788,62,850,850,0,0
10214,2019-03-22,1575,0,1575,125,1700,1700,0,0
10215,2019-03-22,741,0,741,59,800,800,0,0
10216,2019-03-22,1343,0,1343,107,1450,0,1450,0
10217,2019-03-22,2038,0,2038,162,2200,2200,0,0
10218,2019-03-22,658,0,658,52,710,710,0,0
10219,2019-03-22,2130,0,2130,170,2300,2300,0,0
10220,2019-03-22,621,0,621,49,670,670,0,0
10221,2019-03-22,320,-68,252,20,272,0,272,0
10222,2019-03-23,1056,0,1056,84,1140,1140,0,0
10223,2019-03-23,741,0,741,59,800,800,0,0
10224,2019-03-23,806,0,806,64,870,870,0,0
10225,2019-03-23,2399,0,2399,191,2590,2590,0,0
10226,2019-03-23,917,0,917,73,990,990,0,0
10227,2019-03-23,815,0,815,65,880,880,0,0
10228,2019-03-23,750,0,750,60,810,810,0,0
10229,2019-03-23,250,0,250,20,270,270,0,0
10230,2019-03-23,769,0,769,61,830,830,0,0
10231,2019-03-23,676,0,676,54,730,730,0,0
10232,2019-03-23,112,0,112,8,120,120,0,0
10233,2019-03-23,639,0,639,51,690,690,0,0
10234,2019-03-23,945,0,945,75,1020,1020,0,0
10235,2019-03-23,556,0,556,44,600,600,0,0
10236,2019-03-23,1499,0,1499,111,1610,0,1610,0
10237,2019-03-23,260,0,260,20,280,280,0,0
10238,2019-03-23,555,0,555,35,590,590,0,0
10239,2019-03-23,463,0,463,37,500,500,0,0
10240,2019-03-23,612,0,612,48,660,660,0,0
10241,2019-03-23,1426,0,1426,114,1540,1540,0,0
10242,2019-03-23,575,0,575,45,620,620,0,0
10243,2019-03-23,908,0,908,72,980,980,0,0
10244,2019-03-23,825,0,825,65,890,890,0,0
10245,2019-03-23,482,0,482,38,520,520,0,0
10246,2019-03-23,732,0,732,58,790,790,0,0
10247,2019-03-23,5445,0,5445,435,5880,5880,0,0
10248,2019-03-23,519,0,519,41,560,560,0,0
10249,2019-03-23,417,0,417,33,450,450,0,0
10250,2019-03-23,575,0,575,45,620,620,0,0
10251,2019-03-23,2723,0,2723,217,2940,2940,0,0
10252,2019-03-23,908,0,908,72,980,980,0,0
10253,2019-03-23,908,0,908,72,980,980,0,0
10254,2019-03-23,1945,0,1945,155,2100,2100,0,0
10255,2019-03-23,797,0,797,63,860,860,0,0
10256,2019-03-23,852,0,852,68,920,920,0,0
10257,2019-03-23,389,0,389,31,420,420,0,0
10258,2019-03-23,306,0,306,24,330,330,0,0
10259,2019-03-23,573,0,573,37,610,610,0,0
10260,2019-03-23,658,0,658,52,710,710,0,0
10261,2019-03-23,1815,0,1815,145,1960,1960,0,0
10262,2019-03-23,908,0,908,72,980,980,0,0
10263,2019-03-23,908,0,908,72,980,980,0,0
10264,2019-03-23,908,0,908,72,980,980,0,0
10265,2019-03-23,908,0,908,72,980,980,0,0
10266,2019-03-23,1453,0,1453,107,1560,1560,0,0
10267,2019-03-23,1815,0,1815,145,1960,1960,0,0
10268,2019-03-23,399,0,399,31,430,430,0,0
10269,2019-03-23,797,0,797,63,860,860,0,0
10270,2019-03-23,213,0,213,17,230,230,0,0
10271,2019-03-23,463,0,463,37,500,500,0,0
10272,2019-03-23,269,0,269,21,290,290,0,0
10273,2019-03-23,232,0,232,18,250,250,0,0
10274,2019-03-23,463,0,463,37,500,500,0,0
10275,2019-03-23,889,0,889,71,960,960,0,0
10276,2019-03-23,788,0,788,62,850,850,0,0
10277,2019-03-23,260,0,260,20,280,280,0,0
10278,2019-03-23,788,0,788,62,850,850,0,0
10279,2019-03-23,371,0,371,29,400,400,0,0
10280,2019-03-23,1815,0,1815,145,1960,1960,0,0
10281,2019-03-23,352,0,352,28,380,380,0,0
10282,2019-03-23,528,0,528,42,570,570,0,0
10283,2019-03-23,1297,0,1297,103,1400,1400,0,0
10284,2019-03-23,2027,0,2027,153,2180,2180,0,0
10285,2019-03-23,2889,0,2889,231,3120,3120,0,0
10286,2019-03-23,269,0,269,21,290,290,0,0
10287,2019-03-23,602,0,602,48,650,650,0,0
10288,2019-03-23,389,0,389,31,420,420,0,0
10289,2019-03-23,482,0,482,38,520,520,0,0
10290,2019-03-23,1399,0,1399,111,1510,1510,0,0
10291,2019-03-23,426,0,426,34,460,460,0,0
10292,2019-03-23,360,0,360,20,380,380,0,0
10293,2019-03-23,630,0,630,50,680,680,0,0
10294,2019-03-23,473,0,473,37,510,510,0,0
10295,2019-03-23,240,0,240,10,250,250,0,0
10296,2019-03-23,371,0,371,29,400,400,0,0
10297,2019-03-23,260,0,260,20,280,280,0,0
10298,2019-03-23,658,0,658,52,710,0,710,0
10299,2019-03-23,2723,0,2723,217,2940,2940,0,0
10300,2019-03-23,908,0,908,72,980,980,0,0
10301,2019-03-23,195,0,195,15,210,210,0,0
10302,2019-03-23,186,0,186,14,200,200,0,0
10303,2019-03-23,852,0,852,68,920,920,0,0
10304,2019-03-23,343,0,343,27,370,370,0,0
10305,2019-03-23,1130,0,1130,90,1220,1220,0,0
10306,2019-03-23,491,0,491,39,530,530,0,0
10307,2019-03-23,482,0,482,38,520,520,0,0
10308,2019-03-23,1278,0,1278,102,1380,1380,0,0
10309,2019-03-23,769,0,769,61,830,830,0,0
10310,2019-03-23,519,0,519,41,560,560,0,0
10311,2019-03-23,1815,0,1815,145,1960,1960,0,0
10312,2019-03-23,176,0,176,14,190,190,0,0
10313,2019-03-23,481,0,481,29,510,510,0,0
10314,2019-03-23,732,0,732,58,790,790,0,0
10315,2019-03-23,1001,0,1001,79,1080,1080,0,0
10316,2019-03-23,260,0,260,20,280,280,0,0
10317,2019-03-23,380,0,380,30,410,410,0,0
10318,2019-03-23,352,0,352,28,380,380,0,0
10319,2019-03-23,751,0,751,59,810,810,0,0
10320,2019-03-23,408,0,408,32,440,440,0,0
10321,2019-03-23,908,0,908,72,980,980,0,0
10322,2019-03-23,1213,0,1213,97,1310,1310,0,0
10323,2019-03-23,1880,0,1880,150,2030,0,2030,0
10324,2019-03-23,899,0,899,71,970,970,0,0
10325,2019-03-23,408,0,408,32,440,440,0,0
10326,2019-03-23,1565,0,1565,125,1690,1690,0,0
10327,2019-03-23,139,0,139,11,150,150,0,0
10328,2019-03-23,667,0,667,53,720,720,0,0
10329,2019-03-23,334,0,334,26,360,360,0,0
10330,2019-03-23,556,0,556,44,600,600,0,0
10331,2019-03-23,3149,0,3149,251,3400,3400,0,0
10332,2019-03-23,1630,0,1630,130,1760,1760,0,0
10333,2019-03-23,3195,0,3195,255,3450,3450,0,0
10334,2019-03-23,926,0,926,74,1000,1000,0,0
10335,2019-03-23,110,0,110,0,110,110,0,0
10336,2019-03-23,102,0,102,8,110,110,0,0
10337,2019-03-23,1575,0,1575,125,1700,1700,0,0
10338,2019-03-23,794,-85,709,56,765,765,0,0
10339,2019-03-23,251,0,251,19,270,270,0,0
10340,2019-03-23,176,0,176,14,190,190,0,0
10341,2019-03-23,149,0,149,11,160,160,0,0
10342,2019-03-23,362,0,362,28,390,390,0,0
10343,2019-03-23,454,0,454,36,490,490,0,0
10344,2019-03-23,445,0,445,35,480,480,0,0
10345,2019-03-23,519,0,519,41,560,560,0,0
10346,2019-03-23,880,0,880,70,950,950,0,0
10347,2019-03-23,908,0,908,72,980,980,0,0
10348,2019-03-23,676,0,676,54,730,0,730,0
10349,2019-03-23,232,0,232,18,250,250,0,0
10350,2019-03-23,1149,0,1149,91,1240,1240,0,0
10351,2019-03-23,371,0,371,29,400,400,0,0
10352,2019-03-23,232,0,232,18,250,250,0,0
10353,2019-03-23,472,0,472,28,500,500,0,0
10354,2019-03-23,325,0,325,25,350,350,0,0
10355,2019-03-23,806,0,806,64,870,870,0,0
10356,2019-03-23,1686,0,1686,134,1820,1820,0,0
10357,2019-03-23,723,0,723,57,780,780,0,0
10358,2019-03-23,334,0,334,26,360,360,0,0
10359,2019-03-23,1075,0,1075,85,1160,1160,0,0
10360,2019-03-23,110,0,110,0,110,110,0,0
10361,2019-03-23,1112,0,1112,88,1200,1200,0,0
10362,2019-03-23,436,0,436,34,470,470,0,0
10363,2019-03-23,352,0,352,28,380,380,0,0
10364,2019-03-23,547,0,547,43,590,590,0,0
10365,2019-03-23,1352,0,1352,108,1460,1460,0,0
10366,2019-03-23,1843,0,1843,147,1990,1990,0,0
10367,2019-03-23,139,0,139,11,150,150,0,0
10368,2019-03-23,630,0,630,50,680,680,0,0
10369,2019-03-23,686,0,686,54,740,0,740,0
10370,2019-03-23,334,0,334,26,360,360,0,0
10371,2019-03-23,880,0,880,70,950,950,0,0
10372,2019-03-23,445,0,445,35,480,480,0,0
10373,2019-03-23,463,0,463,37,500,500,0,0
10374,2019-03-23,297,0,297,23,320,320,0,0
10375,2019-03-23,1491,0,1491,119,1610,1610,0,0
10376,2019-03-23,712,0,712,48,760,760,0,0
10377,2019-03-23,1019,0,1019,81,1100,1100,0,0
10378,2019-03-23,658,0,658,52,710,710,0,0
10379,2019-03-23,945,0,945,75,1020,1020,0,0
10380,2019-03-23,1602,0,1602,128,1730,1730,0,0
10381,2019-03-23,797,0,797,63,860,860,0,0
10382,2019-03-23,908,0,908,72,980,980,0,0
10383,2019-03-23,417,0,417,33,450,450,0,0
10384,2019-03-23,362,0,362,28,390,390,0,0
10385,2019-03-23,778,0,778,62,840,840,0,0
10386,2019-03-23,1815,0,1815,145,1960,1960,0,0
10387,2019-03-23,139,0,139,11,150,150,0,0
10388,2019-03-23,588,-63,525,42,567,567,0,0
10389,2019-03-23,584,0,584,46,630,630,0,0
10390,2019-03-23,1010,0,1010,80,1090,1090,0,0
10391,2019-03-23,1815,0,1815,145,1960,1960,0,0
10392,2019-03-23,1038,0,1038,82,1120,1120,0,0
10393,2019-03-23,547,0,547,43,590,590,0,0
10394,2019-03-23,463,0,463,37,500,500,0,0
10395,2019-03-23,667,0,667,53,720,720,0,0
10396,2019-03-23,630,0,630,50,680,680,0,0
10397,2019-03-23,454,0,454,36,490,490,0,0
10398,2019-03-23,482,0,482,38,520,520,0,0
10399,2019-03-23,269,0,269,21,290,290,0,0
10400,2019-03-23,510,0,510,40,550,550,0,0
10401,2019-03-23,1528,0,1528,122,1650,1650,0,0
10402,2019-03-23,1491,0,1491,119,1610,1610,0,0
10403,2019-03-23,1065,0,1065,85,1150,1150,0,0
10404,2019-03-23,788,0,788,62,850,850,0,0
10405,2019-03-23,1065,0,1065,85,1150,1150,0,0
10406,2019-03-23,1704,0,1704,136,1840,1840,0,0
10407,2019-03-23,1806,0,1806,144,1950,1950,0,0
10408,2019-03-23,788,0,788,62,850,0,850,0
10409,2019-03-23,2278,0,2278,182,2460,2460,0,0
10410,2019-03-23,213,0,213,17,230,0,230,0
10411,2019-03-23,1473,0,1473,117,1590,1590,0,0
10412,2019-03-23,176,0,176,14,190,190,0,0
10413,2019-03-23,1760,0,1760,140,1900,1900,0,0
10414,2019-03-23,445,0,445,35,480,480,0,0
10415,2019-03-23,510,0,510,40,550,550,0,0
10416,2019-03-23,760,0,760,60,820,820,0,0
10417,2019-03-23,1584,0,1584,126,1710,1710,0,0
10418,2019-03-23,278,0,278,22,300,300,0,0
10419,2019-03-23,1425,0,1425,105,1530,1530,0,0
10420,2019-03-24,315,0,315,25,340,340,0,0
10421,2019-03-24,1269,0,1269,101,1370,0,1370,0
10422,2019-03-24,908,0,908,72,980,980,0,0
10423,2019-03-24,908,0,908,72,980,980,0,0
10424,2019-03-24,538,0,538,42,580,0,580,0
10425,2019-03-24,709,0,709,56,765,765,0,0
10426,2019-03-24,723,0,723,57,780,780,0,0
10427,2019-03-24,565,0,565,45,610,610,0,0
10428,2019-03-24,269,0,269,21,290,290,0,0
10429,2019-03-24,2352,0,2352,188,2540,2540,0,0
10430,2019-03-24,1028,0,1028,82,1110,0,1110,0
10431,2019-03-24,241,0,241,19,260,260,0,0
10432,2019-03-24,1121,0,1121,89,1210,1210,0,0
10433,2019-03-24,538,0,538,42,580,580,0,0
10434,2019-03-24,676,0,676,54,730,730,0,0
10435,2019-03-24,2723,0,2723,217,2940,2940,0,0
10436,2019-03-24,908,0,908,72,980,980,0,0
10437,2019-03-24,1445,0,1445,115,1560,1560,0,0
10438,2019-03-24,908,0,908,72,980,980,0,0
10439,2019-03-24,760,0,760,60,820,820,0,0
10440,2019-03-24,769,0,769,61,830,830,0,0
10441,2019-03-24,1065,0,1065,85,1150,1150,0,0
10442,2019-03-24,204,0,204,16,220,220,0,0
10443,2019-03-24,908,0,908,72,980,980,0,0
10444,2019-03-24,602,0,602,48,650,650,0,0
10445,2019-03-24,501,0,501,39,540,540,0,0
10446,2019-03-24,908,0,908,72,980,980,0,0
10447,2019-03-24,389,0,389,31,420,420,0,0
10448,2019-03-24,747,-80,667,53,720,720,0,0
10449,2019-03-24,908,0,908,72,980,980,0,0
10450,2019-03-24,454,0,454,36,490,490,0,0
10451,2019-03-24,1936,0,1936,154,2090,2090,0,0
10452,2019-03-24,501,0,501,39,540,540,0,0
10453,2019-03-24,584,0,584,46,630,630,0,0
10454,2019-03-24,149,0,149,11,160,160,0,0
10455,2019-03-24,732,0,732,58,790,790,0,0
10456,2019-03-24,908,0,908,72,980,980,0,0
10457,2019-03-24,260,0,260,20,280,280,0,0
10458,2019-03-24,908,0,908,72,980,980,0,0
10459,2019-03-24,1213,0,1213,97,1310,0,1310,0
10460,2019-03-24,121,0,121,9,130,130,0,0
10461,2019-03-24,1101,0,1101,79,1180,1180,0,0
10462,2019-03-24,675,0,675,45,720,0,720,0
10463,2019-03-24,389,0,389,31,420,420,0,0
10464,2019-03-24,379,0,379,21,400,400,0,0
10465,2019-03-24,862,0,862,68,930,930,0,0
10466,2019-03-24,-260,0,-260,-20,-280,-280,0,0
10467,2019-03-24,1325,0,1325,105,1430,1430,0,0
10468,2019-03-24,908,0,908,72,980,980,0,0
10469,2019-03-24,2315,0,2315,185,2500,2500,0,0
10470,2019-03-24,325,0,325,25,350,350,0,0
10471,2019-03-24,445,0,445,35,480,480,0,0
10472,2019-03-24,741,0,741,59,800,800,0,0
10473,2019-03-24,473,0,473,37,510,510,0,0
10474,2019-03-24,871,0,871,69,940,940,0,0
10475,2019-03-24,1306,0,1306,104,1410,1410,0,0
10476,2019-03-24,260,0,260,20,280,280,0,0
10477,2019-03-24,371,0,371,29,400,400,0,0
10478,2019-03-24,426,0,426,34,460,460,0,0
10479,2019-03-24,908,0,908,72,980,980,0,0
10480,2019-03-24,908,0,908,72,980,980,0,0
10481,2019-03-24,501,0,501,39,540,540,0,0
10482,2019-03-24,473,0,473,37,510,510,0,0
10483,2019-03-24,889,0,889,71,960,960,0,0
10484,2019-03-24,908,0,908,72,980,980,0,0
10485,2019-03-24,982,0,982,78,1060,1060,0,0
10486,2019-03-24,815,0,815,65,880,880,0,0
10487,2019-03-24,741,0,741,59,800,800,0,0
10488,2019-03-24,1047,0,1047,83,1130,1130,0,0
10489,2019-03-24,564,0,564,36,600,600,0,0
10490,2019-03-24,426,0,426,34,460,460,0,0
10491,2019-03-24,1269,0,1269,101,1370,1370,0,0
10492,2019-03-24,1815,0,1815,145,1960,0,1960,0
10493,2019-03-24,167,0,167,13,180,180,0,0
10494,2019-03-24,250,0,250,20,270,270,0,0
10495,2019-03-24,251,0,251,19,270,270,0,0
10496,2019-03-24,908,0,908,72,980,980,0,0
10497,2019-03-24,575,0,575,45,620,620,0,0
10498,2019-03-24,2751,0,2751,219,2970,2970,0,0
10499,2019-03-24,1075,0,1075,85,1160,1160,0,0
10500,2019-03-24,630,0,630,50,680,680,0,0
10501,2019-03-24,306,0,306,24,330,330,0,0
10502,2019-03-24,260,0,260,20,280,280,0,0
10503,2019-03-24,2112,0,2112,168,2280,2280,0,0
10504,2019-03-24,399,0,399,31,430,430,0,0
10505,2019-03-24,352,0,352,28,380,380,0,0
10506,2019-03-24,167,0,167,13,180,180,0,0
10507,2019-03-24,713,0,713,57,770,770,0,0
10508,2019-03-24,170,-36,134,10,144,0,144,0
10509,2019-03-24,834,0,834,66,900,0,900,0
10510,2019-03-24,417,0,417,33,450,450,0,0
10511,2019-03-24,463,0,463,37,500,500,0,0
10512,2019-03-24,852,0,852,68,920,920,0,0
10513,2019-03-24,2130,0,2130,170,2300,2300,0,0
10514,2019-03-24,788,0,788,62,850,850,0,0
10515,2019-03-24,788,0,788,62,850,850,0,0
10516,2019-03-24,556,0,556,44,600,600,0,0
10517,2019-03-24,788,0,788,62,850,850,0,0
10518,2019-03-24,769,0,769,61,830,830,0,0
10519,2019-03-24,575,0,575,45,620,620,0,0
10520,2019-03-24,371,0,371,29,400,400,0,0
10521,2019-03-24,380,0,380,30,410,410,0,0
10522,2019-03-24,1260,0,1260,100,1360,1360,0,0
10523,2019-03-24,658,0,658,52,710,710,0,0
10524,2019-03-24,121,0,121,9,130,130,0,0
10525,2019-03-24,1038,0,1038,82,1120,1120,0,0
10526,2019-03-24,760,0,760,60,820,820,0,0
10527,2019-03-24,371,0,371,29,400,400,0,0
10528,2019-03-24,621,0,621,49,670,0,670,0
10529,2019-03-24,-602,0,-602,-48,-650,-650,0,0
10530,2019-03-24,436,0,436,34,470,470,0,0
10531,2019-03-24,1232,0,1232,98,1330,0,1330,0
10532,2019-03-24,630,0,630,50,680,680,0,0
10533,2019-03-24,1112,0,1112,88,1200,1200,0,0
10534,2019-03-24,1213,0,1213,97,1310,0,1310,0
10535,2019-03-24,1880,0,1880,150,2030,2030,0,0
10536,2019-03-24,195,0,195,15,210,210,0,0
10537,2019-03-24,1575,0,1575,125,1700,1700,0,0
10538,2019-03-24,1426,0,1426,114,1540,0,1540,0
10539,2019-03-24,1575,0,1575,125,1700,1700,0,0
10540,2019-03-24,269,0,269,21,290,290,0,0
10541,2019-03-24,149,0,149,11,160,160,0,0
10542,2019-03-24,1213,0,1213,97,1310,1310,0,0
10543,2019-03-24,2398,0,2398,182,2580,2580,0,0
10544,2019-03-24,612,0,612,48,660,660,0,0
10545,2019-03-24,149,0,149,11,160,160,0,0
10546,2019-03-24,510,0,510,40,550,550,0,0
10547,2019-03-24,260,0,260,20,280,280,0,0
10548,2019-03-24,510,0,510,40,550,550,0,0
10549,2019-03-24,334,0,334,26,360,360,0,0
10550,2019-03-24,371,0,371,29,400,400,0,0
10551,2019-03-24,269,0,269,21,290,290,0,0
10552,2019-03-24,612,0,612,48,660,660,0,0
10553,2019-03-24,426,0,426,34,460,460,0,0
10554,2019-03-24,2704,0,2704,216,2920,2920,0,0
10555,2019-03-24,1575,0,1575,125,1700,1700,0,0
10556,2019-03-24,565,0,565,45,610,610,0,0
10557,2019-03-24,315,0,315,25,340,340,0,0
10558,2019-03-24,232,0,232,18,250,250,0,0
10559,2019-03-24,362,0,362,28,390,390,0,0
10560,2019-03-24,491,0,491,39,530,530,0,0
10561,2019-03-24,797,0,797,63,860,860,0,0
10562,2019-03-24,788,0,788,62,850,850,0,0
10563,2019-03-24,1575,0,1575,125,1700,1700,0,0
10564,2019-03-24,788,0,788,62,850,850,0,0
10565,2019-03-24,1186,0,1186,94,1280,1280,0,0
10566,2019-03-24,982,0,982,78,1060,1060,0,0
10567,2019-03-24,1843,0,1843,147,1990,1990,0,0
10568,2019-03-24,1575,0,1575,125,1700,1700,0,0
10569,2019-03-24,334,0,334,26,360,360,0,0
10570,2019-03-24,1852,0,1852,148,2000,2000,0,0
10571,2019-03-24,408,0,408,32,440,440,0,0
10572,2019-03-24,1371,0,1371,109,1480,1480,0,0
10573,2019-03-24,260,0,260,20,280,280,0,0
10574,2019-03-24,2362,0,2362,188,2550,2550,0,0
10575,2019-03-24,2027,-11,2016,153,2169,2169,0,0
10576,2019-03-24,445,0,445,35,480,480,0,0
10577,2019-03-25,1149,0,1149,91,1240,1240,0,0
10578,2019-03-25,306,0,306,24,330,330,0,0
10579,2019-03-25,1167,0,1167,93,1260,1260,0,0
10580,2019-03-25,1667,0,1667,133,1800,1800,0,0
10581,2019-03-25,250,0,250,20,270,270,0,0
10582,2019-03-25,945,0,945,75,1020,1020,0,0
10583,2019-03-25,473,0,473,37,510,510,0,0
10584,2019-03-25,908,0,908,72,980,980,0,0
10585,2019-03-25,1732,0,1732,138,1870,1870,0,0
10586,2019-03-25,908,0,908,72,980,980,0,0
10587,2019-03-25,630,0,630,50,680,680,0,0
10588,2019-03-25,686,0,686,54,740,740,0,0
10589,2019-03-25,908,0,908,72,980,980,0,0
10590,2019-03-25,1121,0,1121,89,1210,1210,0,0
10591,2019-03-25,1167,0,1167,93,1260,1260,0,0
10592,2019-03-25,908,0,908,72,980,980,0,0
10593,2019-03-25,297,0,297,23,320,320,0,0
10594,2019-03-25,408,0,408,32,440,440,0,0
10595,2019-03-25,371,0,371,29,400,400,0,0
10596,2019-03-25,979,-208,771,61,832,832,0,0
10597,2019-03-25,500,0,500,40,540,540,0,0
10598,2019-03-25,741,0,741,59,800,800,0,0
10599,2019-03-25,278,0,278,22,300,300,0,0
10600,2019-03-25,371,0,371,29,400,400,0,0
10601,2019-03-25,880,0,880,70,950,950,0,0
10602,2019-03-25,593,0,593,47,640,640,0,0
10603,2019-03-25,334,0,334,26,360,360,0,0
10604,2019-03-25,602,0,602,48,650,650,0,0
10605,2019-03-25,723,0,723,57,780,780,0,0
10606,2019-03-25,945,0,945,75,1020,1020,0,0
10607,2019-03-25,908,0,908,72,980,980,0,0
10608,2019-03-25,895,0,895,45,940,940,0,0
10609,2019-03-25,2723,0,2723,217,2940,2940,0,0
10610,2019-03-25,908,0,908,72,980,980,0,0
10611,2019-03-25,741,0,741,59,800,800,0,0
10612,2019-03-25,945,0,945,75,1020,1020,0,0
10613,2019-03-25,880,0,880,70,950,0,950,0
10614,2019-03-25,473,0,473,37,510,510,0,0
10615,2019-03-25,149,0,149,11,160,160,0,0
10616,2019-03-25,1907,0,1907,152,2059,2059,0,0
10617,2019-03-25,908,0,908,72,980,980,0,0
10618,2019-03-25,232,0,232,18,250,250,0,0
10619,2019-03-25,547,0,547,43,590,590,0,0
10620,2019-03-25,482,0,482,38,520,520,0,0
10621,2019-03-25,399,0,399,31,430,430,0,0
10622,2019-03-25,639,0,639,51,690,690,0,0
10623,2019-03-25,371,0,371,29,400,400,0,0
10624,2019-03-25,426,0,426,34,460,460,0,0
10625,2019-03-25,769,0,769,61,830,830,0,0
10626,2019-03-25,167,0,167,13,180,180,0,0
10627,2019-03-25,658,0,658,52,710,710,0,0
10628,2019-03-25,889,0,889,71,960,960,0,0
10629,2019-03-25,686,0,686,54,740,740,0,0
10630,2019-03-25,982,0,982,78,1060,1060,0,0
10631,2019-03-25,834,0,834,66,900,900,0,0
10632,2019-03-25,575,0,575,45,620,620,0,0
10633,2019-03-25,1362,0,1362,108,1470,1470,0,0
10634,2019-03-25,389,0,389,31,420,420,0,0
10635,2019-03-25,473,0,473,37,510,510,0,0
10636,2019-03-25,704,0,704,56,760,760,0,0
10637,2019-03-25,593,0,593,47,640,640,0,0
10638,2019-03-25,1815,0,1815,145,1960,1960,0,0
10639,2019-03-25,241,0,241,19,260,260,0,0
10640,2019-03-25,704,0,704,56,760,760,0,0
10641,2019-03-25,408,0,408,32,440,440,0,0
10642,2019-03-25,908,0,908,72,980,980,0,0
10643,2019-03-25,260,0,260,20,280,280,0,0
10644,2019-03-25,371,0,371,29,400,400,0,0
10645,2019-03-25,565,0,565,45,610,610,0,0
10646,2019-03-25,547,0,547,43,590,590,0,0
10647,2019-03-25,741,0,741,59,800,800,0,0
10648,2019-03-25,510,0,510,40,550,550,0,0
10649,2019-03-25,379,0,379,21,400,400,0,0
10650,2019-03-25,538,0,538,42,580,580,0,0
10651,2019-03-25,806,0,806,64,870,870,0,0
10652,2019-03-25,269,0,269,21,290,290,0,0
10653,2019-03-25,1889,0,1889,151,2040,2040,0,0
10654,2019-03-25,3149,0,3149,251,3400,3400,0,0
10655,2019-03-25,936,0,936,74,1010,1010,0,0
10656,2019-03-25,2130,0,2130,170,2300,2300,0,0
10657,2019-03-25,223,0,223,17,240,240,0,0
10658,2019-03-25,1575,0,1575,125,1700,1700,0,0
10659,2019-03-25,788,0,788,62,850,850,0,0
10660,2019-03-25,788,0,788,62,850,850,0,0
10661,2019-03-25,899,0,899,71,970,970,0,0
10662,2019-03-25,2278,0,2278,182,2460,2460,0,0
10663,2019-03-25,296,0,296,14,310,310,0,0
10664,2019-03-25,1014,0,1014,81,1095,1095,0,0
10665,2019-03-25,788,0,788,62,850,850,0,0
10666,2019-03-25,362,0,362,28,390,390,0,0
10667,2019-03-25,1028,0,1028,82,1110,1110,0,0
10668,2019-03-25,269,0,269,21,290,290,0,0
10669,2019-03-25,612,0,612,48,660,660,0,0
10670,2019-03-25,686,0,686,54,740,740,0,0
10671,2019-03-25,380,0,380,30,410,410,0,0
10672,2019-03-25,362,0,362,28,390,390,0,0
10673,2019-03-25,436,0,436,34,470,470,0,0
10674,2019-03-25,954,0,954,76,1030,1030,0,0
10675,2019-03-25,657,0,657,43,700,700,0,0
10676,2019-03-25,741,0,741,59,800,800,0,0
10677,2019-03-25,371,0,371,29,400,400,0,0
10678,2019-03-25,371,0,371,29,400,400,0,0
10679,2019-03-25,926,0,926,74,1000,1000,0,0
10680,2019-03-25,825,0,825,65,890,890,0,0
10681,2019-03-25,232,0,232,18,250,250,0,0
10682,2019-03-25,362,0,362,28,390,390,0,0
10683,2019-03-25,982,0,982,78,1060,1060,0,0
10684,2019-03-25,1093,-1000,93,7,100,100,0,0
10685,2019-03-25,1575,0,1575,125,1700,1700,0,0
10686,2019-03-25,788,0,788,62,850,850,0,0
10687,2019-03-25,834,0,834,66,900,900,0,0
10688,2019-03-25,1444,0,1444,106,1550,1550,0,0
10689,2019-03-25,314,0,314,16,330,330,0,0
10690,2019-03-25,1815,0,1815,145,1960,1960,0,0
10691,2019-03-25,723,0,723,57,780,780,0,0
10692,2019-03-25,1546,0,1546,114,1660,1660,0,0
10693,2019-03-25,538,0,538,42,580,580,0,0
10694,2019-03-25,4538,0,4538,362,4900,4900,0,0
10695,2019-03-25,926,0,926,74,1000,0,1000,0
10696,2019-03-25,315,0,315,25,340,340,0,0
10697,2019-03-25,315,0,315,25,340,340,0,0
10698,2019-03-25,1658,0,1658,132,1790,1790,0,0
10699,2019-03-25,1232,0,1232,98,1330,1330,0,0
10700,2019-03-25,1047,0,1047,83,1130,1130,0,0
10701,2019-03-25,583,0,583,37,620,620,0,0
10702,2019-03-25,908,0,908,72,980,980,0,0
10703,2019-03-25,519,0,519,41,560,0,560,0
10704,2019-03-25,538,0,538,42,580,580,0,0
10705,2019-03-25,1815,0,1815,145,1960,1960,0,0
10706,2019-03-25,473,0,473,37,510,510,0,0
10707,2019-03-25,741,0,741,59,800,800,0,0
10708,2019-03-25,1667,0,1667,133,1800,1800,0,0
10709,2019-03-25,1019,0,1019,81,1100,1100,0,0
10710,2019-03-25,490,0,490,30,520,520,0,0
10711,2019-03-25,417,0,417,33,450,450,0,0
10712,2019-03-25,1325,0,1325,105,1430,1430,0,0
10713,2019-03-25,695,0,695,55,750,750,0,0
10714,2019-03-25,2223,0,2223,177,2400,2400,0,0
10715,2019-03-25,987,0,987,78,1065,1065,0,0
10716,2019-03-25,445,0,445,35,480,480,0,0
10717,2019-03-25,315,0,315,25,340,340,0,0
10718,2019-03-25,1112,0,1112,88,1200,1200,0,0
10719,2019-03-25,1232,0,1232,98,1330,1330,0,0
10720,2019-03-25,794,-85,709,56,765,765,0,0
10721,2019-03-25,491,0,491,39,530,530,0,0
10722,2019-03-25,176,0,176,14,190,190,0,0
10723,2019-03-26,667,0,667,53,720,720,0,0
10724,2019-03-26,1010,0,1010,80,1090,1090,0,0
10725,2019-03-26,223,0,223,17,240,240,0,0
10726,2019-03-26,352,0,352,28,380,380,0,0
10727,2019-03-26,834,0,834,66,900,900,0,0
10728,2019-03-26,1602,0,1602,128,1730,1730,0,0
10729,2019-03-26,269,0,269,21,290,290,0,0
10730,2019-03-26,343,0,343,27,370,370,0,0
10731,2019-03-26,371,0,371,29,400,400,0,0
10732,2019-03-26,325,0,325,25,350,350,0,0
10733,2019-03-26,436,0,436,34,470,470,0,0
10734,2019-03-26,417,0,417,33,450,450,0,0
10735,2019-03-26,602,0,602,48,650,650,0,0
10736,2019-03-26,491,0,491,39,530,530,0,0
10737,2019-03-26,362,0,362,28,390,390,0,0
10738,2019-03-26,1065,0,1065,85,1150,1150,0,0
10739,2019-03-26,676,0,676,54,730,730,0,0
10740,2019-03-26,732,0,732,58,790,790,0,0
10741,2019-03-26,426,0,426,34,460,460,0,0
10742,2019-03-26,963,0,963,77,1040,1040,0,0
10743,2019-03-26,102,0,102,8,110,110,0,0
10744,2019-03-26,260,0,260,20,280,280,0,0
10745,2019-03-26,1945,0,1945,155,2100,2100,0,0
10746,2019-03-26,371,0,371,29,400,400,0,0
10747,2019-03-26,399,0,399,31,430,430,0,0
10748,2019-03-26,1093,0,1093,87,1180,1180,0,0
10749,2019-03-26,982,0,982,78,1060,1060,0,0
10750,2019-03-26,232,0,232,18,250,250,0,0
10751,2019-03-26,297,0,297,23,320,320,0,0
10752,2019-03-26,908,0,908,72,980,980,0,0
10753,2019-03-27,584,0,584,46,630,630,0,0
10754,2019-03-27,139,0,139,11,150,150,0,0
10755,2019-03-27,213,0,213,17,230,230,0,0
10756,2019-03-27,436,0,436,34,470,470,0,0
10757,2019-03-27,2102,0,2102,168,2270,2270,0,0
10758,2019-03-27,935,0,935,65,1000,1000,0,0
10759,2019-03-27,491,0,491,39,530,530,0,0
10760,2019-03-27,167,0,167,13,180,180,0,0
10761,2019-03-27,721,0,721,57,778,778,0,0
10762,2019-03-27,102,0,102,8,110,110,0,0
10763,2019-03-27,1408,0,1408,112,1520,1520,0,0
10764,2019-03-27,1112,0,1112,88,1200,1200,0,0
10765,2019-03-27,547,0,547,43,590,590,0,0
10766,2019-03-27,769,0,769,61,830,830,0,0
10767,2019-03-27,788,0,788,62,850,850,0,0
10768,2019-03-27,232,0,232,18,250,250,0,0
10769,2019-03-27,297,0,297,23,320,320,0,0
10770,2019-03-27,288,0,288,22,310,310,0,0
10771,2019-03-27,862,0,862,68,930,930,0,0
10772,2019-03-27,556,0,556,44,600,600,0,0
10773,2019-03-27,482,0,482,38,520,520,0,0
10774,2019-03-27,204,0,204,16,220,220,0,0
10775,2019-03-27,1176,0,1176,94,1270,1270,0,0
10776,2019-03-27,1547,0,1547,123,1670,1670,0,0
10777,2019-03-27,778,0,778,62,840,840,0,0
10778,2019-03-27,473,0,473,37,510,510,0,0
10779,2019-03-27,491,0,491,39,530,530,0,0
10780,2019-03-27,769,0,769,61,830,830,0,0
10781,2019-03-27,251,0,251,19,270,270,0,0
10782,2019-03-27,1001,0,1001,79,1080,1080,0,0
10783,2019-03-27,139,0,139,11,150,150,0,0
10784,2019-03-27,510,0,510,40,550,550,0,0
10785,2019-03-27,102,0,102,8,110,110,0,0
10786,2019-03-27,760,0,760,60,820,820,0,0
10787,2019-03-27,259,0,259,11,270,270,0,0
10788,2019-03-27,657,0,657,43,700,700,0,0
10789,2019-03-27,269,0,269,21,290,290,0,0
10790,2019-03-27,777,0,777,53,830,830,0,0
10791,2019-03-27,389,0,389,31,420,420,0,0
10792,2019-03-27,815,0,815,65,880,880,0,0
10793,2019-03-27,1093,0,1093,87,1180,1180,0,0
10794,2019-03-27,1815,0,1815,145,1960,1960,0,0
10795,2019-03-27,519,0,519,41,560,560,0,0
10796,2019-03-27,908,0,908,72,980,980,0,0
10797,2019-03-27,593,0,593,47,640,640,0,0
10798,2019-03-27,269,0,269,21,290,290,0,0
10799,2019-03-27,491,0,491,39,530,530,0,0
10800,2019-03-27,149,0,149,11,160,160,0,0
10801,2019-03-27,704,0,704,56,760,760,0,0
10802,2019-03-27,1815,0,1815,145,1960,1960,0,0
10803,2019-03-27,501,0,501,39,540,540,0,0
10804,2019-03-27,93,0,93,7,100,100,0,0
10805,2019-03-27,741,0,741,59,800,800,0,0
10806,2019-03-27,926,0,926,74,1000,1000,0,0
10807,2019-03-27,47,0,47,3,50,50,0,0
10808,2019-03-27,1499,0,1499,111,1610,1610,0,0
10809,2019-03-27,1130,0,1130,90,1220,1220,0,0
10810,2019-03-27,2723,0,2723,217,2940,2940,0,0
10811,2019-03-27,1575,0,1575,125,1700,1700,0,0
10812,2019-03-27,658,0,658,52,710,710,0,0
10813,2019-03-27,621,0,621,49,670,670,0,0
10814,2019-03-27,315,0,315,25,340,340,0,0
10815,2019-03-27,491,0,491,39,530,530,0,0
10816,2019-03-27,2047,0,2047,163,2210,2210,0,0
10817,2019-03-27,1343,0,1343,107,1450,1450,0,0
10818,2019-03-27,306,0,306,24,330,330,0,0
10819,2019-03-27,788,0,788,62,850,850,0,0
10820,2019-03-27,751,0,751,59,810,810,0,0
10821,2019-03-27,501,0,501,39,540,540,0,0
10822,2019-03-27,704,0,704,56,760,760,0,0
10823,2019-03-27,6713,0,6713,537,7250,0,7250,0
10824,2019-03-27,788,0,788,62,850,850,0,0
10825,2019-03-27,426,0,426,34,460,460,0,0
10826,2019-03-27,926,0,926,74,1000,1000,0,0
10827,2019-03-27,621,0,621,49,670,670,0,0
10828,2019-03-27,1852,0,1852,148,2000,2000,0,0
10829,2019-03-27,2575,0,2575,205,2780,2780,0,0
10830,2019-03-27,788,0,788,62,850,850,0,0
10831,2019-03-27,788,0,788,62,850,850,0,0
10832,2019-03-27,788,0,788,62,850,850,0,0
10833,2019-03-27,380,0,380,30,410,410,0,0
10834,2019-03-27,1575,0,1575,125,1700,1700,0,0
10835,2019-03-27,3149,0,3149,251,3400,3400,0,0
10836,2019-03-27,297,0,297,23,320,320,0,0
10837,2019-03-27,306,0,306,24,330,330,0,0
10838,2019-03-27,1334,0,1334,106,1440,1440,0,0
10839,2019-03-27,917,0,917,73,990,990,0,0
10840,2019-03-27,899,0,899,71,970,970,0,0
10841,2019-03-27,1399,0,1399,111,1510,1510,0,0
10842,2019-03-27,320,-68,252,20,272,272,0,0
10843,2019-03-27,510,0,510,40,550,550,0,0
10844,2019-03-27,547,0,547,43,590,590,0,0
10845,2019-03-27,1982,0,1982,158,2140,2140,0,0
10846,2019-03-27,1065,0,1065,85,1150,1150,0,0
10847,2019-03-27,852,0,852,68,920,920,0,0
10848,2019-03-27,1149,0,1149,91,1240,1240,0,0
10849,2019-03-27,723,0,723,57,780,780,0,0
10850,2019-03-27,908,0,908,72,980,980,0,0
10851,2019-03-27,908,0,908,72,980,980,0,0
10852,2019-03-27,908,0,908,72,980,980,0,0
10853,2019-03-27,676,0,676,54,730,730,0,0
10854,2019-03-27,527,0,527,33,560,560,0,0
10855,2019-03-27,880,0,880,70,950,950,0,0
10856,2019-03-27,695,0,695,55,750,750,0,0
10857,2019-03-27,2723,0,2723,217,2940,0,2940,0
10858,2019-03-27,1139,0,1139,91,1230,1230,0,0
10859,2019-03-27,399,0,399,31,430,430,0,0
10860,2019-03-27,249,0,249,11,260,260,0,0
10861,2019-03-27,491,0,491,39,530,530,0,0
10862,2019-03-27,1334,0,1334,106,1440,1440,0,0
10863,2019-03-27,2889,0,2889,231,3120,3120,0,0
10864,2019-03-27,908,0,908,72,980,980,0,0
10865,2019-03-27,352,0,352,28,380,380,0,0
10866,2019-03-27,1815,0,1815,145,1960,1960,0,0
10867,2019-03-28,676,0,676,54,730,730,0,0
10868,2019-03-28,1842,0,1842,138,1980,1980,0,0
10869,2019-03-28,1213,0,1213,97,1310,1310,0,0
10870,2019-03-28,500,0,500,40,540,540,0,0
10871,2019-03-28,888,0,888,62,950,950,0,0
10872,2019-03-28,1815,0,1815,145,1960,1960,0,0
10873,2019-03-28,723,0,723,57,780,780,0,0
10874,2019-03-28,1139,0,1139,91,1230,1230,0,0
10875,2019-03-28,1815,0,1815,145,1960,1960,0,0
10876,2019-03-28,3630,0,3630,290,3920,3920,0,0
10877,2019-03-28,2175,-233,1942,155,2097,2097,0,0
10878,2019-03-28,1815,0,1815,145,1960,1960,0,0
10879,2019-03-28,723,0,723,57,780,780,0,0
10880,2019-03-28,1065,0,1065,85,1150,1150,0,0
10881,2019-03-28,519,0,519,41,560,560,0,0
10882,2019-03-28,593,0,593,47,640,640,0,0
10883,2019-03-28,1065,0,1065,85,1150,1150,0,0
10884,2019-03-28,2723,0,2723,217,2940,2940,0,0
10885,2019-03-28,389,0,389,31,420,0,420,0
10886,2019-03-28,908,0,908,72,980,980,0,0
10887,2019-03-28,899,0,899,71,970,970,0,0
10888,2019-03-28,1112,0,1112,88,1200,1200,0,0
10889,2019-03-28,1362,0,1362,108,1470,1470,0,0
10890,2019-03-28,288,0,288,22,310,310,0,0
10891,2019-03-28,1223,0,1223,97,1320,1320,0,0
10892,2019-03-28,1213,0,1213,97,1310,1310,0,0
10893,2019-03-28,1621,0,1621,129,1750,1750,0,0
10894,2019-03-28,223,0,223,17,240,240,0,0
10895,2019-03-28,269,0,269,21,290,290,0,0
10896,2019-03-28,232,0,232,18,250,250,0,0
10897,2019-03-28,908,0,908,72,980,980,0,0
10898,2019-03-28,1815,0,1815,145,1960,1960,0,0
10899,2019-03-28,380,0,380,30,410,410,0,0
10900,2019-03-28,389,0,389,31,420,420,0,0
10901,2019-03-28,556,0,556,44,600,600,0,0
10902,2019-03-28,1232,0,1232,98,1330,1330,0,0
10903,2019-03-28,399,0,399,31,430,430,0,0
10904,2019-03-28,1815,0,1815,145,1960,1960,0,0
10905,2019-03-28,204,0,204,16,220,220,0,0
10906,2019-03-28,334,0,334,26,360,360,0,0
10907,2019-03-28,676,0,676,54,730,730,0,0
10908,2019-03-28,889,0,889,71,960,960,0,0
10909,2019-03-28,621,0,621,49,670,670,0,0
10910,2019-03-28,1334,0,1334,106,1440,1440,0,0
10911,2019-03-28,251,0,251,19,270,270,0,0
10912,2019-03-28,408,0,408,32,440,440,0,0
10913,2019-03-28,925,0,925,65,990,990,0,0
10914,2019-03-28,862,0,862,68,930,930,0,0
10915,2019-03-28,167,0,167,13,180,0,180,0
10916,2019-03-28,1547,0,1547,123,1670,1670,0,0
10917,2019-03-28,426,0,426,34,460,460,0,0
10918,2019-03-28,121,0,121,9,130,130,0,0
10919,2019-03-28,241,0,241,19,260,260,0,0
10920,2019-03-28,269,0,269,21,290,290,0,0
10921,2019-03-28,241,0,241,19,260,260,0,0
10922,2019-03-28,417,0,417,33,450,450,0,0
10923,2019-03-28,815,0,815,65,880,880,0,0
10924,2019-03-28,1093,0,1093,87,1180,1180,0,0
10925,2019-03-28,1278,0,1278,102,1380,1380,0,0
10926,2019-03-28,871,0,871,69,940,940,0,0
10927,2019-03-28,501,0,501,39,540,540,0,0
10928,2019-03-28,325,0,325,25,350,350,0,0
10929,2019-03-28,407,0,407,23,430,430,0,0
10930,2019-03-28,1038,0,1038,82,1120,1120,0,0
10931,2019-03-28,343,0,343,27,370,370,0,0
10932,2019-03-28,1056,0,1056,84,1140,1140,0,0
10933,2019-03-28,676,0,676,54,730,730,0,0
10934,2019-03-28,538,0,538,42,580,580,0,0
10935,2019-03-28,862,0,862,68,930,930,0,0
10936,2019-03-28,362,0,362,28,390,390,0,0
10937,2019-03-28,1815,0,1815,145,1960,1960,0,0
10938,2019-03-28,1445,0,1445,115,1560,1560,0,0
10939,2019-03-28,1093,0,1093,87,1180,1180,0,0
10940,2019-03-28,658,0,658,52,710,710,0,0
10941,2019-03-28,445,0,445,35,480,480,0,0
10942,2019-03-28,1130,0,1130,90,1220,1220,0,0
10943,2019-03-28,204,0,204,16,220,220,0,0
10944,2019-03-28,602,0,602,48,650,650,0,0
10945,2019-03-28,880,0,880,70,950,950,0,0
10946,2019-03-28,342,0,342,18,360,360,0,0
10947,2019-03-28,491,0,491,39,530,530,0,0
10948,2019-03-28,241,0,241,19,260,260,0,0
10949,2019-03-28,704,0,704,56,760,760,0,0
10950,2019-03-28,880,0,880,70,950,950,0,0
10951,2019-03-28,510,0,510,40,550,550,0,0
10952,2019-03-28,908,0,908,72,980,980,0,0
10953,2019-03-28,491,0,491,39,530,530,0,0
10954,2019-03-28,269,0,269,21,290,290,0,0
10955,2019-03-28,556,0,556,44,600,600,0,0
10956,2019-03-28,1575,0,1575,125,1700,1700,0,0
10957,2019-03-28,612,0,612,48,660,660,0,0
10958,2019-03-28,2788,0,2788,222,3010,3010,0,0
10959,2019-03-28,2788,0,2788,222,3010,3010,0,0
10960,2019-03-28,-2788,0,-2788,-222,-3010,-3010,0,0
10961,2019-03-28,584,0,584,46,630,630,0,0
10962,2019-03-28,362,0,362,28,390,390,0,0
10963,2019-03-28,306,0,306,24,330,330,0,0
10964,2019-03-28,1251,0,1251,99,1350,1350,0,0
10965,2019-03-28,870,0,870,60,930,930,0,0
10966,2019-03-28,352,0,352,28,380,380,0,0
10967,2019-03-28,2130,0,2130,170,2300,0,2300,0
10968,2019-03-28,788,0,788,62,850,850,0,0
10969,2019-03-28,899,0,899,71,970,970,0,0
10970,2019-03-28,473,0,473,37,510,510,0,0
10971,2019-03-28,1112,0,1112,88,1200,1200,0,0
10972,2019-03-28,436,0,436,34,470,470,0,0
10973,2019-03-28,249,0,249,11,260,260,0,0
10974,2019-03-28,487,0,487,38,525,525,0,0
10975,2019-03-28,269,0,269,21,290,290,0,0
10976,2019-03-28,1306,0,1306,104,1410,1410,0,0
10977,2019-03-28,260,0,260,20,280,280,0,0
10978,2019-03-28,510,0,510,40,550,550,0,0
10979,2019-03-28,47,0,47,3,50,50,0,0
10980,2019-03-28,1352,0,1352,108,1460,1460,0,0
10981,2019-03-28,982,0,982,78,1060,0,1060,0
10982,2019-03-28,991,0,991,79,1070,1070,0,0
10983,2019-03-28,843,0,843,67,910,910,0,0
10984,2019-03-28,362,0,362,28,390,390,0,0
10985,2019-03-28,121,0,121,9,130,130,0,0
10986,2019-03-28,56,0,56,4,60,60,0,0
10987,2019-03-28,1612,0,1612,128,1740,1740,0,0
10988,2019-03-28,352,0,352,28,380,380,0,0
10989,2019-03-28,639,0,639,51,690,690,0,0
10990,2019-03-28,1760,0,1760,140,1900,1900,0,0
10991,2019-03-28,343,0,343,27,370,370,0,0
10992,2019-03-28,973,0,973,77,1050,1050,0,0
10993,2019-03-28,602,0,602,48,650,650,0,0
10994,2019-03-28,769,0,769,61,830,830,0,0
10995,2019-03-28,283,0,283,22,305,305,0,0
10996,2019-03-28,788,0,788,62,850,850,0,0
10997,2019-03-28,482,0,482,38,520,520,0,0
10998,2019-03-28,1232,0,1232,98,1330,1330,0,0
10999,2019-03-28,232,0,232,18,250,250,0,0
11000,2019-03-28,463,0,463,37,500,500,0,0
11001,2019-03-28,1815,0,1815,145,1960,1960,0,0
11002,2019-03-28,1658,0,1658,132,1790,1790,0,0
11003,2019-03-28,343,0,343,27,370,370,0,0
11004,2019-03-28,149,0,149,11,160,160,0,0
11005,2019-03-28,1815,0,1815,145,1960,1960,0,0
11006,2019-03-28,1815,0,1815,145,1960,1960,0,0
11007,2019-03-28,741,0,741,59,800,800,0,0
11008,2019-03-28,908,0,908,72,980,0,980,0
11009,2019-03-28,149,0,149,11,160,160,0,0
11010,2019-03-28,1815,0,1815,145,1960,0,1960,0
11011,2019-03-28,908,0,908,72,980,980,0,0
11012,2019-03-28,908,0,908,72,980,980,0,0
11013,2019-03-28,352,0,352,28,380,380,0,0
11014,2019-03-28,908,0,908,72,980,980,0,0
11015,2019-03-28,491,0,491,39,530,530,0,0
11016,2019-03-28,806,0,806,64,870,870,0,0
11017,2019-03-28,1815,0,1815,145,1960,1960,0,0
11018,2019-03-28,490,0,490,30,520,520,0,0
11019,2019-03-28,110,0,110,0,110,110,0,0
11020,2019-03-28,1815,0,1815,145,1960,1960,0,0
11021,2019-03-28,871,0,871,69,940,940,0,0
11022,2019-03-28,277,0,277,13,290,290,0,0
11023,2019-03-28,351,0,351,19,370,370,0,0
11024,2019-03-28,1473,0,1473,117,1590,1590,0,0
11025,2019-03-28,1359,0,1359,91,1450,1450,0,0
11026,2019-03-28,306,0,306,24,330,330,0,0
11027,2019-03-28,139,0,139,11,150,150,0,0
11028,2019-03-28,519,0,519,41,560,560,0,0
11029,2019-03-28,167,0,167,13,180,180,0,0
11030,2019-03-28,1584,0,1584,126,1710,1710,0,0
11031,2019-03-28,834,0,834,66,900,900,0,0
11032,2019-03-28,510,0,510,40,550,550,0,0
11033,2019-03-28,945,0,945,75,1020,0,1020,0
11034,2019-03-28,630,0,630,50,680,680,0,0
11035,2019-03-28,723,0,723,57,780,780,0,0
11036,2019-03-28,306,0,306,24,330,330,0,0
11037,2019-03-28,556,0,556,44,600,600,0,0
11038,2019-03-29,-1390,0,-1390,-110,-1500,-1500,0,0
11039,2019-03-29,4213,0,4213,337,4550,4550,0,0
11040,2019-03-29,1917,0,1917,153,2070,2070,0,0
11041,2019-03-29,593,0,593,47,640,640,0,0
11042,2019-03-29,695,0,695,55,750,750,0,0
11043,2019-03-29,825,0,825,65,890,890,0,0
11044,2019-03-29,1093,0,1093,87,1180,1180,0,0
11045,2019-03-29,417,0,417,33,450,450,0,0
11046,2019-03-29,908,0,908,72,980,0,980,0
11047,2019-03-29,1343,0,1343,107,1450,1450,0,0
11048,2019-03-29,825,0,825,65,890,890,0,0
11049,2019-03-29,815,0,815,65,880,880,0,0
11050,2019-03-29,139,0,139,11,150,150,0,0
11051,2019-03-29,760,0,760,60,820,820,0,0
11052,2019-03-29,1686,0,1686,134,1820,1820,0,0
11053,2019-03-29,343,0,343,27,370,370,0,0
11054,2019-03-29,1047,0,1047,83,1130,1130,0,0
11055,2019-03-29,621,0,621,49,670,670,0,0
11056,2019-03-29,1075,0,1075,85,1160,1160,0,0
11057,2019-03-29,2056,0,2056,164,2220,2220,0,0
11058,2019-03-29,2325,0,2325,185,2510,2510,0,0
11059,2019-03-29,102,0,102,8,110,110,0,0
11060,2019-03-29,871,0,871,69,940,940,0,0
11061,2019-03-29,1102,0,1102,88,1190,1190,0,0
11062,2019-03-29,806,0,806,64,870,870,0,0
11063,2019-03-29,1158,0,1158,92,1250,1250,0,0
11064,2019-03-29,5445,0,5445,435,5880,5880,0,0
11065,2019-03-29,491,0,491,39,530,530,0,0
11066,2019-03-29,906,0,906,54,960,960,0,0
11067,2019-03-29,389,0,389,31,420,420,0,0
11068,2019-03-29,1815,0,1815,145,1960,1960,0,0
11069,2019-03-29,436,0,436,34,470,470,0,0
11070,2019-03-29,723,0,723,57,780,780,0,0
11071,2019-03-29,880,0,880,70,950,950,0,0
11072,2019-03-29,945,0,945,75,1020,1020,0,0
11073,2019-03-29,630,0,630,50,680,680,0,0
11074,2019-03-29,833,0,833,57,890,890,0,0
11075,2019-03-29,1203,0,1203,87,1290,1290,0,0
11076,2019-03-29,751,0,751,59,810,810,0,0
11077,2019-03-29,1639,0,1639,131,1770,1770,0,0
11078,2019-03-29,2638,0,2638,202,2840,2840,0,0
11079,2019-03-29,371,0,371,29,400,400,0,0
11080,2019-03-29,362,0,362,28,390,390,0,0
11081,2019-03-29,755,0,755,60,815,815,0,0
11082,2019-03-29,758,0,758,42,800,800,0,0
11083,2019-03-29,1251,0,1251,99,1350,1350,0,0
11084,2019-03-29,695,0,695,55,750,750,0,0
11085,2019-03-29,445,0,445,35,480,480,0,0
11086,2019-03-29,329,0,329,26,355,355,0,0
11087,2019-03-29,2010,0,2010,160,2170,2170,0,0
11088,2019-03-29,445,0,445,35,480,480,0,0
11089,2019-03-29,658,0,658,52,710,710,0,0
11090,2019-03-29,547,0,547,43,590,590,0,0
11091,2019-03-29,186,0,186,14,200,200,0,0
11092,2019-03-29,232,0,232,18,250,250,0,0
11093,2019-03-29,825,0,825,65,890,890,0,0
11094,2019-03-29,667,0,667,53,720,720,0,0
11095,2019-03-29,1065,0,1065,85,1150,1150,0,0
11096,2019-03-29,723,0,723,57,780,780,0,0
11097,2019-03-29,1676,0,1676,134,1810,1810,0,0
11098,2019-03-29,223,0,223,17,240,240,0,0
11099,2019-03-29,306,0,306,24,330,330,0,0
11100,2019-03-29,593,0,593,47,640,640,0,0
11101,2019-03-29,371,0,371,29,400,400,0,0
11102,2019-03-29,2010,0,2010,160,2170,2170,0,0
11103,2019-03-29,2723,0,2723,217,2940,2940,0,0
11104,2019-03-29,639,0,639,51,690,690,0,0
11105,2019-03-29,704,0,704,56,760,0,760,0
11106,2019-03-29,251,0,251,19,270,270,0,0
11107,2019-03-29,741,0,741,59,800,800,0,0
11108,2019-03-29,519,0,519,41,560,560,0,0
11109,2019-03-29,167,0,167,13,180,180,0,0
11110,2019-03-29,445,0,445,35,480,480,0,0
11111,2019-03-29,260,0,260,20,280,280,0,0
11112,2019-03-29,130,0,130,10,140,140,0,0
11113,2019-03-29,176,0,176,14,190,190,0,0
11114,2019-03-29,1482,0,1482,118,1600,1600,0,0
11115,2019-03-29,565,0,565,45,610,610,0,0
11116,2019-03-29,825,0,825,65,890,890,0,0
11117,2019-03-29,399,0,399,31,430,430,0,0
11118,2019-03-29,575,0,575,45,620,620,0,0
11119,2019-03-29,806,0,806,64,870,870,0,0
11120,2019-03-29,1260,0,1260,100,1360,1360,0,0
11121,2019-03-29,843,0,843,67,910,910,0,0
11122,2019-03-29,908,0,908,72,980,980,0,0
11123,2019-03-29,334,0,334,26,360,360,0,0
11124,2019-03-29,306,0,306,24,330,330,0,0
11125,2019-03-29,538,0,538,42,580,580,0,0
11126,2019-03-29,1575,0,1575,125,1700,1700,0,0
11127,2019-03-29,1695,0,1695,135,1830,1830,0,0
11128,2019-03-29,2038,0,2038,162,2200,2200,0,0
11129,2019-03-29,278,0,278,22,300,300,0,0
11130,2019-03-29,834,0,834,66,900,0,900,0
11131,2019-03-29,3195,0,3195,255,3450,3450,0,0
11132,2019-03-29,1732,0,1732,138,1870,1870,0,0
11133,2019-03-29,371,0,371,29,400,400,0,0
11134,2019-03-29,1575,0,1575,125,1700,1700,0,0
11135,2019-03-29,482,0,482,38,520,520,0,0
11136,2019-03-29,167,0,167,13,180,180,0,0
11137,2019-03-29,704,0,704,56,760,760,0,0
11138,2019-03-29,769,0,769,61,830,830,0,0
11139,2019-03-29,501,0,501,39,540,540,0,0
11140,2019-03-29,1241,0,1241,99,1340,1340,0,0
11141,2019-03-29,584,0,584,46,630,630,0,0
11142,2019-03-29,788,0,788,62,850,850,0,0
11143,2019-03-29,825,0,825,65,890,890,0,0
11144,2019-03-29,167,0,167,13,180,180,0,0
11145,2019-03-29,797,0,797,63,860,860,0,0
11146,2019-03-29,3149,0,3149,251,3400,0,3400,0
11147,2019-03-29,732,0,732,58,790,790,0,0
11148,2019-03-29,723,0,723,57,780,780,0,0
11149,2019-03-29,1371,0,1371,109,1480,1480,0,0
11150,2019-03-29,658,0,658,52,710,710,0,0
11151,2019-03-29,676,0,676,54,730,730,0,0
11152,2019-03-29,732,0,732,58,790,790,0,0
11153,2019-03-29,722,0,722,48,770,770,0,0
11154,2019-03-29,334,0,334,26,360,360,0,0
11155,2019-03-29,815,0,815,65,880,880,0,0
11156,2019-03-29,436,0,436,34,470,470,0,0
11157,2019-03-29,788,0,788,62,850,850,0,0
11158,2019-03-29,149,0,149,11,160,160,0,0
11159,2019-03-29,686,0,686,54,740,740,0,0
11160,2019-03-29,149,0,149,11,160,160,0,0
11161,2019-03-29,658,0,658,52,710,710,0,0
11162,2019-03-29,602,0,602,48,650,650,0,0
11163,2019-03-29,852,0,852,68,920,920,0,0
11164,2019-03-29,223,0,223,17,240,240,0,0
11165,2019-03-29,547,0,547,43,590,590,0,0
11166,2019-03-29,584,0,584,46,630,630,0,0
11167,2019-03-29,1575,0,1575,125,1700,1700,0,0
11168,2019-03-29,741,0,741,59,800,800,0,0
11169,2019-03-29,473,0,473,37,510,510,0,0
11170,2019-03-29,371,0,371,29,400,400,0,0
11171,2019-03-29,936,0,936,74,1010,1010,0,0
11172,2019-03-29,1426,0,1426,114,1540,1540,0,0
11173,2019-03-29,1065,0,1065,85,1150,1150,0,0
11174,2019-03-29,436,0,436,34,470,470,0,0
11175,2019-03-29,1575,0,1575,125,1700,1700,0,0
11176,2019-03-29,1426,0,1426,114,1540,1540,0,0
11177,2019-03-29,1740,0,1740,130,1870,1870,0,0
11178,2019-03-29,417,0,417,33,450,450,0,0
11179,2019-03-29,1491,0,1491,119,1610,1610,0,0
11180,2019-03-29,723,0,723,57,780,780,0,0
11181,2019-03-29,1815,0,1815,145,1960,1960,0,0
11182,2019-03-29,510,0,510,40,550,550,0,0
11183,2019-03-29,176,0,176,14,190,190,0,0
11184,2019-03-29,1260,0,1260,100,1360,1360,0,0
11185,2019-03-29,945,0,945,75,1020,1020,0,0
11186,2019-03-29,1406,0,1406,94,1500,0,1500,0
11187,2019-03-29,454,0,454,36,490,490,0,0
11188,2019-03-29,1093,0,1093,87,1180,1180,0,0
11189,2019-03-29,519,0,519,41,560,560,0,0
11190,2019-03-29,528,0,528,42,570,570,0,0
11191,2019-03-29,269,0,269,21,290,290,0,0
11192,2019-03-29,751,0,751,59,810,810,0,0
11193,2019-03-29,232,0,232,18,250,250,0,0
11194,2019-03-29,1852,0,1852,148,2000,2000,0,0
11195,2019-03-29,445,0,445,35,480,480,0,0
11196,2019-03-29,649,0,649,51,700,700,0,0
11197,2019-03-29,1084,0,1084,86,1170,1170,0,0
11198,2019-03-29,952,0,952,58,1010,1010,0,0
11199,2019-03-29,1084,0,1084,86,1170,1170,0,0
11200,2019-03-29,788,0,788,62,850,850,0,0
11201,2019-03-29,473,0,473,37,510,510,0,0
11202,2019-03-29,501,0,501,39,540,540,0,0
11203,2019-03-29,510,0,510,40,550,550,0,0
11204,2019-03-29,584,0,584,46,630,630,0,0
11205,2019-03-29,704,0,704,56,760,760,0,0
11206,2019-03-29,1704,0,1704,136,1840,1840,0,0
11207,2019-03-29,565,0,565,45,610,610,0,0
11208,2019-03-29,639,0,639,51,690,690,0,0
11209,2019-03-29,778,0,778,62,840,840,0,0
11210,2019-03-29,297,0,297,23,320,320,0,0
11211,2019-03-29,417,0,417,33,450,450,0,0
11212,2019-03-30,667,0,667,53,720,720,0,0
11213,2019-03-30,399,0,399,31,430,430,0,0
11214,2019-03-30,1815,0,1815,145,1960,1960,0,0
11215,2019-03-30,1157,0,1157,83,1240,1240,0,0
11216,2019-03-30,852,0,852,68,920,920,0,0
11217,2019-03-30,963,0,963,77,1040,1040,0,0
11218,2019-03-30,658,0,658,52,710,710,0,0
11219,2019-03-30,1473,0,1473,117,1590,1590,0,0
11220,2019-03-30,519,0,519,41,560,560,0,0
11221,2019-03-30,676,0,676,54,730,730,0,0
11222,2019-03-30,389,0,389,31,420,420,0,0
11223,2019-03-30,741,0,741,59,800,800,0,0
11224,2019-03-30,334,0,334,26,360,360,0,0
11225,2019-03-30,593,0,593,47,640,640,0,0
11226,2019-03-30,1815,0,1815,145,1960,1960,0,0
11227,2019-03-30,917,0,917,73,990,990,0,0
11228,2019-03-30,389,0,389,31,420,420,0,0
11229,2019-03-30,343,0,343,27,370,370,0,0
11230,2019-03-30,862,0,862,68,930,930,0,0
11231,2019-03-30,445,0,445,35,480,480,0,0
11232,2019-03-30,667,0,667,53,720,720,0,0
11233,2019-03-30,1815,0,1815,145,1960,1960,0,0
11234,2019-03-30,593,0,593,47,640,640,0,0
11235,2019-03-30,1815,0,1815,145,1960,1960,0,0
11236,2019-03-30,1111,0,1111,79,1190,1190,0,0
11237,2019-03-30,2121,0,2121,169,2290,2290,0,0
11238,2019-03-30,917,0,917,73,990,990,0,0
11239,2019-03-30,288,0,288,22,310,310,0,0
11240,2019-03-30,288,0,288,22,310,310,0,0
11241,2019-03-30,1065,0,1065,85,1150,1150,0,0
11242,2019-03-30,1815,0,1815,145,1960,1960,0,0
11243,2019-03-30,501,0,501,39,540,540,0,0
11244,2019-03-30,1815,0,1815,145,1960,1960,0,0
11245,2019-03-30,1380,0,1380,110,1490,1490,0,0
11246,2019-03-30,501,0,501,39,540,540,0,0
11247,2019-03-30,584,0,584,46,630,630,0,0
11248,2019-03-30,176,0,176,14,190,190,0,0
11249,2019-03-30,908,0,908,72,980,980,0,0
11250,2019-03-30,1815,0,1815,145,1960,1960,0,0
11251,2019-03-30,389,0,389,31,420,420,0,0
11252,2019-03-30,527,0,527,33,560,560,0,0
11253,2019-03-30,204,0,204,16,220,220,0,0
11254,2019-03-30,362,0,362,28,390,390,0,0
11255,2019-03-30,1945,0,1945,155,2100,2100,0,0
11256,2019-03-30,241,0,241,19,260,260,0,0
11257,2019-03-30,723,0,723,57,780,780,0,0
11258,2019-03-30,815,0,815,65,880,880,0,0
11259,2019-03-30,2038,0,2038,162,2200,2200,0,0
11260,2019-03-30,334,0,334,26,360,360,0,0
11261,2019-03-30,732,0,732,58,790,790,0,0
11262,2019-03-30,925,0,925,65,990,990,0,0
11263,2019-03-30,167,0,167,13,180,180,0,0
11264,2019-03-30,602,0,602,48,650,650,0,0
11265,2019-03-30,565,0,565,45,610,610,0,0
11266,2019-03-30,1658,0,1658,132,1790,1790,0,0
11267,2019-03-30,630,0,630,50,680,680,0,0
11268,2019-03-30,416,0,416,24,440,440,0,0
11269,2019-03-30,1213,0,1213,97,1310,1310,0,0
11270,2019-03-30,982,0,982,78,1060,1060,0,0
11271,2019-03-30,491,0,491,39,530,530,0,0
11272,2019-03-30,260,0,260,20,280,280,0,0
11273,2019-03-30,871,0,871,69,940,940,0,0
11274,2019-03-30,732,0,732,58,790,790,0,0
11275,2019-03-30,306,0,306,24,330,330,0,0
11276,2019-03-30,371,0,371,29,400,400,0,0
11277,2019-03-30,362,0,362,28,390,390,0,0
11278,2019-03-30,399,0,399,31,430,430,0,0
11279,2019-03-30,436,0,436,34,470,0,470,0
11280,2019-03-30,362,0,362,28,390,390,0,0
11281,2019-03-30,112,0,112,8,120,120,0,0
11282,2019-03-30,538,0,538,42,580,580,0,0
11283,2019-03-30,704,0,704,56,760,760,0,0
11284,2019-03-30,213,0,213,17,230,230,0,0
11285,2019-03-30,389,0,389,31,420,420,0,0
11286,2019-03-30,1815,0,1815,145,1960,1960,0,0
11287,2019-03-30,362,0,362,28,390,390,0,0
11288,2019-03-30,880,0,880,70,950,950,0,0
11289,2019-03-30,1815,0,1815,145,1960,1960,0,0
11290,2019-03-30,1815,0,1815,145,1960,1960,0,0
11291,2019-03-30,788,0,788,62,850,850,0,0
11292,2019-03-30,501,0,501,39,540,540,0,0
11293,2019-03-30,2465,-264,2201,175,2376,2376,0,0
11294,2019-03-30,408,0,408,32,440,440,0,0
11295,2019-03-30,334,0,334,26,360,360,0,0
11296,2019-03-30,371,0,371,29,400,400,0,0
11297,2019-03-30,325,0,325,25,350,350,0,0
11298,2019-03-30,343,0,343,27,370,370,0,0
11299,2019-03-30,1815,0,1815,145,1960,1960,0,0
11300,2019-03-30,325,0,325,25,350,350,0,0
11301,2019-03-30,110,0,110,0,110,110,0,0
11302,2019-03-30,269,0,269,21,290,290,0,0
11303,2019-03-30,565,0,565,45,610,610,0,0
11304,2019-03-30,1297,0,1297,103,1400,1400,0,0
11305,2019-03-30,926,0,926,74,1000,1000,0,0
11306,2019-03-30,1278,0,1278,102,1380,1380,0,0
11307,2019-03-30,2204,0,2204,176,2380,2380,0,0
11308,2019-03-30,1195,0,1195,95,1290,1290,0,0
11309,2019-03-30,343,0,343,27,370,370,0,0
11310,2019-03-30,306,0,306,24,330,330,0,0
11311,2019-03-30,843,0,843,67,910,910,0,0
11312,2019-03-30,167,0,167,13,180,180,0,0
11313,2019-03-30,1001,0,1001,79,1080,1080,0,0
11314,2019-03-30,269,0,269,21,290,290,0,0
11315,2019-03-30,1408,0,1408,112,1520,1520,0,0
11316,2019-03-30,2473,0,2473,197,2670,2670,0,0
11317,2019-03-30,371,0,371,29,400,400,0,0
11318,2019-03-30,195,0,195,15,210,0,210,0
11319,2019-03-30,223,0,223,17,240,240,0,0
11320,2019-03-30,2371,0,2371,189,2560,2560,0,0
11321,2019-03-30,602,0,602,48,650,650,0,0
11322,2019-03-30,306,0,306,24,330,330,0,0
11323,2019-03-30,575,0,575,45,620,620,0,0
11324,2019-03-30,380,0,380,30,410,410,0,0
11325,2019-03-30,1575,0,1575,125,1700,1700,0,0
11326,2019-03-30,2362,0,2362,188,2550,2550,0,0
11327,2019-03-30,1625,-174,1451,115,1566,1566,0,0
11328,2019-03-30,1102,0,1102,88,1190,1190,0,0
11329,2019-03-30,3748,0,3748,282,4030,4030,0,0
11330,2019-03-30,1186,0,1186,94,1280,1280,0,0
11331,2019-03-30,2445,0,2445,195,2640,2640,0,0
11332,2019-03-30,788,0,788,62,850,850,0,0
11333,2019-03-30,3500,0,3500,280,3780,0,3780,0
11334,2019-03-30,788,0,788,62,850,850,0,0
11335,2019-03-30,315,0,315,25,340,340,0,0
11336,2019-03-30,334,0,334,26,360,360,0,0
11337,2019-03-30,741,0,741,59,800,800,0,0
11338,2019-03-30,565,0,565,45,610,610,0,0
11339,2019-03-30,278,0,278,22,300,300,0,0
11340,2019-03-30,1065,0,1065,85,1150,1150,0,0
11341,2019-03-30,843,0,843,67,910,910,0,0
11342,2019-03-30,491,0,491,39,530,530,0,0
11343,2019-03-30,371,0,371,29,400,400,0,0
11344,2019-03-30,1084,0,1084,86,1170,1170,0,0
11345,2019-03-30,704,0,704,56,760,760,0,0
11346,2019-03-30,269,0,269,21,290,290,0,0
11347,2019-03-30,834,0,834,66,900,900,0,0
11348,2019-03-30,565,0,565,45,610,610,0,0
11349,2019-03-30,908,0,908,72,980,980,0,0
11350,2019-03-30,186,0,186,14,200,200,0,0
11351,2019-03-30,880,0,880,70,950,950,0,0
11352,2019-03-30,788,0,788,62,850,850,0,0
11353,2019-03-30,630,0,630,50,680,680,0,0
11354,2019-03-30,695,0,695,55,750,750,0,0
11355,2019-03-30,741,0,741,59,800,800,0,0
11356,2019-03-30,102,0,102,8,110,110,0,0
11357,2019-03-30,741,0,741,59,800,800,0,0
11358,2019-03-30,473,0,473,37,510,510,0,0
11359,2019-03-30,278,0,278,22,300,300,0,0
11360,2019-03-30,760,0,760,60,820,820,0,0
11361,2019-03-30,167,0,167,13,180,180,0,0
11362,2019-03-30,1139,0,1139,91,1230,1230,0,0
11363,2019-03-30,654,-70,584,46,630,630,0,0
11364,2019-03-30,269,0,269,21,290,290,0,0
11365,2019-03-30,1130,0,1130,90,1220,1220,0,0
11366,2019-03-30,1036,0,1036,74,1110,1110,0,0
11367,2019-03-30,417,0,417,33,450,450,0,0
11368,2019-03-30,1389,0,1389,111,1500,1500,0,0
11369,2019-03-30,251,0,251,19,270,270,0,0
11370,2019-03-30,463,0,463,37,500,500,0,0
11371,2019-03-30,2723,0,2723,217,2940,2940,0,0
11372,2019-03-30,2019,0,2019,161,2180,2180,0,0
11373,2019-03-30,1815,0,1815,145,1960,1960,0,0
11374,2019-03-30,1001,0,1001,79,1080,1080,0,0
11375,2019-03-30,1297,0,1297,103,1400,1400,0,0
11376,2019-03-30,417,0,417,33,450,450,0,0
11377,2019-03-30,908,0,908,72,980,980,0,0
11378,2019-03-30,862,0,862,68,930,930,0,0
11379,2019-03-30,584,0,584,46,630,630,0,0
11380,2019-03-30,908,0,908,72,980,980,0,0
11381,2019-03-30,908,0,908,72,980,980,0,0
11382,2019-03-30,1038,0,1038,82,1120,1120,0,0
11383,2019-03-30,1593,0,1593,127,1720,1720,0,0
11384,2019-03-30,556,0,556,44,600,600,0,0
11385,2019-03-30,908,0,908,72,980,980,0,0
11386,2019-03-30,473,0,473,37,510,510,0,0
11387,2019-03-30,806,0,806,64,870,0,870,0
11388,2019-03-30,1575,0,1575,125,1700,1700,0,0
11389,2019-03-30,306,0,306,24,330,330,0,0
11390,2019-03-30,704,0,704,56,760,760,0,0
11391,2019-03-30,649,0,649,51,700,700,0,0
11392,2019-03-30,510,0,510,40,550,550,0,0
11393,2019-03-30,788,0,788,62,850,850,0,0
11394,2019-03-30,1575,0,1575,125,1700,1700,0,0
11395,2019-03-30,778,0,778,62,840,840,0,0
11396,2019-03-30,1667,0,1667,133,1800,1800,0,0
11397,2019-03-30,1575,0,1575,125,1700,1700,0,0
11398,2019-03-30,916,0,916,64,980,980,0,0
11399,2019-03-30,565,0,565,45,610,610,0,0
11400,2019-03-30,343,0,343,27,370,370,0,0
11401,2019-03-30,482,0,482,38,520,520,0,0
11402,2019-03-30,769,0,769,61,830,830,0,0
11403,2019-03-30,1028,0,1028,82,1110,1110,0,0
11404,2019-03-30,463,0,463,37,500,500,0,0
11405,2019-03-30,2713,0,2713,217,2930,2930,0,0
11406,2019-03-30,1149,0,1149,91,1240,1240,0,0
11407,2019-03-30,139,0,139,11,150,150,0,0
11408,2019-03-30,1038,0,1038,82,1120,1120,0,0
11409,2019-03-30,269,0,269,21,290,290,0,0
11410,2019-03-31,158,0,158,12,170,170,0,0
11411,2019-03-31,260,0,260,20,280,280,0,0
11412,2019-03-31,556,0,556,44,600,600,0,0
11413,2019-03-31,908,0,908,72,980,980,0,0
11414,2019-03-31,306,0,306,24,330,330,0,0
11415,2019-03-31,398,0,398,22,420,420,0,0
11416,2019-03-31,399,0,399,31,430,430,0,0
11417,2019-03-31,445,0,445,35,480,480,0,0
11418,2019-03-31,380,0,380,30,410,410,0,0
11419,2019-03-31,667,0,667,53,720,720,0,0
11420,2019-03-31,806,0,806,64,870,870,0,0
11421,2019-03-31,149,0,149,11,160,160,0,0
11422,2019-03-31,797,0,797,63,860,0,860,0
11423,2019-03-31,1315,0,1315,105,1420,1420,0,0
11424,2019-03-31,704,0,704,56,760,760,0,0
11425,2019-03-31,908,0,908,72,980,980,0,0
11426,2019-03-31,908,0,908,72,980,980,0,0
11427,2019-03-31,797,0,797,63,860,860,0,0
11428,2019-03-31,139,0,139,11,150,150,0,0
11429,2019-03-31,278,0,278,22,300,300,0,0
11430,2019-03-31,1815,0,1815,145,1960,1960,0,0
11431,2019-03-31,2723,0,2723,217,2940,2940,0,0
11432,2019-03-31,1176,0,1176,94,1270,1270,0,0
11433,2019-03-31,1260,0,1260,100,1360,1360,0,0
11434,2019-03-31,945,0,945,75,1020,1020,0,0
11435,2019-03-31,1473,0,1473,117,1590,1590,0,0
11436,2019-03-31,1352,0,1352,108,1460,1460,0,0
11437,2019-03-31,232,0,232,18,250,250,0,0
11438,2019-03-31,1167,0,1167,93,1260,1260,0,0
11439,2019-03-31,112,0,112,8,120,120,0,0
11440,2019-03-31,149,0,149,11,160,160,0,0
11441,2019-03-31,1380,0,1380,110,1490,1490,0,0
11442,2019-03-31,1612,0,1612,128,1740,1740,0,0
11443,2019-03-31,343,0,343,27,370,370,0,0
11444,2019-03-31,676,0,676,54,730,730,0,0
11445,2019-03-31,672,-72,600,48,648,648,0,0
11446,2019-03-31,1704,0,1704,136,1840,1840,0,0
11447,2019-03-31,1482,0,1482,118,1600,1600,0,0
11448,2019-03-31,908,0,908,72,980,980,0,0
11449,2019-03-31,454,0,454,36,490,490,0,0
11450,2019-03-31,472,0,472,28,500,500,0,0
11451,2019-03-31,908,0,908,72,980,980,0,0
11452,2019-03-31,491,0,491,39,530,530,0,0
11453,2019-03-31,306,0,306,24,330,330,0,0
11454,2019-03-31,936,0,936,74,1010,1010,0,0
11455,2019-03-31,575,0,575,45,620,620,0,0
11456,2019-03-31,1139,0,1139,91,1230,1230,0,0
11457,2019-03-31,1815,0,1815,145,1960,1960,0,0
11458,2019-03-31,139,0,139,11,150,150,0,0
11459,2019-03-31,232,0,232,18,250,250,0,0
11460,2019-03-31,1601,0,1601,119,1720,0,1720,0
11461,2019-03-31,676,0,676,54,730,730,0,0
11462,2019-03-31,575,0,575,45,620,620,0,0
11463,2019-03-31,538,0,538,42,580,580,0,0
11464,2019-03-31,732,0,732,58,790,790,0,0
11465,2019-03-31,1667,0,1667,133,1800,1800,0,0
11466,2019-03-31,936,0,936,74,1010,1010,0,0
11467,2019-03-31,871,0,871,69,940,0,940,0
11468,2019-03-31,1176,0,1176,94,1270,1270,0,0
11469,2019-03-31,1195,0,1195,95,1290,1290,0,0
11470,2019-03-31,612,0,612,48,660,660,0,0
11471,2019-03-31,1352,0,1352,108,1460,1460,0,0
11472,2019-03-31,436,0,436,34,470,470,0,0
11473,2019-03-31,389,0,389,31,420,420,0,0
11474,2019-03-31,1084,0,1084,86,1170,1170,0,0
11475,2019-03-31,425,0,425,25,450,450,0,0
11476,2019-03-31,648,0,648,42,690,690,0,0
11477,2019-03-31,518,0,518,32,550,550,0,0
11478,2019-03-31,788,0,788,62,850,850,0,0
11479,2019-03-31,1038,0,1038,82,1120,1120,0,0
11480,2019-03-31,186,0,186,14,200,200,0,0
11481,2019-03-31,945,0,945,75,1020,1020,0,0
11482,2019-03-31,389,0,389,31,420,420,0,0
11483,2019-03-31,473,0,473,37,510,510,0,0
11484,2019-03-31,834,0,834,66,900,900,0,0
11485,2019-03-31,232,0,232,18,250,250,0,0
11486,2019-03-31,1334,0,1334,106,1440,0,1440,0
11487,2019-03-31,213,0,213,17,230,230,0,0
11488,2019-03-31,769,0,769,61,830,830,0,0
11489,2019-03-31,371,0,371,29,400,400,0,0
11490,2019-03-31,1473,0,1473,117,1590,1590,0,0
11491,2019-03-31,519,0,519,41,560,560,0,0
11492,2019-03-31,491,0,491,39,530,530,0,0
11493,2019-03-31,306,0,306,24,330,330,0,0
11494,2019-03-31,463,0,463,37,500,0,500,0
11495,2019-03-31,3519,0,3519,281,3800,3800,0,0
11496,2019-03-31,1139,0,1139,91,1230,1230,0,0
11497,2019-03-31,908,0,908,72,980,980,0,0
11498,2019-03-31,468,0,468,37,505,505,0,0
11499,2019-03-31,223,0,223,17,240,240,0,0
11500,2019-03-31,547,0,547,43,590,590,0,0
11501,2019-03-31,176,0,176,14,190,190,0,0
11502,2019-03-31,815,0,815,65,880,880,0,0
11503,2019-03-31,362,0,362,28,390,390,0,0
11504,2019-03-31,843,0,843,67,910,910,0,0
11505,2019-03-31,1852,0,1852,148,2000,2000,0,0
11506,2019-03-31,2584,0,2584,206,2790,2790,0,0
11507,2019-03-31,695,0,695,55,750,750,0,0
11508,2019-03-31,825,0,825,65,890,890,0,0
11509,2019-03-31,260,0,260,20,280,280,0,0
11510,2019-03-31,490,0,490,30,520,520,0,0
11511,2019-03-31,510,0,510,40,550,550,0,0
11512,2019-03-31,1288,0,1288,102,1390,1390,0,0
11513,2019-03-31,371,0,371,29,400,400,0,0
11514,2019-03-31,1334,0,1334,106,1440,1440,0,0
11515,2019-03-31,1065,0,1065,85,1150,1150,0,0
11516,2019-03-31,1167,0,1167,93,1260,1260,0,0
11517,2019-03-31,732,0,732,58,790,790,0,0
11518,2019-03-31,352,0,352,28,380,380,0,0
11519,2019-03-31,1001,0,1001,79,1080,1080,0,0
11520,2019-03-31,510,0,510,40,550,550,0,0
11521,2019-03-31,1028,0,1028,82,1110,1110,0,0
11522,2019-03-31,352,0,352,28,380,380,0,0
11523,2019-03-31,463,0,463,37,500,500,0,0
11524,2019-03-31,2167,0,2167,173,2340,2340,0,0
11525,2019-03-31,1010,0,1010,80,1090,1090,0,0
11526,2019-03-31,658,0,658,52,710,710,0,0
11527,2019-03-31,139,0,139,11,150,150,0,0
11528,2019-03-31,723,0,723,57,780,780,0,0
11529,2019-03-31,751,0,751,59,810,810,0,0
11530,2019-03-31,491,0,491,39,530,530,0,0
11531,2019-03-31,602,0,602,48,650,650,0,0
11532,2019-03-31,445,0,445,35,480,480,0,0
11533,2019-03-31,1065,0,1065,85,1150,1150,0,0
11534,2019-03-31,139,0,139,11,150,150,0,0
11535,2019-03-31,343,0,343,27,370,370,0,0
11536,2019-03-31,565,0,565,45,610,610,0,0
11537,2019-03-31,352,0,352,28,380,380,0,0
11538,2019-03-31,1047,0,1047,83,1130,1130,0,0
11539,2019-03-31,510,0,510,40,550,550,0,0
11540,2019-03-31,1075,0,1075,85,1160,1160,0,0
11541,2019-03-31,436,0,436,34,470,470,0,0
11542,2019-03-31,102,0,102,8,110,110,0,0
11543,2019-03-31,741,0,741,59,800,800,0,0
11544,2019-03-31,889,0,889,71,960,960,0,0
11545,2019-03-31,982,0,982,78,1060,0,1060,0
11546,2019-03-31,371,0,371,29,400,400,0,0
11547,2019-03-31,1408,0,1408,112,1520,1520,0,0
11548,2019-03-31,574,-122,452,36,488,488,0,0
11549,2019-03-31,843,0,843,67,910,910,0,0
11550,2019-03-31,112,0,112,8,120,120,0,0
11551,2019-03-31,306,0,306,24,330,330,0,0
11552,2019-03-31,408,0,408,32,440,440,0,0
11553,2019-03-31,481,0,481,29,510,510,0,0
11554,2019-03-31,695,0,695,55,750,750,0,0
11555,2019-03-31,639,0,639,51,690,690,0,0
11556,2019-03-31,306,0,306,24,330,330,0,0
11557,2019-03-31,463,0,463,37,500,500,0,0
11558,2019-03-31,1575,0,1575,125,1700,1700,0,0
11559,2019-03-31,797,0,797,63,860,860,0,0
11560,2019-03-31,-250,0,-250,-20,-270,-270,0,0
11561,2019-03-31,1362,0,1362,108,1470,1470,0,0
11562,2019-03-31,1815,0,1815,145,1960,1960,0,0
11563,2019-03-31,1186,0,1186,94,1280,1280,0,0
11564,2019-03-31,834,0,834,66,900,900,0,0
11565,2019-03-31,288,0,288,22,310,310,0,0
11566,2019-03-31,454,0,454,36,490,490,0,0
11567,2019-03-31,408,0,408,32,440,440,0,0
11568,2019-03-31,501,0,501,39,540,540,0,0
11569,2019-03-31,1028,0,1028,82,1110,1110,0,0
11570,2019-03-31,536,0,536,34,570,570,0,0
11571,2019-03-31,278,0,278,22,300,300,0,0
11572,2019-03-31,1426,0,1426,114,1540,1540,0,0
11573,2019-03-31,982,0,982,78,1060,1060,0,0
11574,2019-03-31,741,0,741,59,800,800,0,0
11575,2019-03-31,778,0,778,62,840,840,0,0
11576,2019-03-31,1575,0,1575,125,1700,1700,0,0
11577,2019-03-31,528,0,528,42,570,570,0,0
11578,2019-03-31,1704,0,1704,136,1840,1840,0,0
11579,2019-03-31,371,0,371,29,400,400,0,0
11580,2019-03-31,454,0,454,36,490,490,0,0
11581,2019-03-31,1139,0,1139,91,1230,1230,0,0
11582,2019-03-31,760,0,760,60,820,820,0,0
11583,2019-03-31,1575,0,1575,125,1700,1700,0,0
11584,2019-03-31,1417,0,1417,113,1530,0,1530,0
11585,2019-03-31,-1417,0,-1417,-113,-1530,-1530,0,0
11586,2019-03-31,676,0,676,54,730,730,0,0
11587,2019-03-31,463,0,463,37,500,500,0,0
11588,2019-03-31,1084,0,1084,86,1170,1170,0,0
11589,2019-03-31,602,0,602,48,650,650,0,0
11590,2019-03-31,797,0,797,63,860,860,0,0
11591,2019-03-31,2499,0,2499,191,2690,2690,0,0
11592,2019-03-31,1417,0,1417,113,1530,1530,0,0
11593,2019-03-31,936,0,936,74,1010,1010,0,0
11594,2019-04-01,825,0,825,65,890,890,0,0
11595,2019-04-01,908,0,908,72,980,980,0,0
11596,2019-04-01,579,-62,517,41,558,558,0,0
11597,2019-04-01,908,0,908,72,980,980,0,0
11598,2019-04-01,1084,0,1084,86,1170,1170,0,0
11599,2019-04-01,1121,0,1121,89,1210,1210,0,0
11600,2019-04-01,1213,0,1213,97,1310,1310,0,0
11601,2019-04-01,602,0,602,48,650,650,0,0
11602,2019-04-01,204,0,204,16,220,220,0,0
11603,2019-04-01,908,0,908,72,980,980,0,0
11604,2019-04-01,425,0,425,25,450,450,0,0
11605,2019-04-01,47,0,47,3,50,50,0,0
11606,2019-04-01,445,0,445,35,480,480,0,0
11607,2019-04-01,1815,0,1815,145,1960,1960,0,0
11608,2019-04-01,602,0,602,48,650,650,0,0
11609,2019-04-01,908,0,908,72,980,980,0,0
11610,2019-04-01,1982,0,1982,158,2140,0,2140,0
11611,2019-04-01,1991,0,1991,159,2150,2150,0,0
11612,2019-04-01,908,0,908,72,980,980,0,0
11613,2019-04-01,1676,0,1676,134,1810,1810,0,0
11614,2019-04-01,112,0,112,8,120,120,0,0
11615,2019-04-01,362,0,362,28,390,390,0,0
11616,2019-04-01,751,0,751,59,810,810,0,0
11617,2019-04-01,723,0,723,57,780,780,0,0
11618,2019-04-01,371,0,371,29,400,400,0,0
11619,2019-04-01,908,0,908,72,980,980,0,0
11620,2019-04-01,362,0,362,28,390,390,0,0
11621,2019-04-01,908,0,908,72,980,980,0,0
11622,2019-04-01,1815,0,1815,145,1960,1960,0,0
11623,2019-04-01,917,0,917,73,990,990,0,0
11624,2019-04-01,399,0,399,31,430,430,0,0
11625,2019-04-01,260,0,260,20,280,280,0,0
11626,2019-04-01,1815,0,1815,145,1960,1960,0,0
11627,2019-04-01,769,0,769,61,830,830,0,0
11628,2019-04-01,288,0,288,22,310,310,0,0
11629,2019-04-01,232,0,232,18,250,250,0,0
11630,2019-04-01,538,0,538,42,580,580,0,0
11631,2019-04-01,1065,0,1065,85,1150,1150,0,0
11632,2019-04-01,445,0,445,35,480,480,0,0
11633,2019-04-01,1288,0,1288,102,1390,1390,0,0
11634,2019-04-01,371,0,371,29,400,400,0,0
11635,2019-04-01,2306,0,2306,184,2490,2490,0,0
11636,2019-04-01,204,0,204,16,220,220,0,0
11637,2019-04-01,1038,0,1038,82,1120,1120,0,0
11638,2019-04-01,1027,0,1027,73,1100,0,1100,0
11639,2019-04-01,1547,0,1547,123,1670,1670,0,0
11640,2019-04-01,1010,0,1010,80,1090,1090,0,0
11641,2019-04-01,954,0,954,76,1030,1030,0,0
11642,2019-04-01,1047,0,1047,83,1130,1130,0,0
11643,2019-04-01,1538,0,1538,122,1660,1660,0,0
11644,2019-04-01,778,0,778,62,840,840,0,0
11645,2019-04-01,519,0,519,41,560,560,0,0
11646,2019-04-01,834,0,834,66,900,900,0,0
11647,2019-04-01,1075,0,1075,85,1160,1160,0,0
11648,2019-04-01,433,-92,341,27,368,368,0,0
11649,2019-04-01,973,0,973,77,1050,1050,0,0
11650,2019-04-01,423,0,423,33,456,456,0,0
11651,2019-04-01,149,0,149,11,160,160,0,0
11652,2019-04-01,1093,0,1093,87,1180,1180,0,0
11653,2019-04-01,399,0,399,31,430,430,0,0
11654,2019-04-01,1924,0,1924,136,2060,2060,0,0
11655,2019-04-01,1362,0,1362,108,1470,1470,0,0
11656,2019-04-01,639,0,639,51,690,690,0,0
11657,2019-04-01,352,0,352,28,380,380,0,0
11658,2019-04-01,2658,0,2658,212,2870,2870,0,0
11659,2019-04-01,371,0,371,29,400,400,0,0
11660,2019-04-01,723,0,723,57,780,780,0,0
11661,2019-04-01,306,0,306,24,330,330,0,0
11662,2019-04-01,936,0,936,74,1010,1010,0,0
11663,2019-04-01,360,0,360,20,380,380,0,0
11664,2019-04-01,658,0,658,52,710,710,0,0
11665,2019-04-01,1065,0,1065,85,1150,1150,0,0
11666,2019-04-01,1575,0,1575,125,1700,1700,0,0
11667,2019-04-01,788,0,788,62,850,850,0,0
11668,2019-04-01,186,0,186,14,200,200,0,0
11669,2019-04-01,176,0,176,14,190,190,0,0
11670,2019-04-01,788,0,788,62,850,850,0,0
11671,2019-04-01,788,0,788,62,850,850,0,0
11672,2019-04-01,139,0,139,11,150,150,0,0
11673,2019-04-01,157,0,157,3,160,160,0,0
11674,2019-04-01,519,0,519,41,560,560,0,0
11675,2019-04-01,713,0,713,57,770,770,0,0
11676,2019-04-01,1575,0,1575,125,1700,1700,0,0
11677,2019-04-01,269,0,269,21,290,290,0,0
11678,2019-04-01,176,0,176,14,190,190,0,0
11679,2019-04-01,1093,0,1093,87,1180,1180,0,0
11680,2019-04-01,612,0,612,48,660,660,0,0
11681,2019-04-01,815,0,815,65,880,880,0,0
11682,2019-04-01,269,0,269,21,290,290,0,0
11683,2019-04-01,1010,0,1010,80,1090,1090,0,0
11684,2019-04-01,325,0,325,25,350,350,0,0
11685,2019-04-01,93,0,93,7,100,100,0,0
11686,2019-04-01,399,0,399,31,430,430,0,0
11687,2019-04-01,399,0,399,31,430,430,0,0
11688,2019-04-01,426,0,426,34,460,460,0,0
11689,2019-04-01,269,0,269,21,290,290,0,0
11690,2019-04-01,556,0,556,44,600,600,0,0
11691,2019-04-01,501,0,501,39,540,540,0,0
11692,2019-04-01,1232,0,1232,98,1330,1330,0,0
11693,2019-04-01,491,0,491,39,530,530,0,0
11694,2019-04-01,1186,0,1186,94,1280,1280,0,0
11695,2019-04-01,1102,0,1102,88,1190,1190,0,0
11696,2019-04-01,2352,0,2352,188,2540,2540,0,0
11697,2019-04-01,4538,0,4538,362,4900,4900,0,0
11698,2019-04-01,297,0,297,23,320,320,0,0
11699,2019-04-01,954,0,954,76,1030,1030,0,0
11700,2019-04-01,843,0,843,67,910,910,0,0
11701,2019-04-01,223,0,223,17,240,240,0,0
11702,2019-04-01,621,0,621,49,670,670,0,0
11703,2019-04-01,278,0,278,22,300,300,0,0
11704,2019-04-01,399,0,399,31,430,430,0,0
11705,2019-04-01,223,0,223,17,240,240,0,0
11706,2019-04-01,2038,0,2038,162,2200,2200,0,0
11707,2019-04-01,667,0,667,53,720,720,0,0
11708,2019-04-01,510,0,510,40,550,550,0,0
11709,2019-04-01,538,0,538,42,580,580,0,0
11710,2019-04-01,908,0,908,72,980,980,0,0
11711,2019-04-01,741,0,741,59,800,800,0,0
11712,2019-04-01,1205,-256,949,75,1024,1024,0,0
11713,2019-04-01,241,0,241,19,260,260,0,0
11714,2019-04-01,593,0,593,47,640,640,0,0
11715,2019-04-01,-1186,0,-1186,-94,-1280,-1280,0,0
11716,2019-04-01,1704,0,1704,136,1840,1840,0,0
11717,2019-04-01,269,0,269,21,290,290,0,0
11718,2019-04-01,482,0,482,38,520,520,0,0
11719,2019-04-01,278,0,278,22,300,300,0,0
11720,2019-04-01,806,0,806,64,870,870,0,0
11721,2019-04-01,139,0,139,11,150,150,0,0
11722,2019-04-01,1093,0,1093,87,1180,1180,0,0
11723,2019-04-01,639,0,639,51,690,690,0,0
11724,2019-04-01,936,0,936,74,1010,1010,0,0
11725,2019-04-01,1575,0,1575,125,1700,1700,0,0
11726,2019-04-02,2093,0,2093,167,2260,2260,0,0
11727,2019-04-02,556,0,556,44,600,600,0,0
11728,2019-04-02,1889,0,1889,151,2040,2040,0,0
11729,2019-04-02,408,0,408,32,440,440,0,0
11730,2019-04-02,519,0,519,41,560,560,0,0
11731,2019-04-02,584,0,584,46,630,630,0,0
11732,2019-04-02,547,0,547,43,590,590,0,0
11733,2019-04-02,463,0,463,37,500,500,0,0
11734,2019-04-02,1491,0,1491,119,1610,1610,0,0
11735,2019-04-02,232,0,232,18,250,250,0,0
11736,2019-04-02,445,0,445,35,480,480,0,0
11737,2019-04-02,491,0,491,39,530,530,0,0
11738,2019-04-02,371,0,371,29,400,400,0,0
11739,2019-04-02,241,0,241,19,260,260,0,0
11740,2019-04-02,811,0,811,64,875,875,0,0
11741,2019-04-02,945,0,945,75,1020,1020,0,0
11742,2019-04-02,797,0,797,63,860,860,0,0
11743,2019-04-02,741,0,741,59,800,800,0,0
11744,2019-04-02,519,0,519,41,560,560,0,0
11745,2019-04-02,730,0,730,40,770,770,0,0
11746,2019-04-02,732,0,732,58,790,790,0,0
11747,2019-04-02,462,0,462,28,490,490,0,0
11748,2019-04-03,1695,0,1695,135,1830,1830,0,0
11749,2019-04-03,908,0,908,72,980,980,0,0
11750,2019-04-03,463,0,463,37,500,500,0,0
11751,2019-04-03,1259,0,1259,91,1350,1350,0,0
11752,2019-04-03,1130,0,1130,90,1220,1220,0,0
11753,2019-04-03,1176,0,1176,94,1270,1270,0,0
11754,2019-04-03,1176,0,1176,94,1270,1270,0,0
11755,2019-04-03,1482,0,1482,118,1600,1600,0,0
11756,2019-04-03,926,0,926,74,1000,1000,0,0
11757,2019-04-03,908,0,908,72,980,980,0,0
11758,2019-04-03,1371,0,1371,109,1480,1480,0,0
11759,2019-04-03,172,0,172,13,185,185,0,0
11760,2019-04-03,297,0,297,23,320,320,0,0
11761,2019-04-03,278,0,278,22,300,300,0,0
11762,2019-04-03,445,0,445,35,480,480,0,0
11763,2019-04-03,259,0,259,11,270,270,0,0
11764,2019-04-03,1556,0,1556,124,1680,0,1680,0
11765,2019-04-03,778,0,778,62,840,840,0,0
11766,2019-04-03,167,0,167,13,180,180,0,0
11767,2019-04-03,1769,0,1769,141,1910,1910,0,0
11768,2019-04-03,936,0,936,74,1010,1010,0,0
11769,2019-04-03,686,0,686,54,740,740,0,0
11770,2019-04-03,788,0,788,62,850,850,0,0
11771,2019-04-03,334,0,334,26,360,360,0,0
11772,2019-04-03,1065,0,1065,85,1150,1150,0,0
11773,2019-04-03,2723,0,2723,217,2940,2940,0,0
11774,2019-04-03,1528,0,1528,122,1650,1650,0,0
11775,2019-04-03,1815,0,1815,145,1960,1960,0,0
11776,2019-04-03,315,0,315,25,340,340,0,0
11777,2019-04-03,713,0,713,57,770,770,0,0
11778,2019-04-03,334,0,334,26,360,360,0,0
11779,2019-04-03,463,0,463,37,500,500,0,0
11780,2019-04-03,362,0,362,28,390,390,0,0
11781,2019-04-03,723,0,723,57,780,780,0,0
11782,2019-04-03,1510,0,1510,120,1630,1630,0,0
11783,2019-04-03,1139,0,1139,91,1230,1230,0,0
11784,2019-04-03,648,0,648,42,690,690,0,0
11785,2019-04-03,1362,0,1362,108,1470,1470,0,0
11786,2019-04-03,362,0,362,28,390,390,0,0
11787,2019-04-03,704,0,704,56,760,760,0,0
11788,2019-04-03,306,0,306,24,330,330,0,0
11789,2019-04-03,1380,0,1380,110,1490,1490,0,0
11790,2019-04-03,908,0,908,72,980,980,0,0
11791,2019-04-03,482,0,482,38,520,520,0,0
11792,2019-04-03,1815,0,1815,145,1960,1960,0,0
11793,2019-04-03,157,0,157,3,160,160,0,0
11794,2019-04-03,399,0,399,31,430,430,0,0
11795,2019-04-03,1260,0,1260,100,1360,1360,0,0
11796,2019-04-03,1075,0,1075,85,1160,1160,0,0
11797,2019-04-03,713,0,713,57,770,0,770,0
11798,2019-04-03,843,0,843,67,910,910,0,0
11799,2019-04-03,463,0,463,37,500,500,0,0
11800,2019-04-03,371,0,371,29,400,400,0,0
11801,2019-04-03,445,0,445,35,480,480,0,0
11802,2019-04-03,510,0,510,40,550,550,0,0
11803,2019-04-03,602,0,602,48,650,650,0,0
11804,2019-04-03,973,0,973,77,1050,1050,0,0
11805,2019-04-03,315,0,315,25,340,340,0,0
11806,2019-04-03,676,0,676,54,730,730,0,0
11807,2019-04-03,1389,0,1389,111,1500,1500,0,0
11808,2019-04-03,1102,0,1102,88,1190,0,1190,0
11809,2019-04-03,1649,0,1649,131,1780,1780,0,0
11810,2019-04-03,2149,0,2149,171,2320,2320,0,0
11811,2019-04-03,926,0,926,74,1000,1000,0,0
11812,2019-04-03,556,0,556,44,600,600,0,0
11813,2019-04-03,334,0,334,26,360,360,0,0
11814,2019-04-03,240,0,240,10,250,250,0,0
11815,2019-04-03,630,0,630,50,680,680,0,0
11816,2019-04-03,2112,0,2112,168,2280,0,2280,0
11817,2019-04-03,3676,0,3676,294,3970,3970,0,0
11818,2019-04-03,334,0,334,26,360,360,0,0
11819,2019-04-03,1001,0,1001,79,1080,1080,0,0
11820,2019-04-03,1751,0,1751,139,1890,1890,0,0
11821,2019-04-03,788,0,788,62,850,850,0,0
11822,2019-04-03,1389,0,1389,111,1500,1500,0,0
11823,2019-04-03,1065,0,1065,85,1150,1150,0,0
11824,2019-04-03,445,0,445,35,480,480,0,0
11825,2019-04-03,538,0,538,42,580,580,0,0
11826,2019-04-03,509,0,509,31,540,540,0,0
11827,2019-04-03,1879,0,1879,141,2020,2020,0,0
11828,2019-04-03,1370,0,1370,100,1470,1470,0,0
11829,2019-04-03,426,0,426,34,460,460,0,0
11830,2019-04-03,1565,0,1565,125,1690,1690,0,0
11831,2019-04-03,1010,0,1010,80,1090,1090,0,0
11832,2019-04-03,602,0,602,48,650,650,0,0
11833,2019-04-03,1408,0,1408,112,1520,1520,0,0
11834,2019-04-03,1399,0,1399,111,1510,1510,0,0
11835,2019-04-03,1556,0,1556,124,1680,1680,0,0
11836,2019-04-03,862,0,862,68,930,930,0,0
11837,2019-04-03,936,0,936,74,1010,0,1010,0
11838,2019-04-03,1121,0,1121,89,1210,1210,0,0
11839,2019-04-03,343,0,343,27,370,370,0,0
11840,2019-04-03,473,0,473,37,510,0,510,0
11841,2019-04-03,323,0,323,17,340,340,0,0
11842,2019-04-03,1445,0,1445,115,1560,1560,0,0
11843,2019-04-03,277,0,277,13,290,290,0,0
11844,2019-04-03,445,0,445,35,480,480,0,0
11845,2019-04-03,593,0,593,47,640,640,0,0
11846,2019-04-03,352,0,352,28,380,380,0,0
11847,2019-04-03,1925,0,1925,145,2070,2070,0,0
11848,2019-04-03,815,0,815,65,880,880,0,0
11849,2019-04-03,436,0,436,34,470,470,0,0
11850,2019-04-03,204,0,204,16,220,220,0,0
11851,2019-04-03,796,0,796,54,850,850,0,0
11852,2019-04-03,1186,0,1186,94,1280,1280,0,0
11853,2019-04-03,908,0,908,72,980,980,0,0
11854,2019-04-03,1013,0,1013,72,1085,1085,0,0
11855,2019-04-03,334,0,334,26,360,360,0,0
11856,2019-04-03,334,0,334,26,360,360,0,0
11857,2019-04-03,519,0,519,41,560,560,0,0
11858,2019-04-03,602,0,602,48,650,650,0,0
11859,2019-04-03,565,0,565,45,610,610,0,0
11860,2019-04-03,-334,0,-334,-26,-360,-360,0,0
11861,2019-04-03,491,0,491,39,530,530,0,0
11862,2019-04-03,528,0,528,42,570,570,0,0
11863,2019-04-04,1010,0,1010,80,1090,1090,0,0
11864,2019-04-04,389,0,389,31,420,420,0,0
11865,2019-04-04,538,0,538,42,580,580,0,0
11866,2019-04-04,241,0,241,19,260,260,0,0
11867,2019-04-04,269,0,269,21,290,290,0,0
11868,2019-04-04,334,0,334,26,360,360,0,0
11869,2019-04-04,834,0,834,66,900,900,0,0
11870,2019-04-04,538,0,538,42,580,580,0,0
11871,2019-04-04,639,0,639,51,690,690,0,0
11872,2019-04-04,908,0,908,72,980,980,0,0
11873,2019-04-04,547,0,547,43,590,590,0,0
11874,2019-04-04,760,0,760,60,820,820,0,0
11875,2019-04-04,369,0,369,11,380,380,0,0
11876,2019-04-04,1575,0,1575,125,1700,1700,0,0
11877,2019-04-04,1269,0,1269,101,1370,1370,0,0
11878,2019-04-04,380,0,380,30,410,410,0,0
11879,2019-04-04,371,0,371,29,400,400,0,0
11880,2019-04-04,482,0,482,38,520,520,0,0
11881,2019-04-04,500,0,500,40,540,540,0,0
11882,2019-04-04,1806,0,1806,144,1950,1950,0,0
11883,2019-04-04,315,0,315,25,340,340,0,0
11884,2019-04-04,575,0,575,45,620,620,0,0
11885,2019-04-04,110,0,110,0,110,110,0,0
11886,2019-04-04,908,0,908,72,980,980,0,0
11887,2019-04-04,362,0,362,28,390,390,0,0
11888,2019-04-04,278,0,278,22,300,300,0,0
11889,2019-04-04,139,0,139,11,150,150,0,0
11890,2019-04-04,204,0,204,16,220,220,0,0
11891,2019-04-04,676,0,676,54,730,730,0,0
11892,2019-04-04,797,0,797,63,860,860,0,0
11893,2019-04-04,454,0,454,36,490,490,0,0
11894,2019-04-04,2388,0,2388,182,2570,0,2570,0
11895,2019-04-04,1325,0,1325,105,1430,1430,0,0
11896,2019-04-04,871,0,871,69,940,940,0,0
11897,2019-04-04,297,0,297,23,320,320,0,0
11898,2019-04-04,2876,0,2876,229,3105,3105,0,0
11899,2019-04-04,1639,0,1639,131,1770,1770,0,0
11900,2019-04-04,639,0,639,51,690,690,0,0
11901,2019-04-04,519,0,519,41,560,560,0,0
11902,2019-04-04,1936,0,1936,154,2090,2090,0,0
11903,2019-04-04,621,0,621,49,670,670,0,0
11904,2019-04-04,371,0,371,29,400,400,0,0
11905,2019-04-04,439,0,439,35,474,474,0,0
11906,2019-04-04,139,0,139,11,150,150,0,0
11907,2019-04-04,1149,0,1149,91,1240,1240,0,0
11908,2019-04-04,371,0,371,29,400,400,0,0
11909,2019-04-04,408,0,408,32,440,440,0,0
11910,2019-04-04,482,0,482,38,520,520,0,0
11911,2019-04-04,297,0,297,23,320,320,0,0
11912,2019-04-04,1936,0,1936,154,2090,2090,0,0
11913,2019-04-04,908,0,908,72,980,980,0,0
11914,2019-04-04,371,0,371,29,400,400,0,0
11915,2019-04-04,362,0,362,28,390,390,0,0
11916,2019-04-04,1038,0,1038,82,1120,1120,0,0
11917,2019-04-04,713,0,713,57,770,770,0,0
11918,2019-04-04,917,0,917,73,990,990,0,0
11919,2019-04-04,1602,0,1602,128,1730,1730,0,0
11920,2019-04-04,473,0,473,37,510,510,0,0
11921,2019-04-04,1019,0,1019,81,1100,1100,0,0
11922,2019-04-04,852,0,852,68,920,920,0,0
11923,2019-04-04,325,0,325,25,350,350,0,0
11924,2019-04-04,149,0,149,11,160,160,0,0
11925,2019-04-04,926,0,926,74,1000,1000,0,0
11926,2019-04-04,306,0,306,24,330,330,0,0
11927,2019-04-04,658,0,658,52,710,710,0,0
11928,2019-04-04,1260,0,1260,100,1360,1360,0,0
11929,2019-04-04,649,0,649,51,700,700,0,0
11930,2019-04-04,1149,0,1149,91,1240,1240,0,0
11931,2019-04-04,241,0,241,19,260,260,0,0
11932,2019-04-04,167,0,167,13,180,180,0,0
11933,2019-04-04,334,0,334,26,360,360,0,0
11934,2019-04-04,1612,0,1612,128,1740,1740,0,0
11935,2019-04-04,426,0,426,34,460,460,0,0
11936,2019-04-04,288,0,288,22,310,310,0,0
11937,2019-04-04,788,0,788,62,850,850,0,0
11938,2019-04-04,1065,0,1065,85,1150,0,1150,0
11939,2019-04-04,926,0,926,74,1000,0,1000,0
11940,2019-04-04,926,0,926,74,1000,1000,0,0
11941,2019-04-04,741,0,741,59,800,800,0,0
11942,2019-04-04,139,0,139,11,150,150,0,0
11943,2019-04-04,334,0,334,26,360,360,0,0
11944,2019-04-04,176,0,176,14,190,190,0,0
11945,2019-04-04,788,0,788,62,850,850,0,0
11946,2019-04-04,1204,0,1204,96,1300,1300,0,0
11947,2019-04-04,926,0,926,74,1000,1000,0,0
11948,2019-04-04,426,0,426,34,460,460,0,0
11949,2019-04-04,223,0,223,17,240,240,0,0
11950,2019-04-04,343,0,343,27,370,370,0,0
11951,2019-04-04,1065,0,1065,85,1150,1150,0,0
11952,2019-04-04,1524,0,1524,121,1645,1645,0,0
11953,2019-04-04,232,0,232,18,250,250,0,0
11954,2019-04-04,260,0,260,20,280,280,0,0
11955,2019-04-04,251,0,251,19,270,270,0,0
11956,2019-04-04,751,0,751,59,810,810,0,0
11957,2019-04-04,871,0,871,69,940,940,0,0
11958,2019-04-04,602,0,602,48,650,650,0,0
11959,2019-04-04,491,0,491,39,530,530,0,0
11960,2019-04-04,630,0,630,50,680,680,0,0
11961,2019-04-04,232,0,232,18,250,250,0,0
11962,2019-04-04,380,0,380,30,410,410,0,0
11963,2019-04-04,102,0,102,8,110,110,0,0
11964,2019-04-04,676,0,676,54,730,730,0,0
11965,2019-04-04,732,0,732,58,790,790,0,0
11966,2019-04-04,323,0,323,17,340,340,0,0
11967,2019-04-04,362,0,362,28,390,390,0,0
11968,2019-04-04,93,0,93,7,100,100,0,0
11969,2019-04-04,431,0,431,34,465,465,0,0
11970,2019-04-04,1370,0,1370,100,1470,1470,0,0
11971,2019-04-04,788,0,788,62,850,850,0,0
11972,2019-04-04,250,0,250,20,270,270,0,0
11973,2019-04-04,657,0,657,43,700,700,0,0
11974,2019-04-04,1019,0,1019,81,1100,1100,0,0
11975,2019-04-04,482,0,482,38,520,520,0,0
11976,2019-04-04,1028,0,1028,82,1110,1110,0,0
11977,2019-04-04,260,0,260,20,280,280,0,0
11978,2019-04-04,380,0,380,30,410,410,0,0
11979,2019-04-04,1639,0,1639,131,1770,1770,0,0
11980,2019-04-04,399,0,399,31,430,430,0,0
11981,2019-04-04,1815,0,1815,145,1960,1960,0,0
11982,2019-04-04,1815,0,1815,145,1960,1960,0,0
11983,2019-04-04,195,0,195,15,210,210,0,0
11984,2019-04-04,519,0,519,41,560,560,0,0
11985,2019-04-04,1047,0,1047,83,1130,1130,0,0
11986,2019-04-04,334,0,334,26,360,360,0,0
11987,2019-04-04,778,0,778,62,840,840,0,0
11988,2019-04-04,1815,0,1815,145,1960,1960,0,0
11989,2019-04-04,445,0,445,35,480,480,0,0
11990,2019-04-04,241,0,241,19,260,260,0,0
11991,2019-04-04,343,0,343,27,370,370,0,0
11992,2019-04-04,926,0,926,74,1000,1000,0,0
11993,2019-04-04,676,0,676,54,730,730,0,0
11994,2019-04-04,556,0,556,44,600,600,0,0
11995,2019-04-04,269,0,269,21,290,290,0,0
11996,2019-04-04,667,0,667,53,720,720,0,0
11997,2019-04-04,658,0,658,52,710,710,0,0
11998,2019-04-04,926,0,926,74,1000,1000,0,0
11999,2019-04-04,973,0,973,77,1050,1050,0,0
12000,2019-04-04,889,0,889,71,960,960,0,0
12001,2019-04-04,510,0,510,40,550,550,0,0
12002,2019-04-04,778,0,778,62,840,840,0,0
12003,2019-04-04,473,0,473,37,510,510,0,0
12004,2019-04-04,417,0,417,33,450,450,0,0
12005,2019-04-04,250,0,250,20,270,270,0,0
12006,2019-04-04,1612,0,1612,128,1740,1740,0,0
12007,2019-04-04,288,0,288,22,310,310,0,0
12008,2019-04-04,695,0,695,55,750,750,0,0
12009,2019-04-05,630,0,630,50,680,680,0,0
12010,2019-04-05,1815,0,1815,145,1960,1960,0,0
12011,2019-04-05,630,0,630,50,680,680,0,0
12012,2019-04-05,371,0,371,29,400,400,0,0
12013,2019-04-05,445,0,445,35,480,480,0,0
12014,2019-04-05,408,0,408,32,440,440,0,0
12015,2019-04-05,2676,0,2676,214,2890,2890,0,0
12016,2019-04-05,1352,0,1352,108,1460,1460,0,0
12017,2019-04-05,1815,0,1815,145,1960,1960,0,0
12018,2019-04-05,417,0,417,33,450,450,0,0
12019,2019-04-05,343,0,343,27,370,370,0,0
12020,2019-04-05,445,0,445,35,480,480,0,0
12021,2019-04-05,260,0,260,20,280,280,0,0
12022,2019-04-05,389,0,389,31,420,0,420,0
12023,2019-04-05,723,0,723,57,780,780,0,0
12024,2019-04-05,723,0,723,57,780,780,0,0
12025,2019-04-05,1306,0,1306,104,1410,1410,0,0
12026,2019-04-05,167,0,167,13,180,180,0,0
12027,2019-04-05,1399,0,1399,111,1510,1510,0,0
12028,2019-04-05,1815,0,1815,145,1960,0,1960,0
12029,2019-04-05,1473,0,1473,117,1590,1590,0,0
12030,2019-04-05,1296,0,1296,94,1390,1390,0,0
12031,2019-04-05,1445,0,1445,115,1560,1560,0,0
12032,2019-04-05,908,0,908,72,980,0,980,0
12033,2019-04-05,556,0,556,44,600,600,0,0
12034,2019-04-05,1212,0,1212,88,1300,1300,0,0
12035,2019-04-05,704,0,704,56,760,760,0,0
12036,2019-04-05,852,0,852,68,920,920,0,0
12037,2019-04-05,1575,0,1575,125,1700,0,1700,0
12038,2019-04-05,1815,0,1815,145,1960,1960,0,0
12039,2019-04-05,925,0,925,65,990,990,0,0
12040,2019-04-05,908,0,908,72,980,980,0,0
12041,2019-04-05,389,0,389,31,420,420,0,0
12042,2019-04-05,1426,0,1426,114,1540,1540,0,0
12043,2019-04-05,1269,0,1269,101,1370,1370,0,0
12044,2019-04-05,862,0,862,68,930,930,0,0
12045,2019-04-05,778,0,778,62,840,840,0,0
12046,2019-04-05,1755,-188,1567,125,1692,1692,0,0
12047,2019-04-05,563,0,563,27,590,590,0,0
12048,2019-04-05,167,0,167,13,180,180,0,0
12049,2019-04-05,1241,0,1241,99,1340,1340,0,0
12050,2019-04-05,519,0,519,41,560,560,0,0
12051,2019-04-05,908,0,908,72,980,980,0,0
12052,2019-04-05,926,0,926,74,1000,1000,0,0
12053,2019-04-05,491,0,491,39,530,530,0,0
12054,2019-04-05,908,0,908,72,980,980,0,0
12055,2019-04-05,1223,0,1223,97,1320,1320,0,0
12056,2019-04-05,1815,0,1815,145,1960,1960,0,0
12057,2019-04-05,260,0,260,20,280,280,0,0
12058,2019-04-05,880,0,880,70,950,950,0,0
12059,2019-04-05,936,0,936,74,1010,1010,0,0
12060,2019-04-05,1176,0,1176,94,1270,1270,0,0
12061,2019-04-05,1593,0,1593,127,1720,1720,0,0
12062,2019-04-05,232,0,232,18,250,250,0,0
12063,2019-04-05,473,0,473,37,510,510,0,0
12064,2019-04-05,269,0,269,21,290,290,0,0
12065,2019-04-05,371,0,371,29,400,400,0,0
12066,2019-04-05,371,0,371,29,400,400,0,0
12067,2019-04-05,371,0,371,29,400,400,0,0
12068,2019-04-05,399,0,399,31,430,430,0,0
12069,2019-04-05,510,0,510,40,550,550,0,0
12070,2019-04-05,1186,0,1186,94,1280,1280,0,0
12071,2019-04-05,139,0,139,11,150,150,0,0
12072,2019-04-05,1501,0,1501,119,1620,1620,0,0
12073,2019-04-05,278,0,278,22,300,300,0,0
12074,2019-04-05,232,0,232,18,250,250,0,0
12075,2019-04-05,176,0,176,14,190,190,0,0
12076,2019-04-05,334,0,334,26,360,360,0,0
12077,2019-04-05,906,0,906,54,960,960,0,0
12078,2019-04-05,1028,0,1028,82,1110,1110,0,0
12079,2019-04-05,371,0,371,29,400,400,0,0
12080,2019-04-05,167,0,167,13,180,180,0,0
12081,2019-04-05,1815,0,1815,145,1960,1960,0,0
12082,2019-04-05,723,0,723,57,780,780,0,0
12083,2019-04-05,1064,0,1064,76,1140,1140,0,0
12084,2019-04-05,1399,0,1399,111,1510,1510,0,0
12085,2019-04-05,1362,0,1362,108,1470,1470,0,0
12086,2019-04-05,1315,0,1315,105,1420,1420,0,0
12087,2019-04-05,1454,0,1454,116,1570,1570,0,0
12088,2019-04-05,399,0,399,31,430,430,0,0
12089,2019-04-05,1565,0,1565,125,1690,1690,0,0
12090,2019-04-05,232,0,232,18,250,250,0,0
12091,2019-04-05,482,0,482,38,520,520,0,0
12092,2019-04-05,908,0,908,72,980,980,0,0
12093,2019-04-05,843,0,843,67,910,910,0,0
12094,2019-04-05,1528,0,1528,122,1650,1650,0,0
12095,2019-04-05,954,0,954,76,1030,1030,0,0
12096,2019-04-05,1926,0,1926,154,2080,2080,0,0
12097,2019-04-05,186,0,186,14,200,200,0,0
12098,2019-04-05,1639,0,1639,131,1770,1770,0,0
12099,2019-04-05,371,0,371,29,400,400,0,0
12100,2019-04-05,732,0,732,58,790,790,0,0
12101,2019-04-05,788,0,788,62,850,850,0,0
12102,2019-04-05,1288,0,1288,102,1390,1390,0,0
12103,2019-04-05,1352,0,1352,108,1460,1460,0,0
12104,2019-04-05,510,0,510,40,550,550,0,0
12105,2019-04-05,1575,0,1575,125,1700,1700,0,0
12106,2019-04-05,223,0,223,17,240,240,0,0
12107,2019-04-05,788,0,788,62,850,850,0,0
12108,2019-04-05,788,0,788,62,850,850,0,0
12109,2019-04-05,973,0,973,77,1050,1050,0,0
12110,2019-04-05,1343,0,1343,107,1450,0,1450,0
12111,2019-04-05,1195,0,1195,95,1290,1290,0,0
12112,2019-04-05,2130,0,2130,170,2300,2300,0,0
12113,2019-04-05,871,0,871,69,940,940,0,0
12114,2019-04-05,788,0,788,62,850,850,0,0
12115,2019-04-05,788,0,788,62,850,850,0,0
12116,2019-04-05,788,0,788,62,850,850,0,0
12117,2019-04-05,1158,0,1158,92,1250,1250,0,0
12118,2019-04-05,546,0,546,34,580,580,0,0
12119,2019-04-05,426,0,426,34,460,460,0,0
12120,2019-04-05,1305,0,1305,95,1400,1400,0,0
12121,2019-04-05,1519,0,1519,121,1640,1640,0,0
12122,2019-04-05,2288,0,2288,182,2470,2470,0,0
12123,2019-04-05,1084,0,1084,86,1170,1170,0,0
12124,2019-04-05,396,-84,312,24,336,336,0,0
12125,2019-04-05,537,-114,423,33,456,456,0,0
12126,2019-04-05,362,0,362,28,390,390,0,0
12127,2019-04-05,167,0,167,13,180,180,0,0
12128,2019-04-05,2260,0,2260,180,2440,2440,0,0
12129,2019-04-05,501,0,501,39,540,540,0,0
12130,2019-04-05,575,0,575,45,620,620,0,0
12131,2019-04-05,1778,0,1778,142,1920,1920,0,0
12132,2019-04-05,1175,0,1175,85,1260,1260,0,0
12133,2019-04-05,899,0,899,71,970,970,0,0
12134,2019-04-05,630,0,630,50,680,680,0,0
12135,2019-04-05,945,0,945,75,1020,1020,0,0
12136,2019-04-05,472,0,472,28,500,500,0,0
12137,2019-04-05,139,0,139,11,150,150,0,0
12138,2019-04-05,678,-144,534,42,576,576,0,0
12139,2019-04-05,723,0,723,57,780,780,0,0
12140,2019-04-05,584,0,584,46,630,630,0,0
12141,2019-04-05,862,0,862,68,930,930,0,0
12142,2019-04-05,176,0,176,14,190,190,0,0
12143,2019-04-05,203,0,203,16,219,219,0,0
12144,2019-04-05,380,0,380,30,410,0,410,0
12145,2019-04-05,1575,0,1575,125,1700,1700,0,0
12146,2019-04-05,251,0,251,19,270,270,0,0
12147,2019-04-05,2259,0,2259,171,2430,2430,0,0
12148,2019-04-05,676,0,676,54,730,730,0,0
12149,2019-04-05,362,0,362,28,390,390,0,0
12150,2019-04-05,519,0,519,41,560,560,0,0
12151,2019-04-05,1917,0,1917,153,2070,2070,0,0
12152,2019-04-05,769,0,769,61,830,830,0,0
12153,2019-04-05,1102,0,1102,88,1190,1190,0,0
12154,2019-04-05,1490,0,1490,110,1600,1600,0,0
12155,2019-04-05,768,0,768,52,820,820,0,0
12156,2019-04-05,649,0,649,51,700,700,0,0
12157,2019-04-05,806,0,806,64,870,870,0,0
12158,2019-04-05,445,0,445,35,480,480,0,0
12159,2019-04-05,862,0,862,68,930,930,0,0
12160,2019-04-05,806,0,806,64,870,870,0,0
12161,2019-04-05,167,0,167,13,180,180,0,0
12162,2019-04-05,1880,0,1880,150,2030,2030,0,0
12163,2019-04-05,1565,0,1565,125,1690,1690,0,0
12164,2019-04-05,1815,0,1815,145,1960,1960,0,0
12165,2019-04-05,806,0,806,64,870,870,0,0
12166,2019-04-05,232,0,232,18,250,250,0,0
12167,2019-04-05,1334,0,1334,106,1440,1440,0,0
12168,2019-04-05,213,0,213,17,230,230,0,0
12169,2019-04-05,1075,0,1075,85,1160,1160,0,0
12170,2019-04-05,454,0,454,36,490,490,0,0
12171,2019-04-05,399,0,399,31,430,430,0,0
12172,2019-04-05,482,0,482,38,520,520,0,0
12173,2019-04-05,527,0,527,33,560,560,0,0
12174,2019-04-05,788,0,788,62,850,850,0,0
12175,2019-04-05,1723,0,1723,137,1860,1860,0,0
12176,2019-04-05,278,0,278,22,300,0,300,0
12177,2019-04-05,538,0,538,42,580,580,0,0
12178,2019-04-05,1084,0,1084,86,1170,1170,0,0
12179,2019-04-05,686,0,686,54,740,740,0,0
12180,2019-04-05,1575,0,1575,125,1700,1700,0,0
12181,2019-04-05,565,0,565,45,610,610,0,0
12182,2019-04-05,547,0,547,43,590,590,0,0
12183,2019-04-05,973,0,973,77,1050,1050,0,0
12184,2019-04-05,251,0,251,19,270,270,0,0
12185,2019-04-05,454,0,454,36,490,490,0,0
12186,2019-04-05,945,0,945,75,1020,1020,0,0
12187,2019-04-05,621,0,621,49,670,670,0,0
12188,2019-04-05,825,0,825,65,890,890,0,0
12189,2019-04-05,251,0,251,19,270,270,0,0
12190,2019-04-05,732,0,732,58,790,790,0,0
12191,2019-04-05,389,0,389,31,420,420,0,0
12192,2019-04-06,213,0,213,17,230,230,0,0
12193,2019-04-06,1499,0,1499,111,1610,1610,0,0
12194,2019-04-06,1815,0,1815,145,1960,1960,0,0
12195,2019-04-06,1862,0,1862,148,2010,2010,0,0
12196,2019-04-06,1815,0,1815,145,1960,1960,0,0
12197,2019-04-06,1501,0,1501,119,1620,1620,0,0
12198,2019-04-06,463,0,463,37,500,500,0,0
12199,2019-04-06,399,0,399,31,430,430,0,0
12200,2019-04-06,1001,0,1001,79,1080,1080,0,0
12201,2019-04-06,463,0,463,37,500,500,0,0
12202,2019-04-06,611,0,611,39,650,650,0,0
12203,2019-04-06,325,0,325,25,350,350,0,0
12204,2019-04-06,2315,0,2315,185,2500,2500,0,0
12205,2019-04-06,1666,0,1666,124,1790,1790,0,0
12206,2019-04-06,1834,0,1834,146,1980,1980,0,0
12207,2019-04-06,1667,0,1667,133,1800,1800,0,0
12208,2019-04-06,1639,0,1639,131,1770,1770,0,0
12209,2019-04-06,917,0,917,73,990,990,0,0
12210,2019-04-06,713,0,713,57,770,770,0,0
12211,2019-04-06,908,0,908,72,980,980,0,0
12212,2019-04-06,621,0,621,49,670,670,0,0
12213,2019-04-06,908,0,908,72,980,980,0,0
12214,2019-04-06,510,0,510,40,550,550,0,0
12215,2019-04-06,806,0,806,64,870,870,0,0
12216,2019-04-06,1278,0,1278,102,1380,1380,0,0
12217,2019-04-06,306,0,306,24,330,330,0,0
12218,2019-04-06,908,0,908,72,980,980,0,0
12219,2019-04-06,1306,0,1306,104,1410,1410,0,0
12220,2019-04-06,871,0,871,69,940,940,0,0
12221,2019-04-06,482,0,482,38,520,520,0,0
12222,2019-04-06,1102,0,1102,88,1190,1190,0,0
12223,2019-04-06,380,0,380,30,410,410,0,0
12224,2019-04-06,648,0,648,42,690,690,0,0
12225,2019-04-06,786,0,786,54,840,840,0,0
12226,2019-04-06,1815,0,1815,145,1960,1960,0,0
12227,2019-04-06,713,0,713,57,770,770,0,0
12228,2019-04-06,1121,0,1121,89,1210,1210,0,0
12229,2019-04-06,917,0,917,73,990,0,990,0
12230,2019-04-06,908,0,908,72,980,980,0,0
12231,2019-04-06,769,0,769,61,830,830,0,0
12232,2019-04-06,1204,0,1204,96,1300,1300,0,0
12233,2019-04-06,334,0,334,26,360,360,0,0
12234,2019-04-06,908,0,908,72,980,980,0,0
12235,2019-04-06,1815,0,1815,145,1960,1960,0,0
12236,2019-04-06,908,0,908,72,980,980,0,0
12237,2019-04-06,1112,0,1112,88,1200,1200,0,0
12238,2019-04-06,1158,0,1158,92,1250,1250,0,0
12239,2019-04-06,630,0,630,50,680,680,0,0
12240,2019-04-06,621,0,621,49,670,670,0,0
12241,2019-04-06,510,0,510,40,550,550,0,0
12242,2019-04-06,1528,0,1528,122,1650,1650,0,0
12243,2019-04-06,889,0,889,71,960,960,0,0
12244,2019-04-06,2065,0,2065,165,2230,2230,0,0
12245,2019-04-06,528,0,528,42,570,570,0,0
12246,2019-04-06,908,0,908,72,980,980,0,0
12247,2019-04-06,389,0,389,31,420,420,0,0
12248,2019-04-06,325,0,325,25,350,350,0,0
12249,2019-04-06,889,0,889,71,960,960,0,0
12250,2019-04-06,1065,0,1065,85,1150,1150,0,0
12251,2019-04-06,251,0,251,19,270,270,0,0
12252,2019-04-06,380,0,380,30,410,410,0,0
12253,2019-04-06,797,0,797,63,860,860,0,0
12254,2019-04-06,1093,0,1093,87,1180,0,1180,0
12255,2019-04-06,593,0,593,47,640,640,0,0
12256,2019-04-06,158,0,158,12,170,170,0,0
12257,2019-04-06,334,0,334,26,360,360,0,0
12258,2019-04-06,620,0,620,40,660,660,0,0
12259,2019-04-06,371,0,371,29,400,400,0,0
12260,2019-04-06,380,0,380,30,410,410,0,0
12261,2019-04-06,1186,0,1186,94,1280,1280,0,0
12262,2019-04-06,528,0,528,42,570,570,0,0
12263,2019-04-06,269,0,269,21,290,290,0,0
12264,2019-04-06,630,0,630,50,680,680,0,0
12265,2019-04-06,315,0,315,25,340,340,0,0
12266,2019-04-06,602,0,602,48,650,650,0,0
12267,2019-04-06,269,0,269,21,290,290,0,0
12268,2019-04-06,139,0,139,11,150,150,0,0
12269,2019-04-06,278,0,278,22,300,300,0,0
12270,2019-04-06,862,0,862,68,930,930,0,0
12271,2019-04-06,797,0,797,63,860,860,0,0
12272,2019-04-06,1186,0,1186,94,1280,1280,0,0
12273,2019-04-06,1639,0,1639,131,1770,1770,0,0
12274,2019-04-06,741,0,741,59,800,800,0,0
12275,2019-04-06,399,0,399,31,430,430,0,0
12276,2019-04-06,278,0,278,22,300,300,0,0
12277,2019-04-06,436,0,436,34,470,470,0,0
12278,2019-04-06,547,0,547,43,590,590,0,0
12279,2019-04-06,1241,0,1241,99,1340,1340,0,0
12280,2019-04-06,260,0,260,20,280,280,0,0
12281,2019-04-06,695,0,695,55,750,750,0,0
12282,2019-04-06,473,0,473,37,510,510,0,0
12283,2019-04-06,695,0,695,55,750,750,0,0
12284,2019-04-06,463,0,463,37,500,500,0,0
12285,2019-04-06,908,0,908,72,980,980,0,0
12286,2019-04-06,741,0,741,59,800,800,0,0
12287,2019-04-06,908,0,908,72,980,980,0,0
12288,2019-04-06,1001,0,1001,79,1080,1080,0,0
12289,2019-04-06,399,0,399,31,430,430,0,0
12290,2019-04-06,1612,0,1612,128,1740,1740,0,0
12291,2019-04-06,306,0,306,24,330,330,0,0
12292,2019-04-06,352,0,352,28,380,380,0,0
12293,2019-04-06,2547,0,2547,203,2750,2750,0,0
12294,2019-04-06,556,0,556,44,600,600,0,0
12295,2019-04-06,1473,0,1473,117,1590,1590,0,0
12296,2019-04-06,519,0,519,41,560,560,0,0
12297,2019-04-06,1815,0,1815,145,1960,1960,0,0
12298,2019-04-06,777,0,777,53,830,830,0,0
12299,2019-04-06,621,0,621,49,670,670,0,0
12300,2019-04-06,963,0,963,77,1040,1040,0,0
12301,2019-04-06,1575,0,1575,125,1700,1700,0,0
12302,2019-04-06,501,0,501,39,540,540,0,0
12303,2019-04-06,260,0,260,20,280,280,0,0
12304,2019-04-06,510,0,510,40,550,550,0,0
12305,2019-04-06,371,0,371,29,400,400,0,0
12306,2019-04-06,639,0,639,51,690,690,0,0
12307,2019-04-06,315,0,315,25,340,340,0,0
12308,2019-04-06,528,0,528,42,570,570,0,0
12309,2019-04-06,241,0,241,19,260,260,0,0
12310,2019-04-06,408,0,408,32,440,440,0,0
12311,2019-04-06,167,0,167,13,180,180,0,0
12312,2019-04-06,602,0,602,48,650,650,0,0
12313,2019-04-06,1815,0,1815,145,1960,1960,0,0
12314,2019-04-06,297,0,297,23,320,320,0,0
12315,2019-04-06,288,0,288,22,310,310,0,0
12316,2019-04-06,510,0,510,40,550,550,0,0
12317,2019-04-06,269,0,269,21,290,290,0,0
12318,2019-04-06,269,0,269,21,290,0,290,0
12319,2019-04-06,2362,0,2362,188,2550,2550,0,0
12320,2019-04-06,834,0,834,66,900,900,0,0
12321,2019-04-06,1093,0,1093,87,1180,0,1180,0
12322,2019-04-06,788,0,788,62,850,850,0,0
12323,2019-04-06,686,0,686,54,740,0,740,0
12324,2019-04-06,788,0,788,62,850,850,0,0
12325,2019-04-06,1149,0,1149,91,1240,1240,0,0
12326,2019-04-06,538,0,538,42,580,580,0,0
12327,2019-04-06,704,0,704,56,760,760,0,0
12328,2019-04-06,538,0,538,42,580,580,0,0
12329,2019-04-06,639,0,639,51,690,690,0,0
12330,2019-04-06,463,0,463,37,500,500,0,0
12331,2019-04-06,612,0,612,48,660,660,0,0
12332,2019-04-06,1038,0,1038,82,1120,1120,0,0
12333,2019-04-06,241,0,241,19,260,260,0,0
12334,2019-04-06,732,0,732,58,790,790,0,0
12335,2019-04-06,463,0,463,37,500,500,0,0
12336,2019-04-06,528,0,528,42,570,570,0,0
12337,2019-04-06,1936,0,1936,154,2090,2090,0,0
12338,2019-04-06,260,0,260,20,280,280,0,0
12339,2019-04-06,908,0,908,72,980,980,0,0
12340,2019-04-06,778,0,778,62,840,840,0,0
12341,2019-04-06,1593,0,1593,127,1720,1720,0,0
12342,2019-04-06,1213,0,1213,97,1310,1310,0,0
12343,2019-04-06,741,0,741,59,800,800,0,0
12344,2019-04-06,491,0,491,39,530,0,530,0
12345,2019-04-06,139,0,139,11,150,150,0,0
12346,2019-04-06,1001,0,1001,79,1080,1080,0,0
12347,2019-04-06,1510,0,1510,120,1630,1630,0,0
12348,2019-04-06,371,0,371,29,400,400,0,0
12349,2019-04-06,639,0,639,51,690,690,0,0
12350,2019-04-06,491,0,491,39,530,530,0,0
12351,2019-04-06,621,0,621,49,670,670,0,0
12352,2019-04-06,232,0,232,18,250,250,0,0
12353,2019-04-06,1056,0,1056,84,1140,1140,0,0
12354,2019-04-06,1445,0,1445,115,1560,1560,0,0
12355,2019-04-06,676,0,676,54,730,730,0,0
12356,2019-04-06,362,0,362,28,390,390,0,0
12357,2019-04-06,704,0,704,56,760,760,0,0
12358,2019-04-06,871,0,871,69,940,940,0,0
12359,2019-04-06,695,0,695,55,750,750,0,0
12360,2019-04-06,1380,0,1380,110,1490,1490,0,0
12361,2019-04-06,796,0,796,54,850,850,0,0
12362,2019-04-06,260,0,260,20,280,280,0,0
12363,2019-04-06,352,0,352,28,380,380,0,0
12364,2019-04-06,315,0,315,25,340,340,0,0
12365,2019-04-06,1130,0,1130,90,1220,1220,0,0
12366,2019-04-06,788,0,788,62,850,850,0,0
12367,2019-04-06,1575,0,1575,125,1700,1700,0,0
12368,2019-04-06,334,0,334,26,360,360,0,0
12369,2019-04-06,788,0,788,62,850,850,0,0
12370,2019-04-06,315,0,315,25,340,340,0,0
12371,2019-04-06,288,0,288,22,310,310,0,0
12372,2019-04-06,1325,0,1325,105,1430,1430,0,0
12373,2019-04-06,1575,0,1575,125,1700,1700,0,0
12374,2019-04-06,1575,0,1575,125,1700,1700,0,0
12375,2019-04-06,1055,0,1055,75,1130,1130,0,0
12376,2019-04-06,352,0,352,28,380,380,0,0
12377,2019-04-06,621,0,621,49,670,670,0,0
12378,2019-04-06,2010,0,2010,160,2170,2170,0,0
12379,2019-04-06,510,0,510,40,550,550,0,0
12380,2019-04-06,371,0,371,29,400,400,0,0
12381,2019-04-06,667,0,667,53,720,720,0,0
12382,2019-04-06,2352,0,2352,188,2540,2540,0,0
12383,2019-04-06,788,0,788,62,850,850,0,0
12384,2019-04-06,1991,0,1991,159,2150,2150,0,0
12385,2019-04-06,371,0,371,29,400,400,0,0
12386,2019-04-06,1575,0,1575,125,1700,1700,0,0
12387,2019-04-06,2130,0,2130,170,2300,2300,0,0
12388,2019-04-06,556,0,556,44,600,600,0,0
12389,2019-04-06,1565,0,1565,125,1690,1690,0,0
12390,2019-04-06,621,0,621,49,670,670,0,0
12391,2019-04-06,1575,0,1575,125,1700,0,1700,0
12392,2019-04-06,2362,0,2362,188,2550,2550,0,0
12393,2019-04-06,352,0,352,28,380,380,0,0
12394,2019-04-06,149,0,149,11,160,160,0,0
12395,2019-04-06,788,0,788,62,850,850,0,0
12396,2019-04-06,788,0,788,62,850,850,0,0
12397,2019-04-06,1158,0,1158,92,1250,1250,0,0
12398,2019-04-06,1575,0,1575,125,1700,1700,0,0
12399,2019-04-06,843,0,843,67,910,910,0,0
12400,2019-04-06,491,0,491,39,530,530,0,0
12401,2019-04-06,519,0,519,41,560,560,0,0
12402,2019-04-06,584,0,584,46,630,630,0,0
12403,2019-04-06,528,0,528,42,570,570,0,0
12404,2019-04-06,362,0,362,28,390,390,0,0
12405,2019-04-06,1556,0,1556,124,1680,1680,0,0
12406,2019-04-06,575,0,575,45,620,620,0,0
12407,2019-04-06,1426,0,1426,114,1540,1540,0,0
12408,2019-04-06,269,0,269,21,290,290,0,0
12409,2019-04-06,167,0,167,13,180,180,0,0
12410,2019-04-06,695,0,695,55,750,750,0,0
12411,2019-04-07,1241,0,1241,99,1340,1340,0,0
12412,2019-04-07,1325,0,1325,105,1430,1430,0,0
12413,2019-04-07,139,0,139,11,150,150,0,0
12414,2019-04-07,1194,0,1194,86,1280,1280,0,0
12415,2019-04-07,149,0,149,11,160,160,0,0
12416,2019-04-07,362,0,362,28,390,390,0,0
12417,2019-04-07,482,0,482,38,520,520,0,0
12418,2019-04-07,528,0,528,42,570,570,0,0
12419,2019-04-07,667,0,667,53,720,720,0,0
12420,2019-04-07,482,0,482,38,520,520,0,0
12421,2019-04-07,852,0,852,68,920,920,0,0
12422,2019-04-07,695,0,695,55,750,750,0,0
12423,2019-04-07,601,0,601,39,640,640,0,0
12424,2019-04-07,1195,0,1195,95,1290,1290,0,0
12425,2019-04-07,769,0,769,61,830,830,0,0
12426,2019-04-07,1130,0,1130,90,1220,1220,0,0
12427,2019-04-07,639,0,639,51,690,690,0,0
12428,2019-04-07,1380,0,1380,110,1490,1490,0,0
12429,2019-04-07,315,0,315,25,340,340,0,0
12430,2019-04-07,990,0,990,70,1060,1060,0,0
12431,2019-04-07,213,0,213,17,230,230,0,0
12432,2019-04-07,325,0,325,25,350,350,0,0
12433,2019-04-07,936,0,936,74,1010,1010,0,0
12434,2019-04-07,1288,0,1288,102,1390,1390,0,0
12435,2019-04-07,343,0,343,27,370,370,0,0
12436,2019-04-07,334,0,334,26,360,360,0,0
12437,2019-04-07,454,0,454,36,490,490,0,0
12438,2019-04-07,2223,0,2223,177,2400,2400,0,0
12439,2019-04-07,2871,0,2871,229,3100,3100,0,0
12440,2019-04-07,445,0,445,35,480,480,0,0
12441,2019-04-07,1778,0,1778,142,1920,1920,0,0
12442,2019-04-07,250,0,250,20,270,270,0,0
12443,2019-04-07,1149,0,1149,91,1240,1240,0,0
12444,2019-04-07,1175,0,1175,85,1260,1260,0,0
12445,2019-04-07,269,0,269,21,290,290,0,0
12446,2019-04-07,251,0,251,19,270,270,0,0
12447,2019-04-07,213,0,213,17,230,230,0,0
12448,2019-04-07,334,0,334,26,360,360,0,0
12449,2019-04-07,695,0,695,55,750,750,0,0
12450,2019-04-07,112,0,112,8,120,120,0,0
12451,2019-04-07,1297,0,1297,103,1400,1400,0,0
12452,2019-04-07,260,0,260,20,280,280,0,0
12453,2019-04-07,1362,0,1362,108,1470,1470,0,0
12454,2019-04-07,260,0,260,20,280,280,0,0
12455,2019-04-07,797,0,797,63,860,860,0,0
12456,2019-04-07,269,0,269,21,290,290,0,0
12457,2019-04-07,612,0,612,48,660,660,0,0
12458,2019-04-07,658,0,658,52,710,710,0,0
12459,2019-04-07,-482,0,-482,-38,-520,-520,0,0
12460,2019-04-07,306,0,306,24,330,330,0,0
12461,2019-04-07,778,0,778,62,840,840,0,0
12462,2019-04-07,102,0,102,8,110,110,0,0
12463,2019-04-07,991,0,991,79,1070,1070,0,0
12464,2019-04-07,110,0,110,0,110,110,0,0
12465,2019-04-07,1917,0,1917,153,2070,2070,0,0
12466,2019-04-07,602,0,602,48,650,650,0,0
12467,2019-04-07,1778,0,1778,142,1920,1920,0,0
12468,2019-04-07,454,0,454,36,490,490,0,0
12469,2019-04-07,1815,0,1815,145,1960,1960,0,0
12470,2019-04-07,778,0,778,62,840,840,0,0
12471,2019-04-07,1278,0,1278,102,1380,1380,0,0
12472,2019-04-07,260,0,260,20,280,280,0,0
12473,2019-04-07,741,0,741,59,800,800,0,0
12474,2019-04-07,269,0,269,21,290,290,0,0
12475,2019-04-07,1204,0,1204,96,1300,1300,0,0
12476,2019-04-07,982,0,982,78,1060,1060,0,0
12477,2019-04-07,1028,0,1028,82,1110,1110,0,0
12478,2019-04-07,167,0,167,13,180,180,0,0
12479,2019-04-07,565,0,565,45,610,610,0,0
12480,2019-04-07,741,0,741,59,800,800,0,0
12481,2019-04-07,584,0,584,46,630,630,0,0
12482,2019-04-07,741,0,741,59,800,800,0,0
12483,2019-04-07,538,0,538,42,580,580,0,0
12484,2019-04-07,1343,0,1343,107,1450,1450,0,0
12485,2019-04-07,371,0,371,29,400,400,0,0
12486,2019-04-07,797,0,797,63,860,860,0,0
12487,2019-04-07,269,0,269,21,290,290,0,0
12488,2019-04-07,602,0,602,48,650,650,0,0
12489,2019-04-07,362,0,362,28,390,390,0,0
12490,2019-04-07,232,0,232,18,250,250,0,0
12491,2019-04-07,334,0,334,26,360,360,0,0
12492,2019-04-07,269,0,269,21,290,290,0,0
12493,2019-04-07,176,0,176,14,190,190,0,0
12494,2019-04-07,343,0,343,27,370,370,0,0
12495,2019-04-07,788,0,788,62,850,850,0,0
12496,2019-04-07,47,0,47,3,50,50,0,0
12497,2019-04-07,528,0,528,42,570,570,0,0
12498,2019-04-07,232,0,232,18,250,250,0,0
12499,2019-04-07,389,0,389,31,420,420,0,0
12500,2019-04-07,491,0,491,39,530,530,0,0
12501,2019-04-07,232,0,232,18,250,250,0,0
12502,2019-04-07,806,0,806,64,870,870,0,0
12503,2019-04-07,575,0,575,45,620,620,0,0
12504,2019-04-07,584,0,584,46,630,630,0,0
12505,2019-04-07,1510,0,1510,120,1630,0,1630,0
12506,2019-04-07,380,0,380,30,410,410,0,0
12507,2019-04-07,454,0,454,36,490,490,0,0
12508,2019-04-07,1056,0,1056,84,1140,1140,0,0
12509,2019-04-07,649,0,649,51,700,700,0,0
12510,2019-04-07,491,0,491,39,530,530,0,0
12511,2019-04-07,260,0,260,20,280,280,0,0
12512,2019-04-07,343,0,343,27,370,370,0,0
12513,2019-04-07,389,0,389,31,420,420,0,0
12514,2019-04-07,2065,0,2065,165,2230,2230,0,0
12515,2019-04-07,371,0,371,29,400,400,0,0
12516,2019-04-07,288,0,288,22,310,310,0,0
12517,2019-04-07,1186,0,1186,94,1280,1280,0,0
12518,2019-04-07,167,0,167,13,180,180,0,0
12519,2019-04-07,556,0,556,44,600,600,0,0
12520,2019-04-07,510,0,510,40,550,550,0,0
12521,2019-04-07,269,0,269,21,290,290,0,0
12522,2019-04-07,1149,0,1149,91,1240,1240,0,0
12523,2019-04-07,1130,0,1130,90,1220,1220,0,0
12524,2019-04-07,686,0,686,54,740,740,0,0
12525,2019-04-07,241,0,241,19,260,260,0,0
12526,2019-04-07,1351,0,1351,99,1450,1450,0,0
12527,2019-04-07,676,0,676,54,730,730,0,0
12528,2019-04-07,741,0,741,59,800,800,0,0
12529,2019-04-07,1195,0,1195,95,1290,1290,0,0
12530,2019-04-07,250,0,250,20,270,270,0,0
12531,2019-04-07,1815,0,1815,145,1960,1960,0,0
12532,2019-04-07,732,0,732,58,790,790,0,0
12533,2019-04-07,536,0,536,34,570,570,0,0
12534,2019-04-07,815,0,815,65,880,880,0,0
12535,2019-04-07,1121,0,1121,89,1210,1210,0,0
12536,2019-04-07,510,0,510,40,550,550,0,0
12537,2019-04-07,556,0,556,44,600,600,0,0
12538,2019-04-07,482,0,482,38,520,520,0,0
12539,2019-04-07,825,0,825,65,890,890,0,0
12540,2019-04-07,676,0,676,54,730,730,0,0
12541,2019-04-07,223,0,223,17,240,240,0,0
12542,2019-04-07,1241,0,1241,99,1340,1340,0,0
12543,2019-04-07,769,0,769,61,830,830,0,0
12544,2019-04-07,788,0,788,62,850,850,0,0
12545,2019-04-07,649,0,649,51,700,700,0,0
12546,2019-04-07,510,0,510,40,550,550,0,0
12547,2019-04-07,343,0,343,27,370,370,0,0
12548,2019-04-07,445,0,445,35,480,480,0,0
12549,2019-04-07,2685,0,2685,205,2890,0,2890,0
12550,2019-04-07,788,0,788,62,850,850,0,0
12551,2019-04-07,362,0,362,28,390,390,0,0
12552,2019-04-07,547,0,547,43,590,590,0,0
12553,2019-04-07,362,0,362,28,390,390,0,0
12554,2019-04-08,982,0,982,78,1060,1060,0,0
12555,2019-04-08,1815,0,1815,145,1960,0,1960,0
12556,2019-04-08,399,0,399,31,430,430,0,0
12557,2019-04-08,1334,0,1334,106,1440,1440,0,0
12558,2019-04-08,139,0,139,11,150,150,0,0
12559,2019-04-08,167,0,167,13,180,180,0,0
12560,2019-04-08,306,0,306,24,330,330,0,0
12561,2019-04-08,232,0,232,18,250,250,0,0
12562,2019-04-08,612,0,612,48,660,0,660,0
12563,2019-04-08,565,0,565,45,610,610,0,0
12564,2019-04-08,667,0,667,53,720,720,0,0
12565,2019-04-08,491,0,491,39,530,530,0,0
12566,2019-04-08,778,0,778,62,840,840,0,0
12567,2019-04-08,639,0,639,51,690,690,0,0
12568,2019-04-08,260,0,260,20,280,280,0,0
12569,2019-04-08,797,0,797,63,860,860,0,0
12570,2019-04-08,732,0,732,58,790,790,0,0
12571,2019-04-08,621,0,621,49,670,670,0,0
12572,2019-04-08,1815,0,1815,145,1960,0,1960,0
12573,2019-04-08,1862,0,1862,148,2010,2010,0,0
12574,2019-04-08,407,0,407,23,430,0,430,0
12575,2019-04-08,908,0,908,72,980,980,0,0
12576,2019-04-08,908,0,908,72,980,980,0,0
12577,2019-04-08,1778,0,1778,142,1920,1920,0,0
12578,2019-04-08,741,0,741,59,800,800,0,0
12579,2019-04-08,1815,0,1815,145,1960,1960,0,0
12580,2019-04-08,2723,0,2723,217,2940,2940,0,0
12581,2019-04-08,306,0,306,24,330,330,0,0
12582,2019-04-08,1837,-196,1641,123,1764,1764,0,0
12583,2019-04-08,1815,0,1815,145,1960,1960,0,0
12584,2019-04-08,1815,0,1815,145,1960,1960,0,0
12585,2019-04-08,908,0,908,72,980,980,0,0
12586,2019-04-08,1306,0,1306,104,1410,1410,0,0
12587,2019-04-08,834,0,834,66,900,900,0,0
12588,2019-04-08,639,0,639,51,690,690,0,0
12589,2019-04-08,297,0,297,23,320,320,0,0
12590,2019-04-08,732,0,732,58,790,790,0,0
12591,2019-04-08,491,0,491,39,530,530,0,0
12592,2019-04-08,908,0,908,72,980,980,0,0
12593,2019-04-08,908,0,908,72,980,980,0,0
12594,2019-04-08,639,0,639,51,690,690,0,0
12595,2019-04-08,278,0,278,22,300,300,0,0
12596,2019-04-08,396,-84,312,24,336,336,0,0
12597,2019-04-08,260,0,260,20,280,280,0,0
12598,2019-04-08,834,0,834,66,900,900,0,0
12599,2019-04-08,880,0,880,70,950,950,0,0
12600,2019-04-08,945,0,945,75,1020,1020,0,0
12601,2019-04-08,1621,0,1621,129,1750,1750,0,0
12602,2019-04-08,222,0,222,8,230,230,0,0
12603,2019-04-08,556,0,556,44,600,600,0,0
12604,2019-04-08,1056,0,1056,84,1140,1140,0,0
12605,2019-04-08,1658,0,1658,132,1790,1790,0,0
12606,2019-04-08,399,0,399,31,430,430,0,0
12607,2019-04-08,1408,0,1408,112,1520,1520,0,0
12608,2019-04-08,936,0,936,74,1010,1010,0,0
12609,2019-04-08,945,0,945,75,1020,1020,0,0
12610,2019-04-08,843,0,843,67,910,910,0,0
12611,2019-04-08,454,0,454,36,490,490,0,0
12612,2019-04-08,908,0,908,72,980,980,0,0
12613,2019-04-08,908,0,908,72,980,980,0,0
12614,2019-04-08,908,0,908,72,980,980,0,0
12615,2019-04-08,630,0,630,50,680,680,0,0
12616,2019-04-08,223,0,223,17,240,240,0,0
12617,2019-04-08,1213,0,1213,97,1310,1310,0,0
12618,2019-04-08,1269,0,1269,101,1370,1370,0,0
12619,2019-04-08,1815,0,1815,145,1960,0,1960,0
12620,2019-04-08,167,0,167,13,180,180,0,0
12621,2019-04-08,769,0,769,61,830,830,0,0
12622,2019-04-08,110,0,110,0,110,110,0,0
12623,2019-04-08,758,0,758,42,800,800,0,0
12624,2019-04-08,1269,0,1269,101,1370,1370,0,0
12625,2019-04-08,871,0,871,69,940,940,0,0
12626,2019-04-08,1084,0,1084,86,1170,1170,0,0
12627,2019-04-08,1121,0,1121,89,1210,1210,0,0
12628,2019-04-08,547,0,547,43,590,590,0,0
12629,2019-04-08,797,0,797,63,860,860,0,0
12630,2019-04-08,139,0,139,11,150,150,0,0
12631,2019-04-08,139,0,139,11,150,150,0,0
12632,2019-04-08,362,0,362,28,390,390,0,0
12633,2019-04-08,1001,0,1001,79,1080,1080,0,0
12634,2019-04-08,167,0,167,13,180,180,0,0
12635,2019-04-08,1139,0,1139,91,1230,1230,0,0
12636,2019-04-08,639,0,639,51,690,690,0,0
12637,2019-04-08,834,0,834,66,900,900,0,0
12638,2019-04-08,667,0,667,53,720,0,720,0
12639,2019-04-08,362,0,362,28,390,390,0,0
12640,2019-04-08,396,-84,312,24,336,336,0,0
12641,2019-04-08,252,-27,225,18,243,243,0,0
12642,2019-04-08,417,0,417,33,450,450,0,0
12643,2019-04-08,501,0,501,39,540,540,0,0
12644,2019-04-08,1167,0,1167,93,1260,1260,0,0
12645,2019-04-08,334,0,334,26,360,360,0,0
12646,2019-04-08,241,0,241,19,260,260,0,0
12647,2019-04-08,463,0,463,37,500,500,0,0
12648,2019-04-08,1204,0,1204,96,1300,1300,0,0
12649,2019-04-08,278,0,278,22,300,300,0,0
12650,2019-04-08,463,0,463,37,500,500,0,0
12651,2019-04-08,1538,0,1538,122,1660,1660,0,0
12652,2019-04-08,667,0,667,53,720,720,0,0
12653,2019-04-08,416,0,416,24,440,440,0,0
12654,2019-04-08,593,0,593,47,640,640,0,0
12655,2019-04-08,360,0,360,20,380,380,0,0
12656,2019-04-08,658,0,658,52,710,710,0,0
12657,2019-04-08,695,0,695,55,750,750,0,0
12658,2019-04-08,408,0,408,32,440,440,0,0
12659,2019-04-08,695,0,695,55,750,750,0,0
12660,2019-04-08,861,0,861,59,920,920,0,0
12661,2019-04-08,593,0,593,47,640,640,0,0
12662,2019-04-08,362,0,362,28,390,390,0,0
12663,2019-04-08,362,0,362,28,390,390,0,0
12664,2019-04-08,288,0,288,22,310,310,0,0
12665,2019-04-08,1010,0,1010,80,1090,1090,0,0
12666,2019-04-08,686,0,686,54,740,740,0,0
12667,2019-04-08,584,0,584,46,630,630,0,0
12668,2019-04-08,501,0,501,39,540,540,0,0
12669,2019-04-08,432,0,432,34,466,466,0,0
12670,2019-04-08,732,0,732,58,790,790,0,0
12671,2019-04-08,251,0,251,19,270,270,0,0
12672,2019-04-08,269,0,269,21,290,290,0,0
12673,2019-04-08,1223,0,1223,97,1320,1320,0,0
12674,2019-04-08,1658,0,1658,132,1790,0,1790,0
12675,2019-04-08,1575,0,1575,125,1700,1700,0,0
12676,2019-04-08,973,0,973,77,1050,1050,0,0
12677,2019-04-08,982,0,982,78,1060,1060,0,0
12678,2019-04-08,732,0,732,58,790,790,0,0
12679,2019-04-08,1815,0,1815,145,1960,1960,0,0
12680,2019-04-08,277,0,277,13,290,290,0,0
12681,2019-04-08,908,0,908,72,980,0,980,0
12682,2019-04-08,908,0,908,72,980,980,0,0
12683,2019-04-08,371,0,371,29,400,400,0,0
12684,2019-04-08,371,0,371,29,400,400,0,0
12685,2019-04-08,1075,0,1075,85,1160,0,1160,0
12686,2019-04-08,371,0,371,29,400,400,0,0
12687,2019-04-08,371,0,371,29,400,400,0,0
12688,2019-04-08,510,0,510,40,550,550,0,0
12689,2019-04-08,47,0,47,3,50,50,0,0
12690,2019-04-08,491,0,491,39,530,530,0,0
12691,2019-04-08,306,0,306,24,330,330,0,0
12692,2019-04-08,121,0,121,9,130,130,0,0
12693,2019-04-08,167,0,167,13,180,180,0,0
12694,2019-04-08,732,0,732,58,790,790,0,0
12695,2019-04-08,362,0,362,28,390,390,0,0
12696,2019-04-08,843,0,843,67,910,910,0,0
12697,2019-04-08,760,0,760,60,820,820,0,0
12698,2019-04-08,741,0,741,59,800,800,0,0
12699,2019-04-08,408,0,408,32,440,440,0,0
12700,2019-04-08,843,0,843,67,910,910,0,0
12701,2019-04-08,167,0,167,13,180,180,0,0
12702,2019-04-08,288,0,288,22,310,310,0,0
12703,2019-04-09,1047,0,1047,83,1130,1130,0,0
12704,2019-04-09,260,0,260,20,280,280,0,0
12705,2019-04-09,760,0,760,60,820,820,0,0
12706,2019-04-09,306,0,306,24,330,330,0,0
12707,2019-04-09,269,0,269,21,290,290,0,0
12708,2019-04-09,306,0,306,24,330,330,0,0
12709,2019-04-09,352,0,352,28,380,380,0,0
12710,2019-04-09,306,0,306,24,330,330,0,0
12711,2019-04-09,371,0,371,29,400,400,0,0
12712,2019-04-09,518,0,518,32,550,550,0,0
12713,2019-04-09,352,0,352,28,380,380,0,0
12714,2019-04-09,491,0,491,39,530,530,0,0
12715,2019-04-09,223,0,223,17,240,240,0,0
12716,2019-04-09,306,0,306,24,330,330,0,0
12717,2019-04-09,334,0,334,26,360,360,0,0
12718,2019-04-09,556,0,556,44,600,600,0,0
12719,2019-04-09,454,0,454,36,490,490,0,0
12720,2019-04-09,797,0,797,63,860,860,0,0
12721,2019-04-09,139,0,139,11,150,150,0,0
12722,2019-04-09,1028,0,1028,82,1110,1110,0,0
12723,2019-04-09,713,0,713,57,770,770,0,0
12724,2019-04-09,1092,0,1092,78,1170,1170,0,0
12725,2019-04-09,704,0,704,56,760,760,0,0
12726,2019-04-09,1815,0,1815,145,1960,1960,0,0
12727,2019-04-09,1343,0,1343,107,1450,1450,0,0
12728,2019-04-09,917,0,917,73,990,990,0,0
12729,2019-04-09,426,0,426,34,460,460,0,0
12730,2019-04-09,260,0,260,20,280,280,0,0
12731,2019-04-09,121,0,121,9,130,130,0,0
12732,2019-04-09,315,0,315,25,340,340,0,0
12733,2019-04-09,482,0,482,38,520,520,0,0
12734,2019-04-09,473,0,473,37,510,510,0,0
12735,2019-04-09,889,0,889,71,960,960,0,0
12736,2019-04-09,315,0,315,25,340,340,0,0
12737,2019-04-09,269,0,269,21,290,290,0,0
12738,2019-04-09,260,0,260,20,280,280,0,0
12739,2019-04-10,1019,0,1019,81,1100,1100,0,0
12740,2019-04-10,667,0,667,53,720,720,0,0
12741,2019-04-10,1167,0,1167,93,1260,1260,0,0
12742,2019-04-10,176,0,176,14,190,190,0,0
12743,2019-04-10,297,0,297,23,320,320,0,0
12744,2019-04-10,713,0,713,57,770,770,0,0
12745,2019-04-10,1325,0,1325,105,1430,0,1430,0
12746,2019-04-10,1149,0,1149,91,1240,1240,0,0
12747,2019-04-10,1362,0,1362,108,1470,1470,0,0
12748,2019-04-10,473,0,473,37,510,510,0,0
12749,2019-04-10,1749,0,1749,131,1880,1880,0,0
12750,2019-04-10,399,0,399,31,430,430,0,0
12751,2019-04-10,269,0,269,21,290,290,0,0
12752,2019-04-10,490,0,490,30,520,520,0,0
12753,2019-04-10,1936,0,1936,154,2090,2090,0,0
12754,2019-04-10,908,0,908,72,980,980,0,0
12755,2019-04-10,639,0,639,51,690,690,0,0
12756,2019-04-10,908,0,908,72,980,980,0,0
12757,2019-04-10,1815,0,1815,145,1960,1960,0,0
12758,2019-04-10,889,0,889,71,960,960,0,0
12759,2019-04-10,1462,0,1462,108,1570,1570,0,0
12760,2019-04-10,343,0,343,27,370,370,0,0
12761,2019-04-10,621,0,621,49,670,670,0,0
12762,2019-04-10,852,0,852,68,920,920,0,0
12763,2019-04-10,251,0,251,19,270,270,0,0
12764,2019-04-10,519,0,519,41,560,560,0,0
12765,2019-04-10,1102,0,1102,88,1190,1190,0,0
12766,2019-04-10,1084,0,1084,86,1170,1170,0,0
12767,2019-04-10,908,0,908,72,980,980,0,0
12768,2019-04-10,880,0,880,70,950,950,0,0
12769,2019-04-10,676,0,676,54,730,730,0,0
12770,2019-04-10,501,0,501,39,540,540,0,0
12771,2019-04-10,371,0,371,29,400,400,0,0
12772,2019-04-10,1176,0,1176,94,1270,1270,0,0
12773,2019-04-10,1519,0,1519,121,1640,1640,0,0
12774,2019-04-10,1815,0,1815,145,1960,1960,0,0
12775,2019-04-10,713,0,713,57,770,0,770,0
12776,2019-04-10,110,0,110,0,110,110,0,0
12777,2019-04-10,584,0,584,46,630,630,0,0
12778,2019-04-10,232,0,232,18,250,250,0,0
12779,2019-04-10,1001,0,1001,79,1080,1080,0,0
12780,2019-04-10,778,0,778,62,840,840,0,0
12781,2019-04-10,908,0,908,72,980,980,0,0
12782,2019-04-10,334,0,334,26,360,360,0,0
12783,2019-04-10,510,0,510,40,550,550,0,0
12784,2019-04-10,417,0,417,33,450,450,0,0
12785,2019-04-10,297,0,297,23,320,320,0,0
12786,2019-04-10,1843,0,1843,147,1990,1990,0,0
12787,2019-04-10,1213,0,1213,97,1310,1310,0,0
12788,2019-04-10,1130,0,1130,90,1220,1220,0,0
12789,2019-04-10,1296,0,1296,94,1390,0,1390,0
12790,2019-04-10,760,0,760,60,820,820,0,0
12791,2019-04-10,908,0,908,72,980,980,0,0
12792,2019-04-10,1306,0,1306,104,1410,1410,0,0
12793,2019-04-10,547,0,547,43,590,590,0,0
12794,2019-04-10,695,0,695,55,750,750,0,0
12795,2019-04-10,176,0,176,14,190,190,0,0
12796,2019-04-10,908,0,908,72,980,980,0,0
12797,2019-04-10,1038,0,1038,82,1120,1120,0,0
12798,2019-04-10,1575,0,1575,125,1700,1700,0,0
12799,2019-04-10,47,0,47,3,50,50,0,0
12800,2019-04-10,1408,0,1408,112,1520,1520,0,0
12801,2019-04-10,538,0,538,42,580,580,0,0
12802,2019-04-10,186,0,186,14,200,200,0,0
12803,2019-04-10,528,0,528,42,570,570,0,0
12804,2019-04-10,167,0,167,13,180,180,0,0
12805,2019-04-10,593,0,593,47,640,640,0,0
12806,2019-04-10,186,0,186,14,200,200,0,0
12807,2019-04-10,176,0,176,14,190,190,0,0
12808,2019-04-10,362,0,362,28,390,390,0,0
12809,2019-04-10,797,0,797,63,860,860,0,0
12810,2019-04-10,1241,0,1241,99,1340,0,1340,0
12811,2019-04-10,732,0,732,58,790,790,0,0
12812,2019-04-10,501,0,501,39,540,540,0,0
12813,2019-04-10,1352,0,1352,108,1460,1460,0,0
12814,2019-04-10,788,0,788,62,850,850,0,0
12815,2019-04-10,362,0,362,28,390,390,0,0
12816,2019-04-10,621,0,621,49,670,670,0,0
12817,2019-04-10,1852,0,1852,148,2000,2000,0,0
12818,2019-04-10,139,0,139,11,150,150,0,0
12819,2019-04-10,1519,0,1519,121,1640,1640,0,0
12820,2019-04-10,1823,0,1823,137,1960,1960,0,0
12821,2019-04-10,686,0,686,54,740,740,0,0
12822,2019-04-10,658,0,658,52,710,710,0,0
12823,2019-04-10,501,0,501,39,540,540,0,0
12824,2019-04-10,788,0,788,62,850,850,0,0
12825,2019-04-10,454,0,454,36,490,490,0,0
12826,2019-04-10,315,0,315,25,340,340,0,0
12827,2019-04-10,806,0,806,64,870,870,0,0
12828,2019-04-10,788,0,788,62,850,850,0,0
12829,2019-04-10,362,0,362,28,390,390,0,0
12830,2019-04-10,343,0,343,27,370,370,0,0
12831,2019-04-10,908,0,908,72,980,980,0,0
12832,2019-04-10,908,0,908,72,980,980,0,0
12833,2019-04-10,834,0,834,66,900,900,0,0
12834,2019-04-10,759,0,759,51,810,810,0,0
12835,2019-04-10,1815,0,1815,145,1960,1960,0,0
12836,2019-04-10,676,0,676,54,730,730,0,0
12837,2019-04-10,232,0,232,18,250,250,0,0
12838,2019-04-10,556,0,556,44,600,600,0,0
12839,2019-04-10,223,0,223,17,240,240,0,0
12840,2019-04-10,908,0,908,72,980,980,0,0
12841,2019-04-10,751,0,751,59,810,810,0,0
12842,2019-04-10,834,0,834,66,900,900,0,0
12843,2019-04-10,639,0,639,51,690,690,0,0
12844,2019-04-10,713,0,713,57,770,770,0,0
12845,2019-04-10,945,0,945,75,1020,0,1020,0
12846,2019-04-10,408,0,408,32,440,440,0,0
12847,2019-04-10,260,0,260,20,280,280,0,0
12848,2019-04-10,463,0,463,37,500,500,0,0
12849,2019-04-10,1815,0,1815,145,1960,1960,0,0
12850,2019-04-10,334,0,334,26,360,360,0,0
12851,2019-04-10,482,0,482,38,520,520,0,0
12852,2019-04-10,676,0,676,54,730,730,0,0
12853,2019-04-10,510,0,510,40,550,0,550,0
12854,2019-04-11,908,0,908,72,980,980,0,0
12855,2019-04-11,1176,0,1176,94,1270,1270,0,0
12856,2019-04-11,1973,0,1973,157,2130,0,2130,0
12857,2019-04-11,1232,0,1232,98,1330,1330,0,0
12858,2019-04-11,639,0,639,51,690,690,0,0
12859,2019-04-11,908,0,908,72,980,0,980,0
12860,2019-04-11,1084,0,1084,86,1170,1170,0,0
12861,2019-04-11,1038,0,1038,82,1120,1120,0,0
12862,2019-04-11,732,0,732,58,790,790,0,0
12863,2019-04-11,593,0,593,47,640,640,0,0
12864,2019-04-11,232,0,232,18,250,250,0,0
12865,2019-04-11,1121,0,1121,89,1210,1210,0,0
12866,2019-04-11,1038,0,1038,82,1120,1120,0,0
12867,2019-04-11,713,0,713,57,770,770,0,0
12868,2019-04-11,843,0,843,67,910,910,0,0
12869,2019-04-11,482,0,482,38,520,520,0,0
12870,2019-04-11,843,0,843,67,910,910,0,0
12871,2019-04-11,908,0,908,72,980,980,0,0
12872,2019-04-11,630,0,630,50,680,680,0,0
12873,2019-04-11,584,0,584,46,630,630,0,0
12874,2019-04-11,1024,0,1024,81,1105,1105,0,0
12875,2019-04-11,741,0,741,59,800,800,0,0
12876,2019-04-11,277,0,277,13,290,290,0,0
12877,2019-04-11,482,0,482,38,520,520,0,0
12878,2019-04-11,908,0,908,72,980,980,0,0
12879,2019-04-11,343,0,343,27,370,370,0,0
12880,2019-04-11,916,0,916,64,980,980,0,0
12881,2019-04-11,445,0,445,35,480,480,0,0
12882,2019-04-11,250,0,250,20,270,270,0,0
12883,2019-04-11,538,0,538,42,580,580,0,0
12884,2019-04-11,769,0,769,61,830,830,0,0
12885,2019-04-11,463,0,463,37,500,500,0,0
12886,2019-04-11,389,0,389,31,420,420,0,0
12887,2019-04-11,547,0,547,43,590,590,0,0
12888,2019-04-11,527,0,527,33,560,560,0,0
12889,2019-04-11,602,0,602,48,650,650,0,0
12890,2019-04-11,315,0,315,25,340,340,0,0
12891,2019-04-11,630,0,630,50,680,680,0,0
12892,2019-04-11,482,0,482,38,520,520,0,0
12893,2019-04-11,1564,0,1564,116,1680,1680,0,0
12894,2019-04-11,278,0,278,22,300,300,0,0
12895,2019-04-11,945,0,945,75,1020,1020,0,0
12896,2019-04-11,1575,0,1575,125,1700,1700,0,0
12897,2019-04-11,343,0,343,27,370,370,0,0
12898,2019-04-11,501,0,501,39,540,540,0,0
12899,2019-04-11,288,0,288,22,310,310,0,0
12900,2019-04-11,491,0,491,39,530,530,0,0
12901,2019-04-11,213,0,213,17,230,230,0,0
12902,2019-04-11,1815,0,1815,145,1960,0,1960,0
12903,2019-04-11,371,0,371,29,400,400,0,0
12904,2019-04-11,609,0,609,31,640,640,0,0
12905,2019-04-11,139,0,139,11,150,150,0,0
12906,2019-04-11,399,0,399,31,430,430,0,0
12907,2019-04-11,1815,0,1815,145,1960,1960,0,0
12908,2019-04-11,1260,0,1260,100,1360,1360,0,0
12909,2019-04-11,1519,0,1519,121,1640,0,1640,0
12910,2019-04-11,547,0,547,43,590,590,0,0
12911,2019-04-11,1288,0,1288,102,1390,1390,0,0
12912,2019-04-11,362,0,362,28,390,390,0,0
12913,2019-04-11,510,0,510,40,550,550,0,0
12914,2019-04-11,658,0,658,52,710,710,0,0
12915,2019-04-11,1306,0,1306,104,1410,1410,0,0
12916,2019-04-11,519,0,519,41,560,560,0,0
12917,2019-04-11,1315,0,1315,105,1420,1420,0,0
12918,2019-04-11,704,0,704,56,760,760,0,0
12919,2019-04-11,491,0,491,39,530,530,0,0
12920,2019-04-11,389,0,389,31,420,420,0,0
12921,2019-04-11,908,0,908,72,980,980,0,0
12922,2019-04-11,426,0,426,34,460,460,0,0
12923,2019-04-11,482,0,482,38,520,520,0,0
12924,2019-04-11,436,0,436,34,470,470,0,0
12925,2019-04-11,269,0,269,21,290,290,0,0
12926,2019-04-11,482,0,482,38,520,520,0,0
12927,2019-04-11,213,0,213,17,230,230,0,0
12928,2019-04-11,741,0,741,59,800,800,0,0
12929,2019-04-11,213,0,213,17,230,230,0,0
12930,2019-04-11,982,0,982,78,1060,0,1060,0
12931,2019-04-11,500,0,500,40,540,540,0,0
12932,2019-04-11,1186,0,1186,94,1280,1280,0,0
12933,2019-04-11,2019,0,2019,161,2180,2180,0,0
12934,2019-04-11,760,0,760,60,820,820,0,0
12935,2019-04-11,278,0,278,22,300,300,0,0
12936,2019-04-11,371,0,371,29,400,400,0,0
12937,2019-04-11,593,0,593,47,640,640,0,0
12938,2019-04-11,491,0,491,39,530,530,0,0
12939,2019-04-11,621,0,621,49,670,670,0,0
12940,2019-04-11,510,0,510,40,550,550,0,0
12941,2019-04-11,251,0,251,19,270,270,0,0
12942,2019-04-11,491,0,491,39,530,530,0,0
12943,2019-04-11,213,0,213,17,230,230,0,0
12944,2019-04-11,260,0,260,20,280,0,280,0
12945,2019-04-11,260,0,260,20,280,280,0,0
12946,2019-04-11,806,0,806,64,870,870,0,0
12947,2019-04-11,250,0,250,20,270,270,0,0
12948,2019-04-11,908,0,908,72,980,980,0,0
12949,2019-04-11,2269,0,2269,181,2450,2450,0,0
12950,2019-04-11,704,0,704,56,760,760,0,0
12951,2019-04-11,445,0,445,35,480,480,0,0
12952,2019-04-11,973,0,973,77,1050,1050,0,0
12953,2019-04-11,843,0,843,67,910,910,0,0
12954,2019-04-11,297,0,297,23,320,320,0,0
12955,2019-04-11,556,0,556,44,600,600,0,0
12956,2019-04-11,732,0,732,58,790,790,0,0
12957,2019-04-11,306,0,306,24,330,330,0,0
12958,2019-04-11,371,0,371,29,400,400,0,0
12959,2019-04-11,704,0,704,56,760,760,0,0
12960,2019-04-11,538,0,538,42,580,580,0,0
12961,2019-04-11,102,0,102,8,110,110,0,0
12962,2019-04-11,315,0,315,25,340,340,0,0
12963,2019-04-11,889,0,889,71,960,960,0,0
12964,2019-04-11,843,0,843,67,910,910,0,0
12965,2019-04-11,3149,0,3149,251,3400,0,3400,0
12966,2019-04-11,788,0,788,62,850,850,0,0
12967,2019-04-11,649,0,649,51,700,700,0,0
12968,2019-04-11,788,0,788,62,850,850,0,0
12969,2019-04-11,788,0,788,62,850,850,0,0
12970,2019-04-11,788,0,788,62,850,850,0,0
12971,2019-04-11,713,0,713,57,770,770,0,0
12972,2019-04-11,362,0,362,28,390,390,0,0
12973,2019-04-11,407,0,407,23,430,430,0,0
12974,2019-04-11,519,0,519,41,560,560,0,0
12975,2019-04-11,334,0,334,26,360,360,0,0
12976,2019-04-11,371,0,371,29,400,400,0,0
12977,2019-04-11,260,0,260,20,280,280,0,0
12978,2019-04-11,676,0,676,54,730,730,0,0
12979,2019-04-11,815,0,815,65,880,880,0,0
12980,2019-04-11,2213,0,2213,177,2390,2390,0,0
12981,2019-04-11,1463,0,1463,117,1580,1580,0,0
12982,2019-04-11,612,0,612,48,660,660,0,0
12983,2019-04-11,751,0,751,59,810,810,0,0
12984,2019-04-11,112,0,112,8,120,120,0,0
12985,2019-04-11,501,0,501,39,540,540,0,0
12986,2019-04-11,-464,0,-464,-36,-500,-500,0,0
12987,2019-04-11,1278,0,1278,102,1380,1380,0,0
12988,2019-04-11,741,0,741,59,800,800,0,0
12989,2019-04-11,334,0,334,26,360,360,0,0
12990,2019-04-11,592,0,592,38,630,630,0,0
12991,2019-04-11,306,0,306,24,330,330,0,0
12992,2019-04-11,639,0,639,51,690,690,0,0
12993,2019-04-11,1379,0,1379,101,1480,1480,0,0
12994,2019-04-11,315,0,315,25,340,340,0,0
12995,2019-04-11,-464,0,-464,-36,-500,-500,0,0
12996,2019-04-11,963,0,963,77,1040,1040,0,0
12997,2019-04-11,334,0,334,26,360,360,0,0
12998,2019-04-11,788,0,788,62,850,850,0,0
12999,2019-04-11,1038,0,1038,82,1120,1120,0,0
13000,2019-04-11,1815,0,1815,145,1960,1960,0,0
13001,2019-04-11,1001,0,1001,79,1080,1080,0,0
13002,2019-04-11,852,0,852,68,920,920,0,0
13003,2019-04-11,538,0,538,42,580,580,0,0
13004,2019-04-11,528,0,528,42,570,570,0,0
13005,2019-04-11,306,0,306,24,330,330,0,0
13006,2019-04-11,700,0,700,55,755,755,0,0
13007,2019-04-11,917,0,917,73,990,990,0,0
13008,2019-04-11,389,0,389,31,420,420,0,0
13009,2019-04-11,1463,0,1463,117,1580,1580,0,0
13010,2019-04-11,399,0,399,31,430,430,0,0
13011,2019-04-11,278,0,278,22,300,300,0,0
13012,2019-04-11,269,0,269,21,290,290,0,0
13013,2019-04-11,1972,0,1972,148,2120,2120,0,0
13014,2019-04-11,686,0,686,54,740,740,0,0
13015,2019-04-11,389,0,389,31,420,420,0,0
13016,2019-04-11,47,0,47,3,50,50,0,0
13017,2019-04-11,1334,0,1334,106,1440,0,1440,0
13018,2019-04-11,453,0,453,27,480,480,0,0
13019,2019-04-11,482,0,482,38,520,520,0,0
13020,2019-04-11,491,0,491,39,530,530,0,0
13021,2019-04-11,1352,0,1352,108,1460,1460,0,0
13022,2019-04-11,510,0,510,40,550,550,0,0
13023,2019-04-11,788,0,788,62,850,850,0,0
13024,2019-04-11,1065,0,1065,85,1150,1150,0,0
13025,2019-04-11,1917,0,1917,153,2070,2070,0,0
13026,2019-04-11,602,0,602,48,650,650,0,0
13027,2019-04-11,167,0,167,13,180,180,0,0
13028,2019-04-11,788,0,788,62,850,850,0,0
13029,2019-04-11,788,0,788,62,850,850,0,0
13030,2019-04-11,1556,0,1556,124,1680,1680,0,0
13031,2019-04-11,788,0,788,62,850,850,0,0
13032,2019-04-11,167,0,167,13,180,180,0,0
13033,2019-04-11,297,0,297,23,320,320,0,0
13034,2019-04-11,926,0,926,74,1000,1000,0,0
13035,2019-04-11,1186,0,1186,94,1280,1280,0,0
13036,2019-04-11,426,0,426,34,460,460,0,0
13037,2019-04-11,343,0,343,27,370,370,0,0
13038,2019-04-11,139,0,139,11,150,150,0,0
13039,2019-04-11,2075,0,2075,165,2240,2240,0,0
13040,2019-04-11,778,0,778,62,840,840,0,0
13041,2019-04-11,149,0,149,11,160,160,0,0
13042,2019-04-11,602,0,602,48,650,650,0,0
13043,2019-04-11,362,0,362,28,390,390,0,0
13044,2019-04-11,510,0,510,40,550,550,0,0
13045,2019-04-12,334,0,334,26,360,360,0,0
13046,2019-04-12,232,0,232,18,250,250,0,0
13047,2019-04-12,686,0,686,54,740,740,0,0
13048,2019-04-12,667,0,667,53,720,720,0,0
13049,2019-04-12,842,0,842,58,900,900,0,0
13050,2019-04-12,1092,0,1092,78,1170,1170,0,0
13051,2019-04-12,658,0,658,52,710,710,0,0
13052,2019-04-12,953,0,953,67,1020,1020,0,0
13053,2019-04-12,1575,0,1575,125,1700,1700,0,0
13054,2019-04-12,1195,0,1195,95,1290,1290,0,0
13055,2019-04-12,167,0,167,13,180,180,0,0
13056,2019-04-12,1436,0,1436,114,1550,1550,0,0
13057,2019-04-12,2158,0,2158,172,2330,2330,0,0
13058,2019-04-12,1399,0,1399,111,1510,1510,0,0
13059,2019-04-12,1084,0,1084,86,1170,1170,0,0
13060,2019-04-12,602,0,602,48,650,650,0,0
13061,2019-04-12,908,0,908,72,980,0,980,0
13062,2019-04-12,2723,0,2723,217,2940,2940,0,0
13063,2019-04-12,584,0,584,46,630,630,0,0
13064,2019-04-12,3371,0,3371,269,3640,3640,0,0
13065,2019-04-12,769,0,769,61,830,830,0,0
13066,2019-04-12,1038,0,1038,82,1120,1120,0,0
13067,2019-04-12,1325,0,1325,105,1430,0,1430,0
13068,2019-04-12,315,0,315,25,340,340,0,0
13069,2019-04-12,1815,0,1815,145,1960,1960,0,0
13070,2019-04-12,426,0,426,34,460,460,0,0
13071,2019-04-12,2047,0,2047,163,2210,2210,0,0
13072,2019-04-12,1815,0,1815,145,1960,1960,0,0
13073,2019-04-12,56,0,56,4,60,60,0,0
13074,2019-04-12,380,0,380,30,410,410,0,0
13075,2019-04-12,1269,0,1269,101,1370,1370,0,0
13076,2019-04-12,538,0,538,42,580,580,0,0
13077,2019-04-12,176,0,176,14,190,190,0,0
13078,2019-04-12,2075,0,2075,165,2240,2240,0,0
13079,2019-04-12,2334,0,2334,186,2520,2520,0,0
13080,2019-04-12,1815,0,1815,145,1960,1960,0,0
13081,2019-04-12,2038,0,2038,162,2200,2200,0,0
13082,2019-04-12,1343,0,1343,107,1450,1450,0,0
13083,2019-04-12,908,0,908,72,980,980,0,0
13084,2019-04-12,1269,0,1269,101,1370,1370,0,0
13085,2019-04-12,612,0,612,48,660,660,0,0
13086,2019-04-12,899,0,899,71,970,970,0,0
13087,2019-04-12,1815,0,1815,145,1960,1960,0,0
13088,2019-04-12,510,0,510,40,550,550,0,0
13089,2019-04-12,908,0,908,72,980,980,0,0
13090,2019-04-12,371,0,371,29,400,400,0,0
13091,2019-04-12,639,0,639,51,690,690,0,0
13092,2019-04-12,167,0,167,13,180,180,0,0
13093,2019-04-12,1288,0,1288,102,1390,0,1390,0
13094,2019-04-12,454,0,454,36,490,490,0,0
13095,2019-04-12,2222,-238,1984,158,2142,0,2142,0
13096,2019-04-12,510,0,510,40,550,550,0,0
13097,2019-04-12,1815,0,1815,145,1960,1960,0,0
13098,2019-04-12,352,0,352,28,380,380,0,0
13099,2019-04-12,269,0,269,21,290,290,0,0
13100,2019-04-12,908,0,908,72,980,980,0,0
13101,2019-04-12,926,0,926,74,1000,1000,0,0
13102,2019-04-12,621,0,621,49,670,670,0,0
13103,2019-04-12,260,0,260,20,280,280,0,0
13104,2019-04-12,149,0,149,11,160,160,0,0
13105,2019-04-12,1186,0,1186,94,1280,1280,0,0
13106,2019-04-12,528,0,528,42,570,570,0,0
13107,2019-04-12,556,0,556,44,600,600,0,0
13108,2019-04-12,491,0,491,39,530,530,0,0
13109,2019-04-12,1019,0,1019,81,1100,1100,0,0
13110,2019-04-12,278,0,278,22,300,300,0,0
13111,2019-04-12,510,0,510,40,550,550,0,0
13112,2019-04-12,472,0,472,28,500,500,0,0
13113,2019-04-12,2723,0,2723,217,2940,2940,0,0
13114,2019-04-12,723,0,723,57,780,780,0,0
13115,2019-04-12,158,0,158,12,170,170,0,0
13116,2019-04-12,362,0,362,28,390,390,0,0
13117,2019-04-12,260,0,260,20,280,280,0,0
13118,2019-04-12,658,0,658,52,710,0,710,0
13119,2019-04-12,362,0,362,28,390,390,0,0
13120,2019-04-12,399,0,399,31,430,430,0,0
13121,2019-04-12,741,0,741,59,800,800,0,0
13122,2019-04-12,389,0,389,31,420,420,0,0
13123,2019-04-12,501,0,501,39,540,540,0,0
13124,2019-04-12,1602,0,1602,128,1730,1730,0,0
13125,2019-04-12,1815,0,1815,145,1960,1960,0,0
13126,2019-04-12,1815,0,1815,145,1960,1960,0,0
13127,2019-04-12,510,0,510,40,550,550,0,0
13128,2019-04-12,1815,0,1815,145,1960,1960,0,0
13129,2019-04-12,1815,0,1815,145,1960,1960,0,0
13130,2019-04-12,1815,0,1815,145,1960,1960,0,0
13131,2019-04-12,371,0,371,29,400,400,0,0
13132,2019-04-12,695,0,695,55,750,750,0,0
13133,2019-04-12,3019,0,3019,241,3260,3260,0,0
13134,2019-04-12,565,0,565,45,610,610,0,0
13135,2019-04-12,917,0,917,73,990,990,0,0
13136,2019-04-12,723,0,723,57,780,780,0,0
13137,2019-04-12,1306,0,1306,104,1410,1410,0,0
13138,2019-04-12,1352,0,1352,108,1460,1460,0,0
13139,2019-04-12,149,0,149,11,160,160,0,0
13140,2019-04-12,2213,0,2213,177,2390,0,2390,0
13141,2019-04-12,399,0,399,31,430,430,0,0
13142,2019-04-12,1010,0,1010,80,1090,1090,0,0
13143,2019-04-12,2723,0,2723,217,2940,0,2940,0
13144,2019-04-12,797,0,797,63,860,860,0,0
13145,2019-04-12,149,0,149,11,160,160,0,0
13146,2019-04-12,269,0,269,21,290,290,0,0
13147,2019-04-12,556,0,556,44,600,0,600,0
13148,2019-04-12,908,0,908,72,980,980,0,0
13149,2019-04-12,463,0,463,37,500,500,0,0
13150,2019-04-12,945,0,945,75,1020,1020,0,0
13151,2019-04-12,445,0,445,35,480,480,0,0
13152,2019-04-12,1195,0,1195,95,1290,0,1290,0
13153,2019-04-12,1584,0,1584,126,1710,1710,0,0
13154,2019-04-12,1102,0,1102,88,1190,1190,0,0
13155,2019-04-12,649,0,649,51,700,700,0,0
13156,2019-04-12,806,0,806,64,870,870,0,0
13157,2019-04-12,139,0,139,11,150,150,0,0
13158,2019-04-12,260,0,260,20,280,280,0,0
13159,2019-04-12,1065,0,1065,85,1150,1150,0,0
13160,2019-04-12,232,0,232,18,250,0,250,0
13161,2019-04-12,223,0,223,17,240,240,0,0
13162,2019-04-12,399,0,399,31,430,430,0,0
13163,2019-04-12,371,0,371,29,400,400,0,0
13164,2019-04-12,380,0,380,30,410,410,0,0
13165,2019-04-12,371,0,371,29,400,400,0,0
13166,2019-04-12,954,0,954,76,1030,1030,0,0
13167,2019-04-12,1028,0,1028,82,1110,1110,0,0
13168,2019-04-12,371,0,371,29,400,400,0,0
13169,2019-04-12,223,0,223,17,240,240,0,0
13170,2019-04-12,621,0,621,49,670,670,0,0
13171,2019-04-12,362,0,362,28,390,390,0,0
13172,2019-04-12,917,0,917,73,990,990,0,0
13173,2019-04-12,2528,0,2528,202,2730,2730,0,0
13174,2019-04-12,130,0,130,10,140,140,0,0
13175,2019-04-12,223,0,223,17,240,240,0,0
13176,2019-04-12,519,0,519,41,560,560,0,0
13177,2019-04-12,741,0,741,59,800,800,0,0
13178,2019-04-12,278,0,278,22,300,300,0,0
13179,2019-04-12,1038,0,1038,82,1120,1120,0,0
13180,2019-04-12,399,0,399,31,430,430,0,0
13181,2019-04-12,676,0,676,54,730,730,0,0
13182,2019-04-12,1445,0,1445,115,1560,1560,0,0
13183,2019-04-12,167,0,167,13,180,180,0,0
13184,2019-04-12,269,0,269,21,290,290,0,0
13185,2019-04-12,741,0,741,59,800,800,0,0
13186,2019-04-12,730,0,730,40,770,770,0,0
13187,2019-04-12,399,0,399,31,430,430,0,0
13188,2019-04-12,315,0,315,25,340,340,0,0
13189,2019-04-12,297,0,297,23,320,320,0,0
13190,2019-04-12,908,0,908,72,980,980,0,0
13191,2019-04-12,1010,0,1010,80,1090,1090,0,0
13192,2019-04-12,278,0,278,22,300,300,0,0
13193,2019-04-12,1019,0,1019,81,1100,0,1100,0
13194,2019-04-12,389,0,389,31,420,420,0,0
13195,2019-04-12,250,0,250,20,270,270,0,0
13196,2019-04-12,278,0,278,22,300,300,0,0
13197,2019-04-12,491,0,491,39,530,530,0,0
13198,2019-04-12,1352,0,1352,108,1460,1460,0,0
13199,2019-04-12,278,0,278,22,300,300,0,0
13200,2019-04-12,1621,0,1621,129,1750,1750,0,0
13201,2019-04-12,260,0,260,20,280,280,0,0
13202,2019-04-12,241,0,241,19,260,260,0,0
13203,2019-04-12,417,0,417,33,450,450,0,0
13204,2019-04-12,676,0,676,54,730,730,0,0
13205,2019-04-12,343,0,343,27,370,370,0,0
13206,2019-04-12,1176,0,1176,94,1270,0,1270,0
13207,2019-04-12,880,0,880,70,950,950,0,0
13208,2019-04-12,408,0,408,32,440,440,0,0
13209,2019-04-12,445,0,445,35,480,480,0,0
13210,2019-04-12,343,0,343,27,370,370,0,0
13211,2019-04-12,788,0,788,62,850,850,0,0
13212,2019-04-12,1936,0,1936,154,2090,2090,0,0
13213,2019-04-12,815,0,815,65,880,880,0,0
13214,2019-04-12,741,0,741,59,800,800,0,0
13215,2019-04-12,602,0,602,48,650,650,0,0
13216,2019-04-12,769,0,769,61,830,0,830,0
13217,2019-04-12,612,0,612,48,660,660,0,0
13218,2019-04-12,1575,0,1575,125,1700,1700,0,0
13219,2019-04-12,1575,0,1575,125,1700,1700,0,0
13220,2019-04-12,1306,0,1306,104,1410,1410,0,0
13221,2019-04-12,463,0,463,37,500,500,0,0
13222,2019-04-12,306,0,306,24,330,330,0,0
13223,2019-04-12,463,0,463,37,500,500,0,0
13224,2019-04-12,658,0,658,52,710,710,0,0
13225,2019-04-12,917,0,917,73,990,990,0,0
13226,2019-04-12,825,0,825,65,890,890,0,0
13227,2019-04-12,1445,0,1445,115,1560,1560,0,0
13228,2019-04-12,630,0,630,50,680,680,0,0
13229,2019-04-12,325,0,325,25,350,350,0,0
13230,2019-04-12,379,0,379,21,400,400,0,0
13231,2019-04-12,732,0,732,58,790,790,0,0
13232,2019-04-12,1075,0,1075,85,1160,1160,0,0
13233,2019-04-12,223,0,223,17,240,240,0,0
13234,2019-04-12,1315,0,1315,105,1420,1420,0,0
13235,2019-04-12,1325,0,1325,105,1430,1430,0,0
13236,2019-04-12,907,0,907,63,970,970,0,0
13237,2019-04-12,2351,0,2351,179,2530,0,2530,0
13238,2019-04-12,593,0,593,47,640,640,0,0
13239,2019-04-12,1362,0,1362,108,1470,1470,0,0
13240,2019-04-12,788,0,788,62,850,850,0,0
13241,2019-04-12,862,0,862,68,930,930,0,0
13242,2019-04-12,1222,0,1222,88,1310,1310,0,0
13243,2019-04-12,1084,0,1084,86,1170,1170,0,0
13244,2019-04-12,2130,0,2130,170,2300,2300,0,0
13245,2019-04-12,1297,0,1297,103,1400,1400,0,0
13246,2019-04-12,1528,0,1528,122,1650,1650,0,0
13247,2019-04-12,1575,0,1575,125,1700,0,1700,0
13248,2019-04-12,1056,0,1056,84,1140,0,1140,0
13249,2019-04-12,306,0,306,24,330,330,0,0
13250,2019-04-12,-1056,0,-1056,-84,-1140,0,-1140,0
13251,2019-04-12,-1056,0,-1056,-84,-1140,-1140,0,0
13252,2019-04-12,1575,0,1575,125,1700,1700,0,0
13253,2019-04-12,1056,0,1056,84,1140,1140,0,0
13254,2019-04-12,1056,0,1056,84,1140,0,1140,0
13255,2019-04-12,510,0,510,40,550,550,0,0
13256,2019-04-12,788,0,788,62,850,850,0,0
13257,2019-04-12,278,0,278,22,300,300,0,0
13258,2019-04-12,1028,0,1028,82,1110,1110,0,0
13259,2019-04-12,612,0,612,48,660,660,0,0
13260,2019-04-12,213,0,213,17,230,230,0,0
13261,2019-04-12,806,0,806,64,870,870,0,0
13262,2019-04-12,1510,0,1510,120,1630,1630,0,0
13263,2019-04-12,1852,0,1852,148,2000,2000,0,0
13264,2019-04-12,788,0,788,62,850,850,0,0
13265,2019-04-13,2237,0,2237,143,2380,2380,0,0
13266,2019-04-13,788,0,788,62,850,850,0,0
13267,2019-04-13,2425,0,2425,185,2610,0,2610,0
13268,2019-04-13,556,0,556,44,600,600,0,0
13269,2019-04-13,399,0,399,31,430,430,0,0
13270,2019-04-13,1213,0,1213,97,1310,1310,0,0
13271,2019-04-13,186,0,186,14,200,200,0,0
13272,2019-04-13,1158,0,1158,92,1250,1250,0,0
13273,2019-04-13,4723,0,4723,377,5100,5100,0,0
13274,2019-04-13,834,0,834,66,900,900,0,0
13275,2019-04-13,556,0,556,44,600,600,0,0
13276,2019-04-13,399,0,399,31,430,430,0,0
13277,2019-04-13,584,0,584,46,630,630,0,0
13278,2019-04-13,1399,0,1399,111,1510,1510,0,0
13279,2019-04-13,3084,0,3084,246,3330,3330,0,0
13280,2019-04-13,778,0,778,62,840,840,0,0
13281,2019-04-13,575,0,575,45,620,620,0,0
13282,2019-04-13,481,0,481,29,510,510,0,0
13283,2019-04-13,334,0,334,26,360,360,0,0
13284,2019-04-13,2277,0,2277,173,2450,2450,0,0
13285,2019-04-13,963,0,963,77,1040,1040,0,0
13286,2019-04-13,1815,0,1815,145,1960,1960,0,0
13287,2019-04-13,630,0,630,50,680,680,0,0
13288,2019-04-13,1112,0,1112,88,1200,1200,0,0
13289,2019-04-13,695,0,695,55,750,750,0,0
13290,2019-04-13,334,0,334,26,360,360,0,0
13291,2019-04-13,889,0,889,71,960,960,0,0
13292,2019-04-13,788,0,788,62,850,850,0,0
13293,2019-04-13,630,0,630,50,680,680,0,0
13294,2019-04-13,1065,0,1065,85,1150,1150,0,0
13295,2019-04-13,1149,0,1149,91,1240,1240,0,0
13296,2019-04-13,1593,0,1593,127,1720,1720,0,0
13297,2019-04-13,426,0,426,34,460,460,0,0
13298,2019-04-13,1325,0,1325,105,1430,1430,0,0
13299,2019-04-13,908,0,908,72,980,980,0,0
13300,2019-04-13,1575,0,1575,125,1700,1700,0,0
13301,2019-04-13,370,0,370,20,390,390,0,0
13302,2019-04-13,1213,0,1213,97,1310,1310,0,0
13303,2019-04-13,917,0,917,73,990,990,0,0
13304,2019-04-13,1362,0,1362,108,1470,1470,0,0
13305,2019-04-13,797,0,797,63,860,860,0,0
13306,2019-04-13,593,0,593,47,640,640,0,0
13307,2019-04-13,1760,0,1760,140,1900,1900,0,0
13308,2019-04-13,1380,0,1380,110,1490,1490,0,0
13309,2019-04-13,260,0,260,20,280,280,0,0
13310,2019-04-13,1139,0,1139,91,1230,1230,0,0
13311,2019-04-13,1815,0,1815,145,1960,1960,0,0
13312,2019-04-13,538,0,538,42,580,580,0,0
13313,2019-04-13,482,0,482,38,520,520,0,0
13314,2019-04-13,501,0,501,39,540,540,0,0
13315,2019-04-13,973,0,973,77,1050,1050,0,0
13316,2019-04-13,2954,0,2954,236,3190,3190,0,0
13317,2019-04-13,713,0,713,57,770,770,0,0
13318,2019-04-13,1084,0,1084,86,1170,1170,0,0
13319,2019-04-13,454,0,454,36,490,490,0,0
13320,2019-04-13,649,0,649,51,700,700,0,0
13321,2019-04-13,1547,0,1547,123,1670,1670,0,0
13322,2019-04-13,1130,0,1130,90,1220,1220,0,0
13323,2019-04-13,797,0,797,63,860,860,0,0
13324,2019-04-13,760,0,760,60,820,820,0,0
13325,2019-04-13,139,0,139,11,150,150,0,0
13326,2019-04-13,1834,0,1834,146,1980,1980,0,0
13327,2019-04-13,519,0,519,41,560,560,0,0
13328,2019-04-13,751,0,751,59,810,810,0,0
13329,2019-04-13,426,0,426,34,460,460,0,0
13330,2019-04-13,658,0,658,52,710,710,0,0
13331,2019-04-13,1315,0,1315,105,1420,1420,0,0
13332,2019-04-13,510,0,510,40,550,550,0,0
13333,2019-04-13,260,0,260,20,280,280,0,0
13334,2019-04-13,306,0,306,24,330,330,0,0
13335,2019-04-13,251,0,251,19,270,270,0,0
13336,2019-04-13,315,0,315,25,340,340,0,0
13337,2019-04-13,260,0,260,20,280,280,0,0
13338,2019-04-13,1815,0,1815,145,1960,1960,0,0
13339,2019-04-13,315,0,315,25,340,340,0,0
13340,2019-04-13,723,0,723,57,780,780,0,0
13341,2019-04-13,695,0,695,55,750,750,0,0
13342,2019-04-13,1815,0,1815,145,1960,1960,0,0
13343,2019-04-13,797,0,797,63,860,860,0,0
13344,2019-04-13,1815,0,1815,145,1960,1960,0,0
13345,2019-04-13,908,0,908,72,980,980,0,0
13346,2019-04-13,908,0,908,72,980,980,0,0
13347,2019-04-13,1815,0,1815,145,1960,1960,0,0
13348,2019-04-13,176,0,176,14,190,190,0,0
13349,2019-04-13,334,0,334,26,360,360,0,0
13350,2019-04-13,343,0,343,27,370,370,0,0
13351,2019-04-13,306,0,306,24,330,330,0,0
13352,2019-04-13,519,0,519,41,560,560,0,0
13353,2019-04-13,676,0,676,54,730,730,0,0
13354,2019-04-13,334,0,334,26,360,360,0,0
13355,2019-04-13,102,0,102,8,110,110,0,0
13356,2019-04-13,491,0,491,39,530,530,0,0
13357,2019-04-13,167,0,167,13,180,180,0,0
13358,2019-04-13,686,0,686,54,740,740,0,0
13359,2019-04-13,1213,0,1213,97,1310,1310,0,0
13360,2019-04-13,1399,0,1399,111,1510,1510,0,0
13361,2019-04-13,491,0,491,39,530,530,0,0
13362,2019-04-13,1815,0,1815,145,1960,0,1960,0
13363,2019-04-13,1510,0,1510,120,1630,1630,0,0
13364,2019-04-13,1389,0,1389,111,1500,1500,0,0
13365,2019-04-13,454,0,454,36,490,490,0,0
13366,2019-04-13,1093,0,1093,87,1180,1180,0,0
13367,2019-04-13,417,0,417,33,450,450,0,0
13368,2019-04-13,232,0,232,18,250,250,0,0
13369,2019-04-13,408,0,408,32,440,440,0,0
13370,2019-04-13,612,0,612,48,660,660,0,0
13371,2019-04-13,621,0,621,49,670,670,0,0
13372,2019-04-13,1019,0,1019,81,1100,1100,0,0
13373,2019-04-13,352,0,352,28,380,380,0,0
13374,2019-04-13,1112,0,1112,88,1200,1200,0,0
13375,2019-04-13,547,0,547,43,590,590,0,0
13376,2019-04-13,362,0,362,28,390,390,0,0
13377,2019-04-13,954,0,954,76,1030,1030,0,0
13378,2019-04-13,723,0,723,57,780,780,0,0
13379,2019-04-13,315,0,315,25,340,340,0,0
13380,2019-04-13,1084,0,1084,86,1170,0,1170,0
13381,2019-04-13,325,0,325,25,350,350,0,0
13382,2019-04-13,741,0,741,59,800,800,0,0
13383,2019-04-13,1149,0,1149,91,1240,1240,0,0
13384,2019-04-13,380,0,380,30,410,410,0,0
13385,2019-04-13,352,0,352,28,380,380,0,0
13386,2019-04-13,473,0,473,37,510,510,0,0
13387,2019-04-13,2065,0,2065,165,2230,2230,0,0
13388,2019-04-13,260,0,260,20,280,280,0,0
13389,2019-04-13,149,0,149,11,160,0,160,0
13390,2019-04-13,593,0,593,47,640,640,0,0
13391,2019-04-13,612,0,612,48,660,660,0,0
13392,2019-04-13,380,0,380,30,410,410,0,0
13393,2019-04-13,232,0,232,18,250,250,0,0
13394,2019-04-13,1213,0,1213,97,1310,1310,0,0
13395,2019-04-13,732,0,732,58,790,790,0,0
13396,2019-04-13,1445,0,1445,115,1560,1560,0,0
13397,2019-04-13,3480,0,3480,260,3740,3740,0,0
13398,2019-04-13,908,0,908,72,980,980,0,0
13399,2019-04-13,732,0,732,58,790,790,0,0
13400,2019-04-13,667,0,667,53,720,720,0,0
13401,2019-04-13,1306,0,1306,104,1410,1410,0,0
13402,2019-04-13,612,0,612,48,660,660,0,0
13403,2019-04-13,834,0,834,66,900,900,0,0
13404,2019-04-13,408,0,408,32,440,440,0,0
13405,2019-04-13,260,0,260,20,280,280,0,0
13406,2019-04-13,232,0,232,18,250,250,0,0
13407,2019-04-13,510,0,510,40,550,550,0,0
13408,2019-04-13,741,0,741,59,800,800,0,0
13409,2019-04-13,760,0,760,60,820,820,0,0
13410,2019-04-13,186,0,186,14,200,200,0,0
13411,2019-04-13,232,0,232,18,250,250,0,0
13412,2019-04-13,778,0,778,62,840,840,0,0
13413,2019-04-13,232,0,232,18,250,250,0,0
13414,2019-04-13,769,0,769,61,830,830,0,0
13415,2019-04-13,454,0,454,36,490,490,0,0
13416,2019-04-13,1528,0,1528,122,1650,1650,0,0
13417,2019-04-13,1028,0,1028,82,1110,1110,0,0
13418,2019-04-13,1038,0,1038,82,1120,1120,0,0
13419,2019-04-13,1130,0,1130,90,1220,1220,0,0
13420,2019-04-13,176,0,176,14,190,190,0,0
13421,2019-04-13,704,0,704,56,760,760,0,0
13422,2019-04-13,380,0,380,30,410,410,0,0
13423,2019-04-13,778,0,778,62,840,840,0,0
13424,2019-04-13,334,0,334,26,360,360,0,0
13425,2019-04-13,269,0,269,21,290,290,0,0
13426,2019-04-13,213,0,213,17,230,230,0,0
13427,2019-04-13,778,0,778,62,840,840,0,0
13428,2019-04-13,223,0,223,17,240,240,0,0
13429,2019-04-13,1093,0,1093,87,1180,1180,0,0
13430,2019-04-13,602,0,602,48,650,650,0,0
13431,2019-04-13,445,0,445,35,480,0,480,0
13432,2019-04-13,241,0,241,19,260,260,0,0
13433,2019-04-13,232,0,232,18,250,250,0,0
13434,2019-04-13,563,0,563,27,590,590,0,0
13435,2019-04-13,778,0,778,62,840,840,0,0
13436,2019-04-13,462,0,462,28,490,490,0,0
13437,2019-04-13,315,0,315,25,340,340,0,0
13438,2019-04-13,315,0,315,25,340,340,0,0
13439,2019-04-13,731,0,731,49,780,780,0,0
13440,2019-04-13,612,0,612,48,660,660,0,0
13441,2019-04-13,399,0,399,31,430,430,0,0
13442,2019-04-13,1001,0,1001,79,1080,1080,0,0
13443,2019-04-13,1213,0,1213,97,1310,1310,0,0
13444,2019-04-13,963,0,963,77,1040,1040,0,0
13445,2019-04-13,593,0,593,47,640,640,0,0
13446,2019-04-13,2473,0,2473,197,2670,2670,0,0
13447,2019-04-13,-2473,0,-2473,-197,-2670,-2670,0,0
13448,2019-04-13,-315,0,-315,-25,-340,-340,0,0
13449,2019-04-13,556,0,556,44,600,600,0,0
13450,2019-04-13,315,0,315,25,340,340,0,0
13451,2019-04-13,1815,0,1815,145,1960,1960,0,0
13452,2019-04-13,389,0,389,31,420,420,0,0
13453,2019-04-13,1158,0,1158,92,1250,1250,0,0
13454,2019-04-13,676,0,676,54,730,730,0,0
13455,2019-04-13,575,0,575,45,620,620,0,0
13456,2019-04-13,352,0,352,28,380,380,0,0
13457,2019-04-13,269,0,269,21,290,290,0,0
13458,2019-04-13,362,0,362,28,390,390,0,0
13459,2019-04-13,167,0,167,13,180,180,0,0
13460,2019-04-13,463,0,463,37,500,500,0,0
13461,2019-04-13,2473,0,2473,197,2670,2670,0,0
13462,2019-04-13,1501,0,1501,119,1620,1620,0,0
13463,2019-04-13,1815,0,1815,145,1960,1960,0,0
13464,2019-04-13,334,0,334,26,360,360,0,0
13465,2019-04-13,-787,0,-787,-63,-850,0,-850,0
13466,2019-04-13,1983,-15,1968,157,2125,2125,0,0
13467,2019-04-13,1639,0,1639,131,1770,1770,0,0
13468,2019-04-13,3538,0,3538,282,3820,3820,0,0
13469,2019-04-13,361,0,361,19,380,380,0,0
13470,2019-04-13,232,0,232,18,250,250,0,0
13471,2019-04-13,788,0,788,62,850,850,0,0
13472,2019-04-13,862,0,862,68,930,930,0,0
13473,2019-04-13,2130,0,2130,170,2300,2300,0,0
13474,2019-04-13,1788,0,1788,142,1930,1930,0,0
13475,2019-04-13,741,0,741,59,800,800,0,0
13476,2019-04-13,380,0,380,30,410,410,0,0
13477,2019-04-13,1575,0,1575,125,1700,1700,0,0
13478,2019-04-13,417,0,417,33,450,450,0,0
13479,2019-04-13,639,0,639,51,690,690,0,0
13480,2019-04-13,1019,0,1019,81,1100,1100,0,0
13481,2019-04-13,786,0,786,54,840,840,0,0
13482,2019-04-13,788,0,788,62,850,0,850,0
13483,2019-04-13,788,0,788,62,850,850,0,0
13484,2019-04-13,788,0,788,62,850,850,0,0
13485,2019-04-13,695,0,695,55,750,750,0,0
13486,2019-04-13,362,0,362,28,390,390,0,0
13487,2019-04-13,704,0,704,56,760,760,0,0
13488,2019-04-13,991,0,991,79,1070,1070,0,0
13489,2019-04-13,797,0,797,63,860,860,0,0
13490,2019-04-13,751,0,751,59,810,0,810,0
13491,2019-04-13,1306,0,1306,104,1410,1410,0,0
13492,2019-04-13,116,0,116,9,125,125,0,0
13493,2019-04-13,213,0,213,17,230,230,0,0
13494,2019-04-13,3149,0,3149,251,3400,0,3400,0
13495,2019-04-13,482,0,482,38,520,520,0,0
13496,2019-04-13,389,0,389,31,420,420,0,0
13497,2019-04-13,1575,0,1575,125,1700,1700,0,0
13498,2019-04-13,862,0,862,68,930,930,0,0
13499,2019-04-13,371,0,371,29,400,400,0,0
13500,2019-04-13,337,0,337,18,355,355,0,0
13501,2019-04-13,1232,0,1232,98,1330,1330,0,0
13502,2019-04-13,1695,0,1695,135,1830,0,1830,0
13503,2019-04-13,389,0,389,31,420,420,0,0
13504,2019-04-13,602,0,602,48,650,0,650,0
13505,2019-04-13,445,0,445,35,480,480,0,0
13506,2019-04-13,1102,0,1102,88,1190,1190,0,0
13507,2019-04-13,1334,0,1334,106,1440,1440,0,0
13508,2019-04-13,121,0,121,9,130,130,0,0
13509,2019-04-13,116,0,116,9,125,125,0,0
13510,2019-04-13,399,0,399,31,430,430,0,0
13511,2019-04-13,463,0,463,37,500,500,0,0
13512,2019-04-13,862,0,862,68,930,930,0,0
13513,2019-04-13,602,0,602,48,650,650,0,0
13514,2019-04-13,1260,0,1260,100,1360,1360,0,0
13515,2019-04-13,1575,0,1575,125,1700,1700,0,0
13516,2019-04-13,1575,0,1575,125,1700,1700,0,0
13517,2019-04-13,2130,0,2130,170,2300,2300,0,0
13518,2019-04-13,2130,0,2130,170,2300,2300,0,0
13519,2019-04-13,1852,0,1852,148,2000,2000,0,0
13520,2019-04-13,788,0,788,62,850,850,0,0
13521,2019-04-13,3149,0,3149,251,3400,0,3400,0
13522,2019-04-13,352,0,352,28,380,380,0,0
13523,2019-04-13,232,0,232,18,250,250,0,0
13524,2019-04-13,167,0,167,13,180,180,0,0
13525,2019-04-13,334,0,334,26,360,360,0,0
13526,2019-04-13,556,0,556,44,600,600,0,0
13527,2019-04-13,2362,0,2362,188,2550,0,2550,0
13528,2019-04-13,1195,0,1195,95,1290,1290,0,0
13529,2019-04-14,1815,0,1815,145,1960,1960,0,0
13530,2019-04-14,934,-100,834,66,900,900,0,0
13531,2019-04-14,788,0,788,62,850,850,0,0
13532,2019-04-14,426,0,426,34,460,460,0,0
13533,2019-04-14,612,0,612,48,660,660,0,0
13534,2019-04-14,575,0,575,45,620,620,0,0
13535,2019-04-14,908,0,908,72,980,980,0,0
13536,2019-04-14,1611,0,1611,119,1730,1730,0,0
13537,2019-04-14,1565,0,1565,125,1690,1690,0,0
13538,2019-04-14,417,0,417,33,450,450,0,0
13539,2019-04-14,908,0,908,72,980,980,0,0
13540,2019-04-14,2399,0,2399,191,2590,2590,0,0
13541,2019-04-14,325,0,325,25,350,350,0,0
13542,2019-04-14,1213,0,1213,97,1310,1310,0,0
13543,2019-04-14,1195,0,1195,95,1290,1290,0,0
13544,2019-04-14,260,0,260,20,280,280,0,0
13545,2019-04-14,1010,0,1010,80,1090,1090,0,0
13546,2019-04-14,722,0,722,48,770,770,0,0
13547,2019-04-14,538,0,538,42,580,580,0,0
13548,2019-04-14,908,0,908,72,980,980,0,0
13549,2019-04-14,639,0,639,51,690,690,0,0
13550,2019-04-14,806,0,806,64,870,870,0,0
13551,2019-04-14,334,0,334,26,360,360,0,0
13552,2019-04-14,-232,0,-232,-18,-250,-250,0,0
13553,2019-04-14,315,0,315,25,340,340,0,0
13554,2019-04-14,593,0,593,47,640,640,0,0
13555,2019-04-14,1491,0,1491,119,1610,1610,0,0
13556,2019-04-14,408,0,408,32,440,440,0,0
13557,2019-04-14,491,0,491,39,530,530,0,0
13558,2019-04-14,499,-106,393,31,424,424,0,0
13559,2019-04-14,894,0,894,71,965,965,0,0
13560,2019-04-14,871,0,871,69,940,940,0,0
13561,2019-04-14,519,0,519,41,560,560,0,0
13562,2019-04-14,-491,0,-491,-39,-530,-530,0,0
13563,2019-04-14,463,0,463,37,500,500,0,0
13564,2019-04-14,962,0,962,68,1030,1030,0,0
13565,2019-04-14,614,-65,549,36,585,585,0,0
13566,2019-04-14,1239,0,1239,81,1320,1320,0,0
13567,2019-04-14,445,0,445,35,480,480,0,0
13568,2019-04-14,1010,0,1010,80,1090,1090,0,0
13569,2019-04-14,445,0,445,35,480,480,0,0
13570,2019-04-14,1232,0,1232,98,1330,1330,0,0
13571,2019-04-14,575,0,575,45,620,620,0,0
13572,2019-04-14,1000,0,1000,80,1080,1080,0,0
13573,2019-04-14,573,0,573,37,610,610,0,0
13574,2019-04-14,800,-170,630,50,680,680,0,0
13575,2019-04-14,510,0,510,40,550,550,0,0
13576,2019-04-14,584,0,584,46,630,630,0,0
13577,2019-04-14,445,0,445,35,480,480,0,0
13578,2019-04-14,1038,0,1038,82,1120,1120,0,0
13579,2019-04-14,1028,0,1028,82,1110,0,1110,0
13580,2019-04-14,473,0,473,37,510,510,0,0
13581,2019-04-14,297,0,297,23,320,320,0,0
13582,2019-04-14,389,0,389,31,420,420,0,0
13583,2019-04-14,908,0,908,72,980,980,0,0
13584,2019-04-14,528,0,528,42,570,570,0,0
13585,2019-04-14,3630,0,3630,290,3920,3920,0,0
13586,2019-04-14,676,0,676,54,730,730,0,0
13587,2019-04-14,998,-212,786,62,848,848,0,0
13588,2019-04-14,982,0,982,78,1060,1060,0,0
13589,2019-04-14,1223,0,1223,97,1320,1320,0,0
13590,2019-04-14,371,0,371,29,400,400,0,0
13591,2019-04-14,417,0,417,33,450,450,0,0
13592,2019-04-14,612,0,612,48,660,660,0,0
13593,2019-04-14,232,0,232,18,250,250,0,0
13594,2019-04-14,908,0,908,72,980,980,0,0
13595,2019-04-14,582,0,582,28,610,610,0,0
13596,2019-04-14,3444,0,3444,266,3710,3710,0,0
13597,2019-04-14,473,0,473,37,510,510,0,0
13598,2019-04-14,658,0,658,52,710,710,0,0
13599,2019-04-14,963,0,963,77,1040,1040,0,0
13600,2019-04-14,3240,0,3240,250,3490,3490,0,0
13601,2019-04-14,1538,0,1538,122,1660,1660,0,0
13602,2019-04-14,1028,0,1028,82,1110,1110,0,0
13603,2019-04-14,1815,0,1815,145,1960,1960,0,0
13604,2019-04-14,288,0,288,22,310,310,0,0
13605,2019-04-14,232,0,232,18,250,250,0,0
13606,2019-04-14,879,0,879,61,940,940,0,0
13607,2019-04-14,1362,0,1362,108,1470,1470,0,0
13608,2019-04-14,1001,0,1001,79,1080,1080,0,0
13609,2019-04-14,204,0,204,16,220,220,0,0
13610,2019-04-14,176,0,176,14,190,190,0,0
13611,2019-04-14,1325,0,1325,105,1430,1430,0,0
13612,2019-04-14,788,0,788,62,850,850,0,0
13613,2019-04-14,519,0,519,41,560,560,0,0
13614,2019-04-14,908,0,908,72,980,980,0,0
13615,2019-04-14,814,0,814,56,870,870,0,0
13616,2019-04-14,1417,0,1417,113,1530,1530,0,0
13617,2019-04-14,297,0,297,23,320,320,0,0
13618,2019-04-14,834,0,834,66,900,900,0,0
13619,2019-04-14,489,0,489,21,510,510,0,0
13620,2019-04-14,426,0,426,34,460,460,0,0
13621,2019-04-14,2204,0,2204,176,2380,2380,0,0
13622,2019-04-14,630,0,630,50,680,680,0,0
13623,2019-04-14,1102,0,1102,88,1190,1190,0,0
13624,2019-04-14,2223,0,2223,177,2400,0,2400,0
13625,2019-04-14,297,0,297,23,320,320,0,0
13626,2019-04-14,704,0,704,56,760,760,0,0
13627,2019-04-14,1051,0,1051,84,1135,1135,0,0
13628,2019-04-14,278,0,278,22,300,300,0,0
13629,2019-04-14,1389,0,1389,111,1500,1500,0,0
13630,2019-04-14,371,0,371,29,400,0,400,0
13631,2019-04-14,1268,0,1268,92,1360,1360,0,0
13632,2019-04-14,260,0,260,20,280,280,0,0
13633,2019-04-14,1111,0,1111,79,1190,1190,0,0
13634,2019-04-14,269,0,269,21,290,290,0,0
13635,2019-04-14,1933,0,1933,137,2070,2070,0,0
13636,2019-04-14,536,0,536,34,570,0,570,0
13637,2019-04-14,269,0,269,21,290,290,0,0
13638,2019-04-14,463,0,463,37,500,500,0,0
13639,2019-04-14,1297,0,1297,103,1400,1400,0,0
13640,2019-04-14,1426,0,1426,114,1540,1540,0,0
13641,2019-04-14,1018,0,1018,72,1090,1090,0,0
13642,2019-04-14,982,0,982,78,1060,1060,0,0
13643,2019-04-14,260,0,260,20,280,280,0,0
13644,2019-04-14,467,0,467,37,504,504,0,0
13645,2019-04-14,491,0,491,39,530,530,0,0
13646,2019-04-14,510,0,510,40,550,550,0,0
13647,2019-04-14,686,0,686,54,740,740,0,0
13648,2019-04-14,371,0,371,29,400,400,0,0
13649,2019-04-14,1325,0,1325,105,1430,1430,0,0
13650,2019-04-14,760,0,760,60,820,820,0,0
13651,2019-04-14,741,0,741,59,800,800,0,0
13652,2019-04-14,1269,0,1269,101,1370,1370,0,0
13653,2019-04-14,573,0,573,37,610,610,0,0
13654,2019-04-14,723,0,723,57,780,780,0,0
13655,2019-04-14,362,0,362,28,390,390,0,0
13656,2019-04-14,538,0,538,42,580,580,0,0
13657,2019-04-14,315,0,315,25,340,340,0,0
13658,2019-04-14,676,0,676,54,730,730,0,0
13659,2019-04-14,454,0,454,36,490,490,0,0
13660,2019-04-14,788,0,788,62,850,850,0,0
13661,2019-04-14,1001,0,1001,79,1080,1080,0,0
13662,2019-04-14,1195,0,1195,95,1290,1290,0,0
13663,2019-04-14,426,0,426,34,460,460,0,0
13664,2019-04-14,130,0,130,10,140,140,0,0
13665,2019-04-14,232,0,232,18,250,250,0,0
13666,2019-04-14,1556,0,1556,124,1680,1680,0,0
13667,2019-04-14,713,0,713,57,770,770,0,0
13668,2019-04-14,741,0,741,59,800,800,0,0
13669,2019-04-14,362,0,362,28,390,390,0,0
13670,2019-04-14,371,0,371,29,400,400,0,0
13671,2019-04-14,797,0,797,63,860,860,0,0
13672,2019-04-14,723,0,723,57,780,780,0,0
13673,2019-04-14,491,0,491,39,530,530,0,0
13674,2019-04-14,723,0,723,57,780,780,0,0
13675,2019-04-14,741,0,741,59,800,800,0,0
13676,2019-04-14,232,0,232,18,250,250,0,0
13677,2019-04-14,584,0,584,46,630,630,0,0
13678,2019-04-14,982,0,982,78,1060,1060,0,0
13679,2019-04-14,852,0,852,68,920,920,0,0
13680,2019-04-14,491,0,491,39,530,530,0,0
13681,2019-04-14,195,0,195,15,210,210,0,0
13682,2019-04-14,343,0,343,27,370,370,0,0
13683,2019-04-14,509,0,509,31,540,540,0,0
13684,2019-04-14,686,0,686,54,740,740,0,0
13685,2019-04-14,1093,0,1093,87,1180,1180,0,0
13686,2019-04-14,1408,0,1408,112,1520,1520,0,0
13687,2019-04-14,1288,0,1288,102,1390,1390,0,0
13688,2019-04-14,232,0,232,18,250,250,0,0
13689,2019-04-14,1575,0,1575,125,1700,1700,0,0
13690,2019-04-14,167,0,167,13,180,180,0,0
13691,2019-04-14,788,0,788,62,850,850,0,0
13692,2019-04-14,751,0,751,59,810,810,0,0
13693,2019-04-14,251,0,251,19,270,270,0,0
13694,2019-04-14,362,0,362,28,390,390,0,0
13695,2019-04-14,1575,0,1575,125,1700,1700,0,0
13696,2019-04-14,1343,0,1343,107,1450,1450,0,0
13697,2019-04-14,1519,0,1519,121,1640,1640,0,0
13698,2019-04-14,1167,0,1167,93,1260,0,1260,0
13699,2019-04-14,602,0,602,48,650,650,0,0
13700,2019-04-14,1352,0,1352,108,1460,1460,0,0
13701,2019-04-14,491,0,491,39,530,530,0,0
13702,2019-04-14,195,0,195,15,210,210,0,0
13703,2019-04-14,167,0,167,13,180,180,0,0
13704,2019-04-14,1167,0,1167,93,1260,0,1260,0
13705,2019-04-14,454,0,454,36,490,490,0,0
13706,2019-04-14,269,0,269,21,290,290,0,0
13707,2019-04-14,186,0,186,14,200,200,0,0
13708,2019-04-14,676,0,676,54,730,730,0,0
13709,2019-04-14,889,0,889,71,960,960,0,0
13710,2019-04-14,1112,0,1112,88,1200,0,1200,0
13711,2019-04-14,408,0,408,32,440,440,0,0
13712,2019-04-14,1575,0,1575,125,1700,1700,0,0
13713,2019-04-14,186,0,186,14,200,200,0,0
13714,2019-04-14,788,0,788,62,850,850,0,0
13715,2019-04-14,788,0,788,62,850,850,0,0
13716,2019-04-14,788,0,788,62,850,850,0,0
13717,2019-04-14,1453,0,1453,107,1560,1560,0,0
13718,2019-04-14,788,0,788,62,850,850,0,0
13719,2019-04-14,1473,0,1473,117,1590,1590,0,0
13720,2019-04-14,139,0,139,11,150,150,0,0
13721,2019-04-14,621,0,621,49,670,670,0,0
13722,2019-04-14,417,0,417,33,450,450,0,0
13723,2019-04-14,2065,0,2065,165,2230,2230,0,0
13724,2019-04-14,445,0,445,35,480,480,0,0
13725,2019-04-14,445,0,445,35,480,480,0,0
13726,2019-04-14,788,0,788,62,850,850,0,0
13727,2019-04-14,2399,0,2399,191,2590,2590,0,0
13728,2019-04-14,408,0,408,32,440,440,0,0
13729,2019-04-15,528,0,528,42,570,570,0,0
13730,2019-04-15,528,0,528,42,570,570,0,0
13731,2019-04-15,575,0,575,45,620,620,0,0
13732,2019-04-15,538,0,538,42,580,580,0,0
13733,2019-04-15,561,0,561,44,605,605,0,0
13734,2019-04-15,862,0,862,68,930,930,0,0
13735,2019-04-15,1815,0,1815,145,1960,1960,0,0
13736,2019-04-15,694,0,694,46,740,740,0,0
13737,2019-04-15,565,0,565,45,610,610,0,0
13738,2019-04-15,260,0,260,20,280,280,0,0
13739,2019-04-15,676,0,676,54,730,730,0,0
13740,2019-04-15,1815,0,1815,145,1960,1960,0,0
13741,2019-04-15,1084,0,1084,86,1170,1170,0,0
13742,2019-04-15,510,0,510,40,550,550,0,0
13743,2019-04-15,1491,0,1491,119,1610,1610,0,0
13744,2019-04-15,315,0,315,25,340,340,0,0
13745,2019-04-15,916,0,916,64,980,980,0,0
13746,2019-04-15,899,0,899,71,970,0,970,0
13747,2019-04-15,380,0,380,30,410,410,0,0
13748,2019-04-15,2100,0,2100,150,2250,2250,0,0
13749,2019-04-15,908,0,908,72,980,980,0,0
13750,2019-04-15,991,0,991,79,1070,1070,0,0
13751,2019-04-15,426,0,426,34,460,460,0,0
13752,2019-04-15,908,0,908,72,980,980,0,0
13753,2019-04-15,213,0,213,17,230,230,0,0
13754,2019-04-15,426,0,426,34,460,460,0,0
13755,2019-04-15,519,0,519,41,560,560,0,0
13756,2019-04-15,852,0,852,68,920,920,0,0
13757,2019-04-15,982,0,982,78,1060,0,1060,0
13758,2019-04-15,-519,0,-519,-41,-560,-560,0,0
13759,2019-04-15,249,0,249,11,260,260,0,0
13760,2019-04-15,343,0,343,27,370,370,0,0
13761,2019-04-15,1815,0,1815,145,1960,1960,0,0
13762,2019-04-15,436,0,436,34,470,470,0,0
13763,2019-04-15,417,0,417,33,450,450,0,0
13764,2019-04-15,1815,0,1815,145,1960,1960,0,0
13765,2019-04-15,1001,0,1001,79,1080,1080,0,0
13766,2019-04-15,2584,0,2584,206,2790,2790,0,0
13767,2019-04-15,315,0,315,25,340,340,0,0
13768,2019-04-15,916,0,916,64,980,980,0,0
13769,2019-04-15,908,0,908,72,980,980,0,0
13770,2019-04-15,1251,0,1251,99,1350,1350,0,0
13771,2019-04-15,945,0,945,75,1020,1020,0,0
13772,2019-04-15,473,0,473,37,510,510,0,0
13773,2019-04-15,788,0,788,62,850,850,0,0
13774,2019-04-15,1204,0,1204,96,1300,1300,0,0
13775,2019-04-15,593,0,593,47,640,640,0,0
13776,2019-04-15,334,0,334,26,360,360,0,0
13777,2019-04-15,1926,0,1926,154,2080,0,2080,0
13778,2019-04-15,1963,0,1963,157,2120,2120,0,0
13779,2019-04-15,638,0,638,42,680,680,0,0
13780,2019-04-15,371,0,371,29,400,400,0,0
13781,2019-04-15,2788,0,2788,222,3010,3010,0,0
13782,2019-04-15,389,0,389,31,420,420,0,0
13783,2019-04-15,1676,0,1676,134,1810,0,1810,0
13784,2019-04-15,584,0,584,46,630,630,0,0
13785,2019-04-15,1443,0,1443,97,1540,1540,0,0
13786,2019-04-15,121,0,121,9,130,130,0,0
13787,2019-04-15,667,0,667,53,720,720,0,0
13788,2019-04-15,916,0,916,64,980,980,0,0
13789,2019-04-15,260,0,260,20,280,280,0,0
13790,2019-04-15,241,0,241,19,260,260,0,0
13791,2019-04-15,343,0,343,27,370,370,0,0
13792,2019-04-15,806,0,806,64,870,870,0,0
13793,2019-04-15,325,0,325,25,350,350,0,0
13794,2019-04-15,3297,0,3297,263,3560,3560,0,0
13795,2019-04-15,547,0,547,43,590,590,0,0
13796,2019-04-15,2723,0,2723,217,2940,2940,0,0
13797,2019-04-15,510,0,510,40,550,550,0,0
13798,2019-04-15,945,0,945,75,1020,1020,0,0
13799,2019-04-15,713,0,713,57,770,770,0,0
13800,2019-04-15,880,0,880,70,950,950,0,0
13801,2019-04-15,473,0,473,37,510,510,0,0
13802,2019-04-15,297,0,297,23,320,320,0,0
13803,2019-04-15,788,0,788,62,850,850,0,0
13804,2019-04-15,695,0,695,55,750,750,0,0
13805,2019-04-15,880,0,880,70,950,950,0,0
13806,2019-04-15,167,0,167,13,180,180,0,0
13807,2019-04-15,1112,0,1112,88,1200,1200,0,0
13808,2019-04-15,1047,0,1047,83,1130,1130,0,0
13809,2019-04-15,825,0,825,65,890,890,0,0
13810,2019-04-15,1010,0,1010,80,1090,1090,0,0
13811,2019-04-15,463,0,463,37,500,500,0,0
13812,2019-04-15,1389,0,1389,111,1500,1500,0,0
13813,2019-04-15,797,0,797,63,860,860,0,0
13814,2019-04-15,908,0,908,72,980,0,980,0
13815,2019-04-15,908,0,908,72,980,980,0,0
13816,2019-04-15,954,0,954,76,1030,1030,0,0
13817,2019-04-15,1047,0,1047,83,1130,1130,0,0
13818,2019-04-15,1223,0,1223,97,1320,1320,0,0
13819,2019-04-15,806,0,806,64,870,870,0,0
13820,2019-04-15,723,0,723,57,780,780,0,0
13821,2019-04-15,806,0,806,64,870,870,0,0
13822,2019-04-15,630,0,630,50,680,680,0,0
13823,2019-04-15,496,0,496,39,535,535,0,0
13824,2019-04-15,538,0,538,42,580,580,0,0
13825,2019-04-15,2121,0,2121,169,2290,2290,0,0
13826,2019-04-15,453,0,453,27,480,480,0,0
13827,2019-04-15,963,0,963,77,1040,1040,0,0
13828,2019-04-15,278,0,278,22,300,300,0,0
13829,2019-04-15,334,0,334,26,360,360,0,0
13830,2019-04-15,249,0,249,11,260,260,0,0
13831,2019-04-15,1065,0,1065,85,1150,1150,0,0
13832,2019-04-15,695,0,695,55,750,750,0,0
13833,2019-04-15,213,0,213,17,230,230,0,0
13834,2019-04-15,167,0,167,13,180,180,0,0
13835,2019-04-15,491,0,491,39,530,530,0,0
13836,2019-04-15,612,0,612,48,660,660,0,0
13837,2019-04-15,1038,0,1038,82,1120,1120,0,0
13838,2019-04-15,1815,0,1815,145,1960,1960,0,0
13839,2019-04-15,315,0,315,25,340,340,0,0
13840,2019-04-15,908,0,908,72,980,980,0,0
13841,2019-04-15,593,0,593,47,640,640,0,0
13842,2019-04-15,575,0,575,45,620,620,0,0
13843,2019-04-15,1399,0,1399,111,1510,1510,0,0
13844,2019-04-15,612,0,612,48,660,660,0,0
13845,2019-04-15,862,0,862,68,930,930,0,0
13846,2019-04-15,139,0,139,11,150,150,0,0
13847,2019-04-15,426,0,426,34,460,460,0,0
13848,2019-04-15,269,0,269,21,290,290,0,0
13849,2019-04-15,871,0,871,69,940,940,0,0
13850,2019-04-15,691,-74,617,49,666,666,0,0
13851,2019-04-15,825,0,825,65,890,890,0,0
13852,2019-04-15,612,0,612,48,660,660,0,0
13853,2019-04-15,621,0,621,49,670,670,0,0
13854,2019-04-15,3519,0,3519,281,3800,0,3800,0
13855,2019-04-15,102,0,102,8,110,110,0,0
13856,2019-04-15,259,0,259,11,270,270,0,0
13857,2019-04-15,269,0,269,21,290,290,0,0
13858,2019-04-15,1815,0,1815,145,1960,0,1960,0
13859,2019-04-15,630,0,630,50,680,680,0,0
13860,2019-04-15,788,0,788,62,850,850,0,0
13861,2019-04-15,1325,0,1325,105,1430,1430,0,0
13862,2019-04-15,954,0,954,76,1030,1030,0,0
13863,2019-04-15,1297,0,1297,103,1400,1400,0,0
13864,2019-04-15,695,0,695,55,750,750,0,0
13865,2019-04-15,102,0,102,8,110,110,0,0
13866,2019-04-15,269,0,269,21,290,290,0,0
13867,2019-04-15,769,0,769,61,830,830,0,0
13868,2019-04-15,269,0,269,21,290,290,0,0
13869,2019-04-15,112,0,112,8,120,120,0,0
13870,2019-04-15,788,0,788,62,850,850,0,0
13871,2019-04-15,926,0,926,74,1000,1000,0,0
13872,2019-04-15,602,0,602,48,650,650,0,0
13873,2019-04-15,3630,0,3630,290,3920,3920,0,0
13874,2019-04-15,815,0,815,65,880,880,0,0
13875,2019-04-15,908,0,908,72,980,980,0,0
13876,2019-04-15,908,0,908,72,980,980,0,0
13877,2019-04-15,834,0,834,66,900,900,0,0
13878,2019-04-15,1815,0,1815,145,1960,1960,0,0
13879,2019-04-15,2723,0,2723,217,2940,2940,0,0
13880,2019-04-15,797,0,797,63,860,860,0,0
13881,2019-04-15,2028,0,2028,162,2190,2190,0,0
13882,2019-04-15,704,0,704,56,760,760,0,0
13883,2019-04-15,288,0,288,22,310,310,0,0
13884,2019-04-15,788,0,788,62,850,850,0,0
13885,2019-04-15,528,0,528,42,570,570,0,0
13886,2019-04-15,491,0,491,39,530,530,0,0
13887,2019-04-15,788,0,788,62,850,850,0,0
13888,2019-04-15,788,0,788,62,850,850,0,0
13889,2019-04-15,1575,0,1575,125,1700,1700,0,0
13890,2019-04-15,788,0,788,62,850,850,0,0
13891,2019-04-15,760,0,760,60,820,820,0,0
13892,2019-04-15,1788,0,1788,142,1930,1930,0,0
13893,2019-04-15,500,0,500,40,540,540,0,0
13894,2019-04-15,121,0,121,9,130,130,0,0
13895,2019-04-15,788,0,788,62,850,850,0,0
13896,2019-04-15,463,0,463,37,500,500,0,0
13897,2019-04-15,1538,0,1538,122,1660,1660,0,0
13898,2019-04-15,936,0,936,74,1010,1010,0,0
13899,2019-04-15,741,0,741,59,800,800,0,0
13900,2019-04-15,278,0,278,22,300,300,0,0
13901,2019-04-15,380,0,380,30,410,410,0,0
13902,2019-04-15,352,0,352,28,380,380,0,0
13903,2019-04-15,908,0,908,72,980,980,0,0
13904,2019-04-15,982,0,982,78,1060,0,1060,0
13905,2019-04-16,329,0,329,26,355,355,0,0
13906,2019-04-16,575,0,575,45,620,620,0,0
13907,2019-04-16,2195,0,2195,175,2370,0,2370,0
13908,2019-04-16,342,0,342,18,360,360,0,0
13909,2019-04-16,223,0,223,17,240,240,0,0
13910,2019-04-16,797,0,797,63,860,860,0,0
13911,2019-04-16,510,0,510,40,550,550,0,0
13912,2019-04-16,889,0,889,71,960,960,0,0
13913,2019-04-16,1176,0,1176,94,1270,1270,0,0
13914,2019-04-16,269,0,269,21,290,290,0,0
13915,2019-04-16,269,0,269,21,290,290,0,0
13916,2019-04-16,1130,0,1130,90,1220,1220,0,0
13917,2019-04-16,269,0,269,21,290,290,0,0
13918,2019-04-16,926,0,926,74,1000,1000,0,0
13919,2019-04-16,1213,0,1213,97,1310,1310,0,0
13920,2019-04-16,343,0,343,27,370,370,0,0
13921,2019-04-16,602,0,602,48,650,650,0,0
13922,2019-04-16,1121,0,1121,89,1210,1210,0,0
13923,2019-04-16,399,0,399,31,430,430,0,0
13924,2019-04-16,181,0,181,14,195,195,0,0
13925,2019-04-16,501,0,501,39,540,540,0,0
13926,2019-04-16,269,0,269,21,290,290,0,0
13927,2019-04-16,47,0,47,3,50,50,0,0
13928,2019-04-16,1315,0,1315,105,1420,1420,0,0
13929,2019-04-16,223,0,223,17,240,240,0,0
13930,2019-04-16,260,0,260,20,280,280,0,0
13931,2019-04-16,778,0,778,62,840,840,0,0
13932,2019-04-16,612,0,612,48,660,660,0,0
13933,2019-04-16,658,0,658,52,710,710,0,0
13934,2019-04-16,1380,0,1380,110,1490,1490,0,0
13935,2019-04-16,1815,0,1815,145,1960,1960,0,0
13936,2019-04-16,232,0,232,18,250,250,0,0
13937,2019-04-16,547,0,547,43,590,590,0,0
13938,2019-04-16,1130,0,1130,90,1220,1220,0,0
13939,2019-04-16,510,0,510,40,550,550,0,0
13940,2019-04-16,609,0,609,31,640,640,0,0
13941,2019-04-16,602,0,602,48,650,0,650,0
13942,2019-04-16,371,0,371,29,400,400,0,0
13943,2019-04-16,2056,0,2056,164,2220,2220,0,0
13944,2019-04-16,1158,0,1158,92,1250,1250,0,0
13945,2019-04-16,269,0,269,21,290,290,0,0
13946,2019-04-16,311,0,311,24,335,335,0,0
13947,2019-04-16,389,0,389,31,420,420,0,0
13948,2019-04-16,751,0,751,59,810,810,0,0
13949,2019-04-16,1713,0,1713,137,1850,1850,0,0
13950,2019-04-16,176,0,176,14,190,190,0,0
13951,2019-04-16,584,0,584,46,630,630,0,0
13952,2019-04-17,739,0,739,41,780,780,0,0
13953,2019-04-17,982,0,982,78,1060,1060,0,0
13954,2019-04-17,343,0,343,27,370,370,0,0
13955,2019-04-17,815,0,815,65,880,880,0,0
13956,2019-04-17,797,0,797,63,860,860,0,0
13957,2019-04-17,916,0,916,64,980,980,0,0
13958,2019-04-17,288,0,288,22,310,310,0,0
13959,2019-04-17,1926,0,1926,154,2080,2080,0,0
13960,2019-04-17,843,0,843,67,910,910,0,0
13961,2019-04-17,954,0,954,76,1030,1030,0,0
13962,2019-04-17,352,0,352,28,380,380,0,0
13963,2019-04-17,843,0,843,67,910,910,0,0
13964,2019-04-17,463,0,463,37,500,500,0,0
13965,2019-04-17,778,0,778,62,840,840,0,0
13966,2019-04-17,269,0,269,21,290,290,0,0
13967,2019-04-17,704,0,704,56,760,760,0,0
13968,2019-04-17,908,0,908,72,980,980,0,0
13969,2019-04-17,908,0,908,72,980,980,0,0
13970,2019-04-17,908,0,908,72,980,980,0,0
13971,2019-04-17,454,0,454,36,490,490,0,0
13972,2019-04-17,490,0,490,30,520,520,0,0
13973,2019-04-17,1130,0,1130,90,1220,1220,0,0
13974,2019-04-17,769,0,769,61,830,830,0,0
13975,2019-04-17,908,0,908,72,980,980,0,0
13976,2019-04-17,408,0,408,32,440,440,0,0
13977,2019-04-17,769,0,769,61,830,830,0,0
13978,2019-04-17,602,0,602,48,650,650,0,0
13979,2019-04-17,1064,0,1064,76,1140,1140,0,0
13980,2019-04-17,519,0,519,41,560,560,0,0
13981,2019-04-17,649,0,649,51,700,700,0,0
13982,2019-04-17,1593,0,1593,127,1720,1720,0,0
13983,2019-04-17,825,0,825,65,890,890,0,0
13984,2019-04-17,4538,0,4538,362,4900,4900,0,0
13985,2019-04-17,686,0,686,54,740,740,0,0
13986,2019-04-17,445,0,445,35,480,480,0,0
13987,2019-04-17,232,0,232,18,250,250,0,0
13988,2019-04-17,908,0,908,72,980,980,0,0
13989,2019-04-17,362,0,362,28,390,390,0,0
13990,2019-04-17,1815,0,1815,145,1960,0,1960,0
13991,2019-04-17,778,0,778,62,840,840,0,0
13992,2019-04-17,751,0,751,59,810,810,0,0
13993,2019-04-17,167,0,167,13,180,180,0,0
13994,2019-04-17,852,0,852,68,920,920,0,0
13995,2019-04-17,1130,0,1130,90,1220,1220,0,0
13996,2019-04-17,908,0,908,72,980,980,0,0
13997,2019-04-17,908,0,908,72,980,980,0,0
13998,2019-04-17,1815,0,1815,145,1960,1960,0,0
13999,2019-04-17,1278,0,1278,102,1380,1380,0,0
14000,2019-04-17,1215,-15,1200,95,1295,1295,0,0
14001,2019-04-17,371,0,371,29,400,400,0,0
14002,2019-04-17,269,0,269,21,290,290,0,0
14003,2019-04-17,371,0,371,29,400,400,0,0
14004,2019-04-17,102,0,102,8,110,110,0,0
14005,2019-04-17,1815,0,1815,145,1960,1960,0,0
14006,2019-04-17,871,0,871,69,940,940,0,0
14007,2019-04-17,621,0,621,49,670,670,0,0
14008,2019-04-17,482,0,482,38,520,520,0,0
14009,2019-04-17,908,0,908,72,980,980,0,0
14010,2019-04-17,639,0,639,51,690,690,0,0
14011,2019-04-17,575,0,575,45,620,620,0,0
14012,2019-04-17,1362,0,1362,108,1470,1470,0,0
14013,2019-04-17,1232,0,1232,98,1330,1330,0,0
14014,2019-04-17,649,0,649,51,700,700,0,0
14015,2019-04-17,389,0,389,31,420,420,0,0
14016,2019-04-17,652,-69,583,38,621,621,0,0
14017,2019-04-17,777,0,777,53,830,830,0,0
14018,2019-04-17,362,0,362,28,390,390,0,0
14019,2019-04-17,306,0,306,24,330,330,0,0
14020,2019-04-17,306,0,306,24,330,330,0,0
14021,2019-04-17,1111,0,1111,79,1190,1190,0,0
14022,2019-04-17,321,0,321,25,346,346,0,0
14023,2019-04-17,232,0,232,18,250,250,0,0
14024,2019-04-17,1120,0,1120,80,1200,1200,0,0
14025,2019-04-17,788,0,788,62,850,850,0,0
14026,2019-04-17,1426,0,1426,114,1540,1540,0,0
14027,2019-04-17,538,0,538,42,580,580,0,0
14028,2019-04-17,982,0,982,78,1060,0,1060,0
14029,2019-04-17,269,0,269,21,290,290,0,0
14030,2019-04-17,1084,0,1084,86,1170,0,1170,0
14031,2019-04-17,676,0,676,54,730,730,0,0
14032,2019-04-17,538,0,538,42,580,580,0,0
14033,2019-04-17,1575,0,1575,125,1700,1700,0,0
14034,2019-04-17,1575,0,1575,125,1700,1700,0,0
14035,2019-04-17,704,0,704,56,760,760,0,0
14036,2019-04-17,334,0,334,26,360,360,0,0
14037,2019-04-17,788,0,788,62,850,850,0,0
14038,2019-04-17,288,0,288,22,310,310,0,0
14039,2019-04-17,518,0,518,32,550,550,0,0
14040,2019-04-17,723,0,723,57,780,780,0,0
14041,2019-04-17,1575,0,1575,125,1700,1700,0,0
14042,2019-04-17,676,0,676,54,730,730,0,0
14043,2019-04-17,1879,0,1879,141,2020,2020,0,0
14044,2019-04-17,676,0,676,54,730,730,0,0
14045,2019-04-17,723,0,723,57,780,780,0,0
14046,2019-04-17,2380,0,2380,190,2570,2570,0,0
14047,2019-04-17,93,0,93,7,100,100,0,0
14048,2019-04-17,371,0,371,29,400,400,0,0
14049,2019-04-17,658,0,658,52,710,710,0,0
14050,2019-04-17,908,0,908,72,980,980,0,0
14051,2019-04-17,575,0,575,45,620,620,0,0
14052,2019-04-17,908,0,908,72,980,980,0,0
14053,2019-04-17,139,0,139,11,150,150,0,0
14054,2019-04-17,823,0,823,57,880,880,0,0
14055,2019-04-17,1815,0,1815,145,1960,1960,0,0
14056,2019-04-17,908,0,908,72,980,980,0,0
14057,2019-04-17,908,0,908,72,980,980,0,0
14058,2019-04-17,510,0,510,40,550,550,0,0
14059,2019-04-17,1815,0,1815,145,1960,1960,0,0
14060,2019-04-17,204,0,204,16,220,220,0,0
14061,2019-04-17,908,0,908,72,980,980,0,0
14062,2019-04-17,908,0,908,72,980,980,0,0
14063,2019-04-17,1315,0,1315,105,1420,1420,0,0
14064,2019-04-17,593,0,593,47,640,640,0,0
14065,2019-04-17,991,0,991,79,1070,1070,0,0
14066,2019-04-17,741,0,741,59,800,800,0,0
14067,2019-04-17,130,0,130,10,140,140,0,0
14068,2019-04-17,899,0,899,71,970,970,0,0
14069,2019-04-17,232,0,232,18,250,250,0,0
14070,2019-04-17,325,0,325,25,350,350,0,0
14071,2019-04-17,417,0,417,33,450,0,450,0
14072,2019-04-17,815,0,815,65,880,880,0,0
14073,2019-04-17,676,0,676,54,730,730,0,0
14074,2019-04-17,862,0,862,68,930,930,0,0
14075,2019-04-17,510,0,510,40,550,550,0,0
14076,2019-04-17,852,0,852,68,920,920,0,0
14077,2019-04-17,371,0,371,29,400,400,0,0
14078,2019-04-17,380,0,380,30,410,410,0,0
14079,2019-04-17,704,0,704,56,760,760,0,0
14080,2019-04-18,908,0,908,72,980,980,0,0
14081,2019-04-18,473,0,473,37,510,510,0,0
14082,2019-04-18,1121,0,1121,89,1210,1210,0,0
14083,2019-04-18,352,0,352,28,380,380,0,0
14084,2019-04-18,769,0,769,61,830,830,0,0
14085,2019-04-18,908,0,908,72,980,980,0,0
14086,2019-04-18,713,0,713,57,770,770,0,0
14087,2019-04-18,908,0,908,72,980,980,0,0
14088,2019-04-18,908,0,908,72,980,980,0,0
14089,2019-04-18,417,0,417,33,450,450,0,0
14090,2019-04-18,834,0,834,66,900,900,0,0
14091,2019-04-18,908,0,908,72,980,980,0,0
14092,2019-04-18,1815,0,1815,145,1960,1960,0,0
14093,2019-04-18,1501,0,1501,119,1620,1620,0,0
14094,2019-04-18,852,0,852,68,920,920,0,0
14095,2019-04-18,723,0,723,57,780,780,0,0
14096,2019-04-18,2010,0,2010,160,2170,2170,0,0
14097,2019-04-18,963,0,963,77,1040,1040,0,0
14098,2019-04-18,463,0,463,37,500,500,0,0
14099,2019-04-18,917,0,917,73,990,990,0,0
14100,2019-04-18,1260,0,1260,100,1360,1360,0,0
14101,2019-04-18,908,0,908,72,980,980,0,0
14102,2019-04-18,436,0,436,34,470,470,0,0
14103,2019-04-18,472,0,472,28,500,500,0,0
14104,2019-04-18,473,0,473,37,510,510,0,0
14105,2019-04-18,1297,0,1297,103,1400,1400,0,0
14106,2019-04-18,2573,0,2573,197,2770,2770,0,0
14107,2019-04-18,806,0,806,64,870,870,0,0
14108,2019-04-18,788,0,788,62,850,850,0,0
14109,2019-04-18,334,0,334,26,360,360,0,0
14110,2019-04-18,445,0,445,35,480,480,0,0
14111,2019-04-18,658,0,658,52,710,710,0,0
14112,2019-04-18,639,0,639,51,690,690,0,0
14113,2019-04-18,380,0,380,30,410,410,0,0
14114,2019-04-18,334,0,334,26,360,360,0,0
14115,2019-04-18,139,0,139,11,150,150,0,0
14116,2019-04-18,139,0,139,11,150,150,0,0
14117,2019-04-18,241,0,241,19,260,260,0,0
14118,2019-04-18,167,0,167,13,180,180,0,0
14119,2019-04-18,288,0,288,22,310,310,0,0
14120,2019-04-18,352,0,352,28,380,380,0,0
14121,2019-04-18,880,0,880,70,950,950,0,0
14122,2019-04-18,1204,0,1204,96,1300,1300,0,0
14123,2019-04-18,500,0,500,40,540,540,0,0
14124,2019-04-18,936,0,936,74,1010,1010,0,0
14125,2019-04-18,399,0,399,31,430,430,0,0
14126,2019-04-18,426,0,426,34,460,460,0,0
14127,2019-04-18,151,-32,119,9,128,128,0,0
14128,2019-04-18,1686,0,1686,134,1820,1820,0,0
14129,2019-04-18,436,0,436,34,470,470,0,0
14130,2019-04-18,630,0,630,50,680,680,0,0
14131,2019-04-18,1019,0,1019,81,1100,1100,0,0
14132,2019-04-18,223,0,223,17,240,240,0,0
14133,2019-04-18,223,0,223,17,240,240,0,0
14134,2019-04-18,306,0,306,24,330,330,0,0
14135,2019-04-18,973,0,973,77,1050,1050,0,0
14136,2019-04-18,315,0,315,25,340,340,0,0
14137,2019-04-18,1426,0,1426,114,1540,1540,0,0
14138,2019-04-18,371,0,371,29,400,400,0,0
14139,2019-04-18,547,0,547,43,590,590,0,0
14140,2019-04-18,306,0,306,24,330,330,0,0
14141,2019-04-18,433,0,433,17,450,450,0,0
14142,2019-04-18,223,0,223,17,240,240,0,0
14143,2019-04-18,371,0,371,29,400,400,0,0
14144,2019-04-18,371,0,371,29,400,400,0,0
14145,2019-04-18,593,0,593,47,640,640,0,0
14146,2019-04-18,2260,0,2260,180,2440,2440,0,0
14147,2019-04-18,360,0,360,20,380,380,0,0
14148,2019-04-18,2723,0,2723,217,2940,2940,0,0
14149,2019-04-18,463,0,463,37,500,500,0,0
14150,2019-04-18,482,0,482,38,520,0,520,0
14151,2019-04-18,362,0,362,28,390,390,0,0
14152,2019-04-18,1093,0,1093,87,1180,1180,0,0
14153,2019-04-18,982,0,982,78,1060,1060,0,0
14154,2019-04-18,908,0,908,72,980,980,0,0
14155,2019-04-18,1519,0,1519,121,1640,1640,0,0
14156,2019-04-18,362,0,362,28,390,390,0,0
14157,2019-04-18,1102,0,1102,88,1190,1190,0,0
14158,2019-04-18,917,0,917,73,990,990,0,0
14159,2019-04-18,9260,0,9260,740,10000,10000,0,0
14160,2019-04-18,269,0,269,21,290,290,0,0
14161,2019-04-18,176,0,176,14,190,190,0,0
14162,2019-04-18,1232,0,1232,98,1330,1330,0,0
14163,2019-04-18,362,0,362,28,390,390,0,0
14164,2019-04-18,501,0,501,39,540,540,0,0
14165,2019-04-18,788,0,788,62,850,850,0,0
14166,2019-04-18,360,0,360,20,380,380,0,0
14167,2019-04-18,417,0,417,33,450,450,0,0
14168,2019-04-18,306,0,306,24,330,330,0,0
14169,2019-04-18,1112,0,1112,88,1200,1200,0,0
14170,2019-04-18,528,0,528,42,570,570,0,0
14171,2019-04-18,463,0,463,37,500,500,0,0
14172,2019-04-18,473,0,473,37,510,510,0,0
14173,2019-04-18,426,0,426,34,460,460,0,0
14174,2019-04-18,713,0,713,57,770,770,0,0
14175,2019-04-18,204,0,204,16,220,220,0,0
14176,2019-04-18,1325,0,1325,105,1430,1430,0,0
14177,2019-04-18,371,0,371,29,400,400,0,0
14178,2019-04-18,112,0,112,8,120,120,0,0
14179,2019-04-18,3047,0,3047,243,3290,3290,0,0
14180,2019-04-18,424,0,424,33,457,457,0,0
14181,2019-04-18,389,0,389,31,420,420,0,0
14182,2019-04-18,1093,0,1093,87,1180,1180,0,0
14183,2019-04-18,315,0,315,25,340,340,0,0
14184,2019-04-18,362,0,362,28,390,390,0,0
14185,2019-04-18,445,0,445,35,480,480,0,0
14186,2019-04-18,139,0,139,11,150,150,0,0
14187,2019-04-18,584,0,584,46,630,630,0,0
14188,2019-04-18,121,0,121,9,130,130,0,0
14189,2019-04-18,510,0,510,40,550,550,0,0
14190,2019-04-18,1327,-282,1045,83,1128,1128,0,0
14191,2019-04-18,269,0,269,21,290,290,0,0
14192,2019-04-18,778,0,778,62,840,840,0,0
14193,2019-04-18,260,0,260,20,280,280,0,0
14194,2019-04-18,760,0,760,60,820,820,0,0
14195,2019-04-18,371,0,371,29,400,400,0,0
14196,2019-04-18,232,0,232,18,250,250,0,0
14197,2019-04-18,1065,0,1065,85,1150,1150,0,0
14198,2019-04-18,93,0,93,7,100,100,0,0
14199,2019-04-18,760,0,760,60,820,820,0,0
14200,2019-04-18,741,0,741,59,800,800,0,0
14201,2019-04-18,463,0,463,37,500,500,0,0
14202,2019-04-18,389,0,389,31,420,420,0,0
14203,2019-04-18,1167,0,1167,93,1260,1260,0,0
14204,2019-04-18,538,0,538,42,580,580,0,0
14205,2019-04-18,491,0,491,39,530,530,0,0
14206,2019-04-18,899,0,899,71,970,970,0,0
14207,2019-04-18,297,0,297,23,320,320,0,0
14208,2019-04-18,1232,0,1232,98,1330,0,1330,0
14209,2019-04-18,1102,0,1102,88,1190,1190,0,0
14210,2019-04-18,417,0,417,33,450,450,0,0
14211,2019-04-18,343,0,343,27,370,370,0,0
14212,2019-04-18,491,0,491,39,530,530,0,0
14213,2019-04-18,889,0,889,71,960,960,0,0
14214,2019-04-18,269,0,269,21,290,290,0,0
14215,2019-04-18,658,0,658,52,710,710,0,0
14216,2019-04-18,686,0,686,54,740,740,0,0
14217,2019-04-18,899,0,899,71,970,970,0,0
14218,2019-04-18,945,0,945,75,1020,1020,0,0
14219,2019-04-18,1093,0,1093,87,1180,1180,0,0
14220,2019-04-18,1269,0,1269,101,1370,1370,0,0
14221,2019-04-18,538,0,538,42,580,580,0,0
14222,2019-04-18,621,0,621,49,670,670,0,0
14223,2019-04-18,1149,0,1149,91,1240,1240,0,0
14224,2019-04-18,1501,0,1501,119,1620,1620,0,0
14225,2019-04-18,1575,0,1575,125,1700,1700,0,0
14226,2019-04-18,621,0,621,49,670,670,0,0
14227,2019-04-18,343,0,343,27,370,370,0,0
14228,2019-04-18,1861,0,1861,139,2000,2000,0,0
14229,2019-04-18,297,0,297,23,320,320,0,0
14230,2019-04-18,1399,0,1399,111,1510,0,1510,0
14231,2019-04-18,1675,0,1675,125,1800,1800,0,0
14232,2019-04-18,288,0,288,22,310,310,0,0
14233,2019-04-18,2426,0,2426,194,2620,0,2620,0
14234,2019-04-18,639,0,639,51,690,690,0,0
14235,2019-04-18,481,0,481,29,510,510,0,0
14236,2019-04-18,1038,0,1038,82,1120,1120,0,0
14237,2019-04-18,888,0,888,62,950,0,950,0
14238,2019-04-18,1149,0,1149,91,1240,0,1240,0
14239,2019-04-18,334,0,334,26,360,360,0,0
14240,2019-04-18,288,0,288,22,310,310,0,0
14241,2019-04-18,1149,0,1149,91,1240,1240,0,0
14242,2019-04-18,510,0,510,40,550,550,0,0
14243,2019-04-18,112,0,112,8,120,120,0,0
14244,2019-04-18,788,0,788,62,850,850,0,0
14245,2019-04-18,1575,0,1575,125,1700,1700,0,0
14246,2019-04-18,760,0,760,60,820,820,0,0
14247,2019-04-18,510,0,510,40,550,550,0,0
14248,2019-04-18,315,0,315,25,340,340,0,0
14249,2019-04-18,3149,0,3149,251,3400,0,3400,0
14250,2019-04-18,741,0,741,59,800,0,800,0
14251,2019-04-18,-788,0,-788,-62,-850,-850,0,0
14252,2019-04-18,547,0,547,43,590,590,0,0
14253,2019-04-18,371,0,371,29,400,400,0,0
14254,2019-04-18,788,0,788,62,850,850,0,0
14255,2019-04-18,398,0,398,22,420,420,0,0
14256,2019-04-18,1445,0,1445,115,1560,0,1560,0
14257,2019-04-18,788,0,788,62,850,850,0,0
14258,2019-04-18,788,0,788,62,850,850,0,0
14259,2019-04-18,362,0,362,28,390,390,0,0
14260,2019-04-18,1167,0,1167,93,1260,1260,0,0
14261,2019-04-19,1565,0,1565,125,1690,1690,0,0
14262,2019-04-19,501,0,501,39,540,540,0,0
14263,2019-04-19,963,0,963,77,1040,1040,0,0
14264,2019-04-19,482,0,482,38,520,520,0,0
14265,2019-04-19,788,0,788,62,850,850,0,0
14266,2019-04-19,510,0,510,40,550,550,0,0
14267,2019-04-19,1630,0,1630,130,1760,1760,0,0
14268,2019-04-19,676,0,676,54,730,730,0,0
14269,2019-04-19,1417,0,1417,113,1530,1530,0,0
14270,2019-04-19,695,0,695,55,750,750,0,0
14271,2019-04-19,1380,0,1380,110,1490,1490,0,0
14272,2019-04-19,334,0,334,26,360,0,360,0
14273,2019-04-19,1334,0,1334,106,1440,1440,0,0
14274,2019-04-19,1073,0,1073,77,1150,1150,0,0
14275,2019-04-19,167,0,167,13,180,180,0,0
14276,2019-04-19,278,0,278,22,300,300,0,0
14277,2019-04-19,334,0,334,26,360,360,0,0
14278,2019-04-19,1241,0,1241,99,1340,1340,0,0
14279,2019-04-19,926,0,926,74,1000,1000,0,0
14280,2019-04-19,223,0,223,17,240,240,0,0
14281,2019-04-19,241,0,241,19,260,260,0,0
14282,2019-04-19,1843,0,1843,147,1990,1990,0,0
14283,2019-04-19,1399,0,1399,111,1510,1510,0,0
14284,2019-04-19,1325,0,1325,105,1430,1430,0,0
14285,2019-04-19,510,0,510,40,550,550,0,0
14286,2019-04-19,1075,0,1075,85,1160,1160,0,0
14287,2019-04-19,732,0,732,58,790,790,0,0
14288,2019-04-19,667,0,667,53,720,720,0,0
14289,2019-04-19,399,0,399,31,430,430,0,0
14290,2019-04-19,1815,0,1815,145,1960,1960,0,0
14291,2019-04-19,1223,0,1223,97,1320,1320,0,0
14292,2019-04-19,871,0,871,69,940,940,0,0
14293,2019-04-19,380,0,380,30,410,410,0,0
14294,2019-04-19,556,0,556,44,600,600,0,0
14295,2019-04-19,908,0,908,72,980,980,0,0
14296,2019-04-19,908,0,908,72,980,980,0,0
14297,2019-04-19,1712,0,1712,128,1840,1840,0,0
14298,2019-04-19,1788,0,1788,142,1930,1930,0,0
14299,2019-04-19,547,0,547,43,590,590,0,0
14300,2019-04-19,713,0,713,57,770,770,0,0
14301,2019-04-19,908,0,908,72,980,980,0,0
14302,2019-04-19,908,0,908,72,980,980,0,0
14303,2019-04-19,380,0,380,30,410,410,0,0
14304,2019-04-19,695,0,695,55,750,750,0,0
14305,2019-04-19,1926,0,1926,154,2080,2080,0,0
14306,2019-04-19,732,0,732,58,790,790,0,0
14307,2019-04-19,482,0,482,38,520,520,0,0
14308,2019-04-19,2723,0,2723,217,2940,0,2940,0
14309,2019-04-19,649,0,649,51,700,700,0,0
14310,2019-04-19,1288,0,1288,102,1390,0,1390,0
14311,2019-04-19,1297,0,1297,103,1400,1400,0,0
14312,2019-04-19,797,0,797,63,860,860,0,0
14313,2019-04-19,834,0,834,66,900,900,0,0
14314,2019-04-19,251,0,251,19,270,270,0,0
14315,2019-04-19,139,0,139,11,150,150,0,0
14316,2019-04-19,334,0,334,26,360,360,0,0
14317,2019-04-19,908,0,908,72,980,980,0,0
14318,2019-04-19,612,0,612,48,660,660,0,0
14319,2019-04-19,741,0,741,59,800,800,0,0
14320,2019-04-19,908,0,908,72,980,980,0,0
14321,2019-04-19,908,0,908,72,980,980,0,0
14322,2019-04-19,1991,0,1991,159,2150,2150,0,0
14323,2019-04-19,2380,0,2380,190,2570,2570,0,0
14324,2019-04-19,741,0,741,59,800,800,0,0
14325,2019-04-19,204,0,204,16,220,220,0,0
14326,2019-04-19,741,0,741,59,800,800,0,0
14327,2019-04-19,1297,0,1297,103,1400,1400,0,0
14328,2019-04-19,713,0,713,57,770,770,0,0
14329,2019-04-19,778,0,778,62,840,0,840,0
14330,2019-04-19,630,0,630,50,680,680,0,0
14331,2019-04-19,778,0,778,62,840,840,0,0
14332,2019-04-19,250,0,250,20,270,270,0,0
14333,2019-04-19,139,0,139,11,150,150,0,0
14334,2019-04-19,1102,0,1102,88,1190,1190,0,0
14335,2019-04-19,843,0,843,67,910,910,0,0
14336,2019-04-19,1139,0,1139,91,1230,1230,0,0
14337,2019-04-19,741,0,741,59,800,800,0,0
14338,2019-04-19,204,0,204,16,220,220,0,0
14339,2019-04-19,741,0,741,59,800,800,0,0
14340,2019-04-19,908,0,908,72,980,980,0,0
14341,2019-04-19,602,0,602,48,650,650,0,0
14342,2019-04-19,232,0,232,18,250,250,0,0
14343,2019-04-19,601,0,601,39,640,640,0,0
14344,2019-04-19,1889,0,1889,151,2040,2040,0,0
14345,2019-04-19,639,0,639,51,690,690,0,0
14346,2019-04-19,1732,0,1732,138,1870,1870,0,0
14347,2019-04-19,417,0,417,33,450,450,0,0
14348,2019-04-19,908,0,908,72,980,980,0,0
14349,2019-04-19,751,0,751,59,810,810,0,0
14350,2019-04-19,1195,0,1195,95,1290,1290,0,0
14351,2019-04-19,399,0,399,31,430,430,0,0
14352,2019-04-19,250,0,250,20,270,270,0,0
14353,2019-04-19,277,0,277,13,290,290,0,0
14354,2019-04-19,380,0,380,30,410,410,0,0
14355,2019-04-19,260,0,260,20,280,280,0,0
14356,2019-04-19,1667,0,1667,133,1800,1800,0,0
14357,2019-04-19,1815,0,1815,145,1960,1960,0,0
14358,2019-04-19,334,0,334,26,360,360,0,0
14359,2019-04-19,1815,0,1815,145,1960,1960,0,0
14360,2019-04-19,815,0,815,65,880,880,0,0
14361,2019-04-19,315,0,315,25,340,340,0,0
14362,2019-04-19,908,0,908,72,980,980,0,0
14363,2019-04-19,1047,0,1047,83,1130,1130,0,0
14364,2019-04-19,389,0,389,31,420,420,0,0
14365,2019-04-19,760,0,760,60,820,820,0,0
14366,2019-04-19,1417,0,1417,113,1530,0,1530,0
14367,2019-04-19,564,0,564,36,600,600,0,0
14368,2019-04-19,1815,0,1815,145,1960,1960,0,0
14369,2019-04-19,473,0,473,37,510,510,0,0
14370,2019-04-19,288,0,288,22,310,310,0,0
14371,2019-04-19,491,0,491,39,530,530,0,0
14372,2019-04-19,510,0,510,40,550,550,0,0
14373,2019-04-19,862,0,862,68,930,930,0,0
14374,2019-04-19,269,0,269,21,290,290,0,0
14375,2019-04-19,260,0,260,20,280,280,0,0
14376,2019-04-19,371,0,371,29,400,400,0,0
14377,2019-04-19,399,0,399,31,430,430,0,0
14378,2019-04-19,251,0,251,19,270,270,0,0
14379,2019-04-19,1593,0,1593,127,1720,1720,0,0
14380,2019-04-19,241,0,241,19,260,260,0,0
14381,2019-04-19,260,0,260,20,280,280,0,0
14382,2019-04-19,1241,0,1241,99,1340,1340,0,0
14383,2019-04-19,260,0,260,20,280,280,0,0
14384,2019-04-19,528,0,528,42,570,570,0,0
14385,2019-04-19,213,0,213,17,230,230,0,0
14386,2019-04-19,306,0,306,24,330,330,0,0
14387,2019-04-19,908,0,908,72,980,980,0,0
14388,2019-04-19,158,0,158,12,170,170,0,0
14389,2019-04-19,102,0,102,8,110,110,0,0
14390,2019-04-19,380,0,380,30,410,410,0,0
14391,2019-04-19,788,0,788,62,850,850,0,0
14392,2019-04-19,788,0,788,62,850,850,0,0
14393,2019-04-19,463,0,463,37,500,500,0,0
14394,2019-04-19,1528,0,1528,122,1650,1650,0,0
14395,2019-04-19,212,0,212,8,220,220,0,0
14396,2019-04-19,862,0,862,68,930,930,0,0
14397,2019-04-19,593,0,593,47,640,640,0,0
14398,2019-04-19,380,0,380,30,410,410,0,0
14399,2019-04-19,1240,0,1240,90,1330,0,1330,0
14400,2019-04-19,286,0,286,14,300,300,0,0
14401,2019-04-19,528,0,528,42,570,570,0,0
14402,2019-04-19,269,0,269,21,290,290,0,0
14403,2019-04-19,1371,0,1371,109,1480,0,1480,0
14404,2019-04-19,362,0,362,28,390,390,0,0
14405,2019-04-19,139,0,139,11,150,150,0,0
14406,2019-04-19,232,0,232,18,250,250,0,0
14407,2019-04-19,4538,0,4538,362,4900,4900,0,0
14408,2019-04-19,278,0,278,22,300,300,0,0
14409,2019-04-19,602,0,602,48,650,650,0,0
14410,2019-04-19,741,0,741,59,800,800,0,0
14411,2019-04-19,713,0,713,57,770,0,770,0
14412,2019-04-19,408,0,408,32,440,440,0,0
14413,2019-04-19,130,0,130,10,140,140,0,0
14414,2019-04-19,297,0,297,23,320,320,0,0
14415,2019-04-19,1547,0,1547,123,1670,1670,0,0
14416,2019-04-19,167,0,167,13,180,180,0,0
14417,2019-04-19,269,0,269,21,290,290,0,0
14418,2019-04-19,334,0,334,26,360,360,0,0
14419,2019-04-19,556,0,556,44,600,600,0,0
14420,2019-04-19,769,0,769,61,830,830,0,0
14421,2019-04-19,186,0,186,14,200,200,0,0
14422,2019-04-19,749,0,749,51,800,800,0,0
14423,2019-04-19,981,0,981,69,1050,1050,0,0
14424,2019-04-19,621,0,621,49,670,670,0,0
14425,2019-04-19,547,0,547,43,590,590,0,0
14426,2019-04-19,1389,0,1389,111,1500,0,1500,0
14427,2019-04-19,1444,0,1444,106,1550,1550,0,0
14428,2019-04-19,3149,0,3149,251,3400,3400,0,0
14429,2019-04-19,917,0,917,73,990,990,0,0
14430,2019-04-19,399,0,399,31,430,430,0,0
14431,2019-04-19,676,0,676,54,730,730,0,0
14432,2019-04-19,362,0,362,28,390,390,0,0
14433,2019-04-19,491,0,491,39,530,530,0,0
14434,2019-04-19,176,0,176,14,190,190,0,0
14435,2019-04-19,176,0,176,14,190,190,0,0
14436,2019-04-19,352,0,352,28,380,380,0,0
14437,2019-04-19,741,0,741,59,800,800,0,0
14438,2019-04-19,1343,0,1343,107,1450,1450,0,0
14439,2019-04-19,695,0,695,55,750,750,0,0
14440,2019-04-19,2130,0,2130,170,2300,2300,0,0
14441,2019-04-19,547,0,547,43,590,590,0,0
14442,2019-04-19,269,0,269,21,290,290,0,0
14443,2019-04-19,778,0,778,62,840,840,0,0
14444,2019-04-19,871,0,871,69,940,940,0,0
14445,2019-04-19,1223,0,1223,97,1320,1320,0,0
14446,2019-04-19,788,0,788,62,850,850,0,0
14447,2019-04-19,621,0,621,49,670,670,0,0
14448,2019-04-19,510,0,510,40,550,550,0,0
14449,2019-04-19,1575,0,1575,125,1700,1700,0,0
14450,2019-04-19,1056,0,1056,84,1140,1140,0,0
14451,2019-04-19,778,0,778,62,840,840,0,0
14452,2019-04-19,343,0,343,27,370,370,0,0
14453,2019-04-19,545,0,545,25,570,570,0,0
14454,2019-04-19,2093,0,2093,167,2260,2260,0,0
14455,2019-04-19,778,0,778,62,840,840,0,0
14456,2019-04-19,732,0,732,58,790,790,0,0
14457,2019-04-19,741,0,741,59,800,800,0,0
14458,2019-04-19,-621,0,-621,-49,-670,-670,0,0
14459,2019-04-19,362,0,362,28,390,390,0,0
14460,2019-04-19,250,0,250,20,270,270,0,0
14461,2019-04-19,343,0,343,27,370,370,0,0
14462,2019-04-19,351,0,351,19,370,370,0,0
14463,2019-04-19,1851,0,1851,139,1990,1990,0,0
14464,2019-04-19,1676,0,1676,134,1810,1810,0,0
14465,2019-04-19,167,0,167,13,180,180,0,0
14466,2019-04-19,2371,0,2371,189,2560,2560,0,0
14467,2019-04-19,139,0,139,11,150,150,0,0
14468,2019-04-19,723,0,723,57,780,780,0,0
14469,2019-04-19,556,0,556,44,600,600,0,0
14470,2019-04-19,2130,0,2130,170,2300,2300,0,0
14471,2019-04-19,1575,0,1575,125,1700,1700,0,0
14472,2019-04-19,288,0,288,22,310,310,0,0
14473,2019-04-19,973,0,973,77,1050,1050,0,0
14474,2019-04-19,788,0,788,62,850,850,0,0
14475,2019-04-19,788,0,788,62,850,850,0,0
14476,2019-04-19,1852,0,1852,148,2000,2000,0,0
14477,2019-04-20,1620,0,1620,120,1740,0,1740,0
14478,2019-04-20,417,0,417,33,450,450,0,0
14479,2019-04-20,426,0,426,34,460,0,460,0
14480,2019-04-20,1815,0,1815,145,1960,1960,0,0
14481,2019-04-20,751,0,751,59,810,810,0,0
14482,2019-04-20,991,0,991,79,1070,1070,0,0
14483,2019-04-20,593,0,593,47,640,640,0,0
14484,2019-04-20,519,0,519,41,560,560,0,0
14485,2019-04-20,436,0,436,34,470,470,0,0
14486,2019-04-20,723,0,723,57,780,780,0,0
14487,2019-04-20,288,0,288,22,310,310,0,0
14488,2019-04-20,649,0,649,51,700,700,0,0
14489,2019-04-20,269,0,269,21,290,290,0,0
14490,2019-04-20,1278,0,1278,102,1380,1380,0,0
14491,2019-04-20,1278,0,1278,102,1380,1380,0,0
14492,2019-04-20,593,0,593,47,640,640,0,0
14493,2019-04-20,1815,0,1815,145,1960,1960,0,0
14494,2019-04-20,732,0,732,58,790,790,0,0
14495,2019-04-20,556,0,556,44,600,600,0,0
14496,2019-04-20,371,0,371,29,400,400,0,0
14497,2019-04-20,371,0,371,29,400,400,0,0
14498,2019-04-20,1121,0,1121,89,1210,1210,0,0
14499,2019-04-20,1426,0,1426,114,1540,1540,0,0
14500,2019-04-20,1769,0,1769,141,1910,1910,0,0
14501,2019-04-20,1778,0,1778,142,1920,1920,0,0
14502,2019-04-20,797,0,797,63,860,860,0,0
14503,2019-04-20,212,0,212,8,220,220,0,0
14504,2019-04-20,2723,0,2723,217,2940,0,2940,0
14505,2019-04-20,843,0,843,67,910,910,0,0
14506,2019-04-20,528,0,528,42,570,0,570,0
14507,2019-04-20,833,0,833,57,890,890,0,0
14508,2019-04-20,1176,0,1176,94,1270,1270,0,0
14509,2019-04-20,1139,0,1139,91,1230,1230,0,0
14510,2019-04-20,843,0,843,67,910,910,0,0
14511,2019-04-20,1575,0,1575,125,1700,1700,0,0
14512,2019-04-20,1075,0,1075,85,1160,1160,0,0
14513,2019-04-20,1501,0,1501,119,1620,1620,0,0
14514,2019-04-20,1426,0,1426,114,1540,1540,0,0
14515,2019-04-20,176,0,176,14,190,190,0,0
14516,2019-04-20,852,0,852,68,920,920,0,0
14517,2019-04-20,788,0,788,62,850,850,0,0
14518,2019-04-20,1019,0,1019,81,1100,1100,0,0
14519,2019-04-20,788,0,788,62,850,850,0,0
14520,2019-04-20,788,0,788,62,850,850,0,0
14521,2019-04-20,788,0,788,62,850,850,0,0
14522,2019-04-20,788,0,788,62,850,850,0,0
14523,2019-04-20,1149,0,1149,91,1240,1240,0,0
14524,2019-04-20,788,0,788,62,850,850,0,0
14525,2019-04-20,1102,0,1102,88,1190,0,1190,0
14526,2019-04-20,788,0,788,62,850,850,0,0
14527,2019-04-20,686,0,686,54,740,0,740,0
14528,2019-04-20,1065,0,1065,85,1150,1150,0,0
14529,2019-04-20,334,0,334,26,360,360,0,0
14530,2019-04-20,408,0,408,32,440,440,0,0
14531,2019-04-20,806,0,806,64,870,870,0,0
14532,2019-04-20,491,0,491,39,530,530,0,0
14533,2019-04-20,-371,0,-371,-29,-400,-400,0,0
14534,2019-04-20,371,0,371,29,400,400,0,0
14535,2019-04-20,491,0,491,39,530,530,0,0
14536,2019-04-20,343,0,343,27,370,370,0,0
14537,2019-04-20,371,0,371,29,400,400,0,0
14538,2019-04-20,880,0,880,70,950,950,0,0
14539,2019-04-20,371,0,371,29,400,400,0,0
14540,2019-04-20,973,0,973,77,1050,1050,0,0
14541,2019-04-20,380,0,380,30,410,410,0,0
14542,2019-04-20,788,0,788,62,850,850,0,0
14543,2019-04-20,1176,0,1176,94,1270,1270,0,0
14544,2019-04-20,908,0,908,72,980,980,0,0
14545,2019-04-20,630,0,630,50,680,0,680,0
14546,2019-04-20,306,0,306,24,330,330,0,0
14547,2019-04-20,383,-80,303,17,320,320,0,0
14548,2019-04-20,130,0,130,10,140,140,0,0
14549,2019-04-20,1834,0,1834,146,1980,1980,0,0
14550,2019-04-20,1102,0,1102,88,1190,1190,0,0
14551,2019-04-20,667,0,667,53,720,720,0,0
14552,2019-04-20,213,0,213,17,230,230,0,0
14553,2019-04-20,2723,0,2723,217,2940,2940,0,0
14554,2019-04-20,1815,0,1815,145,1960,1960,0,0
14555,2019-04-20,565,0,565,45,610,610,0,0
14556,2019-04-20,278,0,278,22,300,300,0,0
14557,2019-04-20,510,0,510,40,550,550,0,0
14558,2019-04-20,945,0,945,75,1020,1020,0,0
14559,2019-04-20,1815,0,1815,145,1960,1960,0,0
14560,2019-04-20,139,0,139,11,150,150,0,0
14561,2019-04-20,408,0,408,32,440,440,0,0
14562,2019-04-20,473,0,473,37,510,510,0,0
14563,2019-04-20,1815,0,1815,145,1960,1960,0,0
14564,2019-04-20,1362,0,1362,108,1470,1470,0,0
14565,2019-04-20,269,0,269,21,290,290,0,0
14566,2019-04-20,908,0,908,72,980,980,0,0
14567,2019-04-20,565,0,565,45,610,610,0,0
14568,2019-04-20,834,0,834,66,900,900,0,0
14569,2019-04-20,223,0,223,17,240,240,0,0
14570,2019-04-20,528,0,528,42,570,570,0,0
14571,2019-04-20,112,0,112,8,120,120,0,0
14572,2019-04-20,417,0,417,33,450,450,0,0
14573,2019-04-20,334,0,334,26,360,360,0,0
14574,2019-04-20,260,0,260,20,280,280,0,0
14575,2019-04-20,880,0,880,70,950,950,0,0
14576,2019-04-20,1815,0,1815,145,1960,1960,0,0
14577,2019-04-20,732,0,732,58,790,790,0,0
14578,2019-04-20,612,0,612,48,660,660,0,0
14579,2019-04-20,825,0,825,65,890,890,0,0
14580,2019-04-20,213,0,213,17,230,230,0,0
14581,2019-04-20,982,0,982,78,1060,1060,0,0
14582,2019-04-20,1038,0,1038,82,1120,1120,0,0
14583,2019-04-20,1112,0,1112,88,1200,1200,0,0
14584,2019-04-20,575,0,575,45,620,620,0,0
14585,2019-04-20,538,0,538,42,580,580,0,0
14586,2019-04-20,389,0,389,31,420,420,0,0
14587,2019-04-20,417,0,417,33,450,450,0,0
14588,2019-04-20,417,0,417,33,450,450,0,0
14589,2019-04-20,612,0,612,48,660,660,0,0
14590,2019-04-20,778,0,778,62,840,840,0,0
14591,2019-04-20,389,0,389,31,420,420,0,0
14592,2019-04-20,454,0,454,36,490,490,0,0
14593,2019-04-20,676,0,676,54,730,730,0,0
14594,2019-04-20,1815,0,1815,145,1960,1960,0,0
14595,2019-04-20,260,0,260,20,280,280,0,0
14596,2019-04-20,277,0,277,13,290,290,0,0
14597,2019-04-20,1260,-135,1125,90,1215,1215,0,0
14598,2019-04-20,436,0,436,34,470,470,0,0
14599,2019-04-20,908,0,908,72,980,980,0,0
14600,2019-04-20,862,0,862,68,930,930,0,0
14601,2019-04-20,433,-92,341,27,368,368,0,0
14602,2019-04-20,352,0,352,28,380,380,0,0
14603,2019-04-20,389,0,389,31,420,420,0,0
14604,2019-04-20,315,0,315,25,340,340,0,0
14605,2019-04-20,584,0,584,46,630,0,630,0
14606,2019-04-20,1815,0,1815,145,1960,1960,0,0
14607,2019-04-20,871,0,871,69,940,940,0,0
14608,2019-04-20,315,0,315,25,340,340,0,0
14609,2019-04-20,1815,0,1815,145,1960,0,1960,0
14610,2019-04-20,2120,0,2120,160,2280,2280,0,0
14611,2019-04-20,519,0,519,41,560,560,0,0
14612,2019-04-20,769,0,769,61,830,830,0,0
14613,2019-04-20,1251,0,1251,99,1350,1350,0,0
14614,2019-04-20,1815,0,1815,145,1960,0,1960,0
14615,2019-04-20,1815,0,1815,145,1960,1960,0,0
14616,2019-04-20,260,0,260,20,280,0,280,0
14617,2019-04-20,1065,0,1065,85,1150,1150,0,0
14618,2019-04-20,538,0,538,42,580,580,0,0
14619,2019-04-20,1065,0,1065,85,1150,1150,0,0
14620,2019-04-20,389,0,389,31,420,420,0,0
14621,2019-04-20,334,0,334,26,360,360,0,0
14622,2019-04-20,491,0,491,39,530,530,0,0
14623,2019-04-20,399,0,399,31,430,430,0,0
14624,2019-04-20,1399,0,1399,111,1510,1510,0,0
14625,2019-04-20,306,0,306,24,330,330,0,0
14626,2019-04-20,463,0,463,37,500,500,0,0
14627,2019-04-20,1380,0,1380,110,1490,1490,0,0
14628,2019-04-20,139,0,139,11,150,150,0,0
14629,2019-04-20,954,0,954,76,1030,1030,0,0
14630,2019-04-20,269,0,269,21,290,290,0,0
14631,2019-04-20,1084,0,1084,86,1170,1170,0,0
14632,2019-04-20,1167,0,1167,93,1260,1260,0,0
14633,2019-04-20,602,0,602,48,650,0,650,0
14634,2019-04-20,130,0,130,10,140,140,0,0
14635,2019-04-20,306,0,306,24,330,330,0,0
14636,2019-04-20,584,0,584,46,630,630,0,0
14637,2019-04-20,2584,0,2584,206,2790,2790,0,0
14638,2019-04-20,260,0,260,20,280,280,0,0
14639,2019-04-20,186,0,186,14,200,200,0,0
14640,2019-04-20,871,0,871,69,940,940,0,0
14641,2019-04-20,621,0,621,49,670,670,0,0
14642,2019-04-20,769,0,769,61,830,830,0,0
14643,2019-04-20,760,0,760,60,820,820,0,0
14644,2019-04-20,491,0,491,39,530,530,0,0
14645,2019-04-20,788,0,788,62,850,850,0,0
14646,2019-04-20,1297,0,1297,103,1400,1400,0,0
14647,2019-04-20,538,0,538,42,580,580,0,0
14648,2019-04-20,1047,0,1047,83,1130,1130,0,0
14649,2019-04-20,1288,0,1288,102,1390,0,1390,0
14650,2019-04-20,528,0,528,42,570,570,0,0
14651,2019-04-20,1862,0,1862,148,2010,2010,0,0
14652,2019-04-20,778,0,778,62,840,840,0,0
14653,2019-04-20,778,0,778,62,840,840,0,0
14654,2019-04-20,1028,0,1028,82,1110,1110,0,0
14655,2019-04-20,269,0,269,21,290,290,0,0
14656,2019-04-20,871,0,871,69,940,940,0,0
14657,2019-04-20,454,0,454,36,490,490,0,0
14658,2019-04-20,954,0,954,76,1030,1030,0,0
14659,2019-04-20,899,0,899,71,970,970,0,0
14660,2019-04-20,666,0,666,44,710,710,0,0
14661,2019-04-20,1075,0,1075,85,1160,1160,0,0
14662,2019-04-20,917,0,917,73,990,990,0,0
14663,2019-04-20,908,0,908,72,980,980,0,0
14664,2019-04-20,1815,0,1815,145,1960,1960,0,0
14665,2019-04-20,1121,0,1121,89,1210,1210,0,0
14666,2019-04-20,778,0,778,62,840,840,0,0
14667,2019-04-20,630,0,630,50,680,680,0,0
14668,2019-04-20,760,0,760,60,820,820,0,0
14669,2019-04-20,1065,0,1065,85,1150,1150,0,0
14670,2019-04-20,371,0,371,29,400,400,0,0
14671,2019-04-20,1028,0,1028,82,1110,1110,0,0
14672,2019-04-20,269,0,269,21,290,290,0,0
14673,2019-04-20,630,0,630,50,680,680,0,0
14674,2019-04-20,425,0,425,25,450,450,0,0
14675,2019-04-20,797,0,797,63,860,860,0,0
14676,2019-04-20,362,0,362,28,390,390,0,0
14677,2019-04-20,788,0,788,62,850,850,0,0
14678,2019-04-20,1288,0,1288,102,1390,1390,0,0
14679,2019-04-20,213,0,213,17,230,230,0,0
14680,2019-04-20,945,0,945,75,1020,0,1020,0
14681,2019-04-20,852,0,852,68,920,920,0,0
14682,2019-04-20,723,0,723,57,780,780,0,0
14683,2019-04-20,325,0,325,25,350,350,0,0
14684,2019-04-20,362,0,362,28,390,390,0,0
14685,2019-04-20,130,0,130,10,140,140,0,0
14686,2019-04-20,1130,0,1130,90,1220,1220,0,0
14687,2019-04-20,260,0,260,20,280,280,0,0
14688,2019-04-20,315,0,315,25,340,340,0,0
14689,2019-04-20,630,0,630,50,680,680,0,0
14690,2019-04-20,1121,0,1121,89,1210,1210,0,0
14691,2019-04-20,889,0,889,71,960,960,0,0
14692,2019-04-20,880,0,880,70,950,950,0,0
14693,2019-04-20,575,0,575,45,620,620,0,0
14694,2019-04-20,834,0,834,66,900,900,0,0
14695,2019-04-20,556,0,556,44,600,600,0,0
14696,2019-04-20,1528,0,1528,122,1650,1650,0,0
14697,2019-04-20,2315,0,2315,185,2500,2500,0,0
14698,2019-04-20,575,0,575,45,620,620,0,0
14699,2019-04-20,778,0,778,62,840,840,0,0
14700,2019-04-20,1362,0,1362,108,1470,1470,0,0
14701,2019-04-20,1149,0,1149,91,1240,1240,0,0
14702,2019-04-20,732,0,732,58,790,790,0,0
14703,2019-04-20,630,0,630,50,680,680,0,0
14704,2019-04-20,788,0,788,62,850,850,0,0
14705,2019-04-20,249,0,249,11,260,260,0,0
14706,2019-04-20,1288,0,1288,102,1390,0,1390,0
14707,2019-04-20,2362,0,2362,188,2550,2550,0,0
14708,2019-04-20,241,0,241,19,260,260,0,0
14709,2019-04-20,510,0,510,40,550,550,0,0
14710,2019-04-20,269,0,269,21,290,290,0,0
14711,2019-04-20,760,0,760,60,820,820,0,0
14712,2019-04-20,2001,0,2001,159,2160,2160,0,0
14713,2019-04-20,593,0,593,47,640,640,0,0
14714,2019-04-20,204,0,204,16,220,220,0,0
14715,2019-04-20,991,0,991,79,1070,1070,0,0
14716,2019-04-20,2362,0,2362,188,2550,2550,0,0
14717,2019-04-20,788,0,788,62,850,850,0,0
14718,2019-04-20,1102,0,1102,88,1190,1190,0,0
14719,2019-04-20,510,0,510,40,550,550,0,0
14720,2019-04-20,1102,0,1102,88,1190,1190,0,0
14721,2019-04-20,538,0,538,42,580,580,0,0
14722,2019-04-20,538,0,538,42,580,580,0,0
14723,2019-04-20,991,0,991,79,1070,1070,0,0
14724,2019-04-20,788,0,788,62,850,850,0,0
14725,2019-04-20,1019,0,1019,81,1100,1100,0,0
14726,2019-04-20,1195,0,1195,95,1290,1290,0,0
14727,2019-04-20,834,0,834,66,900,900,0,0
14728,2019-04-20,360,0,360,20,380,380,0,0
14729,2019-04-20,788,0,788,62,850,850,0,0
14730,2019-04-20,731,0,731,49,780,780,0,0
14731,2019-04-20,556,0,556,44,600,600,0,0
14732,2019-04-20,1575,0,1575,125,1700,1700,0,0
14733,2019-04-20,1575,0,1575,125,1700,1700,0,0
14734,2019-04-20,1575,0,1575,125,1700,0,1700,0
14735,2019-04-20,834,0,834,66,900,900,0,0
14736,2019-04-20,482,0,482,38,520,520,0,0
14737,2019-04-20,491,0,491,39,530,530,0,0
14738,2019-04-20,1343,0,1343,107,1450,1450,0,0
14739,2019-04-20,112,0,112,8,120,120,0,0
14740,2019-04-20,1065,0,1065,85,1150,1150,0,0
14741,2019-04-20,593,0,593,47,640,640,0,0
14742,2019-04-20,269,0,269,21,290,290,0,0
14743,2019-04-20,982,0,982,78,1060,1060,0,0
14744,2019-04-20,510,0,510,40,550,550,0,0
14745,2019-04-20,1852,0,1852,148,2000,2000,0,0
14746,2019-04-20,38,0,38,2,40,40,0,0
14747,2019-04-20,1167,0,1167,93,1260,1260,0,0
14748,2019-04-20,250,0,250,20,270,270,0,0
14749,2019-04-20,3185,0,3185,245,3430,3430,0,0
14750,2019-04-20,1575,0,1575,125,1700,1700,0,0
14751,2019-04-20,834,0,834,66,900,900,0,0
14752,2019-04-20,1371,0,1371,109,1480,1480,0,0
14753,2019-04-20,278,0,278,22,300,300,0,0
14754,2019-04-20,806,0,806,64,870,870,0,0
14755,2019-04-20,788,0,788,62,850,850,0,0
14756,2019-04-20,1575,0,1575,125,1700,1700,0,0
14757,2019-04-20,1575,0,1575,125,1700,1700,0,0
14758,2019-04-20,630,0,630,50,680,680,0,0
14759,2019-04-20,806,0,806,64,870,870,0,0
14760,2019-04-20,982,0,982,78,1060,1060,0,0
14761,2019-04-21,547,0,547,43,590,590,0,0
14762,2019-04-21,741,0,741,59,800,800,0,0
14763,2019-04-21,362,0,362,28,390,390,0,0
14764,2019-04-21,658,0,658,52,710,710,0,0
14765,2019-04-21,343,0,343,27,370,370,0,0
14766,2019-04-21,908,0,908,72,980,980,0,0
14767,2019-04-21,908,0,908,72,980,980,0,0
14768,2019-04-21,500,0,500,40,540,540,0,0
14769,2019-04-21,1575,0,1575,125,1700,1700,0,0
14770,2019-04-21,788,0,788,62,850,850,0,0
14771,2019-04-21,805,0,805,55,860,860,0,0
14772,2019-04-21,1815,0,1815,145,1960,1960,0,0
14773,2019-04-21,658,0,658,52,710,710,0,0
14774,2019-04-21,360,0,360,20,380,380,0,0
14775,2019-04-21,491,0,491,39,530,530,0,0
14776,2019-04-21,778,0,778,62,840,840,0,0
14777,2019-04-21,862,0,862,68,930,930,0,0
14778,2019-04-21,834,0,834,66,900,900,0,0
14779,2019-04-21,232,0,232,18,250,250,0,0
14780,2019-04-21,204,0,204,16,220,220,0,0
14781,2019-04-21,1408,0,1408,112,1520,1520,0,0
14782,2019-04-21,130,0,130,10,140,140,0,0
14783,2019-04-21,250,0,250,20,270,270,0,0
14784,2019-04-21,260,0,260,20,280,280,0,0
14785,2019-04-21,963,0,963,77,1040,1040,0,0
14786,2019-04-21,630,0,630,50,680,680,0,0
14787,2019-04-21,1426,0,1426,114,1540,1540,0,0
14788,2019-04-21,1084,0,1084,86,1170,1170,0,0
14789,2019-04-21,389,0,389,31,420,420,0,0
14790,2019-04-21,167,0,167,13,180,180,0,0
14791,2019-04-21,695,0,695,55,750,750,0,0
14792,2019-04-21,399,0,399,31,430,430,0,0
14793,2019-04-21,426,0,426,34,460,460,0,0
14794,2019-04-21,278,0,278,22,300,300,0,0
14795,2019-04-21,371,0,371,29,400,400,0,0
14796,2019-04-21,297,0,297,23,320,320,0,0
14797,2019-04-21,612,0,612,48,660,660,0,0
14798,2019-04-21,973,0,973,77,1050,1050,0,0
14799,2019-04-21,834,0,834,66,900,0,900,0
14800,2019-04-21,1278,0,1278,102,1380,0,1380,0
14801,2019-04-21,399,0,399,31,430,430,0,0
14802,2019-04-21,510,0,510,40,550,550,0,0
14803,2019-04-21,436,0,436,34,470,470,0,0
14804,2019-04-21,408,0,408,32,440,440,0,0
14805,2019-04-21,575,0,575,45,620,620,0,0
14806,2019-04-21,1334,0,1334,106,1440,1440,0,0
14807,2019-04-21,1056,0,1056,84,1140,0,1140,0
14808,2019-04-21,667,0,667,53,720,720,0,0
14809,2019-04-21,334,0,334,26,360,360,0,0
14810,2019-04-21,454,0,454,36,490,490,0,0
14811,2019-04-21,1056,0,1056,84,1140,0,1140,0
14812,2019-04-21,788,0,788,62,850,850,0,0
14813,2019-04-21,547,0,547,43,590,590,0,0
14814,2019-04-21,491,0,491,39,530,530,0,0
14815,2019-04-21,575,0,575,45,620,620,0,0
14816,2019-04-21,250,0,250,20,270,270,0,0
14817,2019-04-21,1047,0,1047,83,1130,1130,0,0
14818,2019-04-21,723,0,723,57,780,780,0,0
14819,2019-04-21,405,-86,319,25,344,344,0,0
14820,2019-04-21,249,0,249,11,260,260,0,0
14821,2019-04-21,676,0,676,54,730,730,0,0
14822,2019-04-21,1010,0,1010,80,1090,1090,0,0
14823,2019-04-21,908,0,908,72,980,980,0,0
14824,2019-04-21,908,0,908,72,980,980,0,0
14825,2019-04-21,908,0,908,72,980,980,0,0
14826,2019-04-21,399,0,399,31,430,430,0,0
14827,2019-04-21,232,0,232,18,250,250,0,0
14828,2019-04-21,639,0,639,51,690,690,0,0
14829,2019-04-21,500,0,500,40,540,540,0,0
14830,2019-04-21,352,0,352,28,380,380,0,0
14831,2019-04-21,167,0,167,13,180,180,0,0
14832,2019-04-21,778,0,778,62,840,840,0,0
14833,2019-04-21,102,0,102,8,110,110,0,0
14834,2019-04-21,389,0,389,31,420,420,0,0
14835,2019-04-21,481,0,481,29,510,510,0,0
14836,2019-04-21,232,0,232,18,250,250,0,0
14837,2019-04-21,510,0,510,40,550,550,0,0
14838,2019-04-21,232,0,232,18,250,250,0,0
14839,2019-04-21,528,0,528,42,570,570,0,0
14840,2019-04-21,343,0,343,27,370,370,0,0
14841,2019-04-21,232,0,232,18,250,250,0,0
14842,2019-04-21,1888,0,1888,142,2030,2030,0,0
14843,2019-04-21,1001,0,1001,79,1080,1080,0,0
14844,2019-04-21,343,0,343,27,370,370,0,0
14845,2019-04-21,1315,0,1315,105,1420,1420,0,0
14846,2019-04-21,462,0,462,36,498,498,0,0
14847,2019-04-21,371,0,371,29,400,400,0,0
14848,2019-04-21,121,0,121,9,130,130,0,0
14849,2019-04-21,47,0,47,3,50,50,0,0
14850,2019-04-21,47,0,47,3,50,50,0,0
14851,2019-04-21,825,0,825,65,890,890,0,0
14852,2019-04-21,741,0,741,59,800,800,0,0
14853,2019-04-21,325,0,325,25,350,350,0,0
14854,2019-04-21,523,-56,467,37,504,504,0,0
14855,2019-04-21,1102,0,1102,88,1190,1190,0,0
14856,2019-04-21,306,0,306,24,330,330,0,0
14857,2019-04-21,1149,0,1149,91,1240,1240,0,0
14858,2019-04-21,389,0,389,31,420,420,0,0
14859,2019-04-21,889,0,889,71,960,960,0,0
14860,2019-04-21,121,0,121,9,130,130,0,0
14861,2019-04-21,334,0,334,26,360,360,0,0
14862,2019-04-21,501,0,501,39,540,540,0,0
14863,2019-04-21,1203,0,1203,87,1290,1290,0,0
14864,2019-04-21,1047,0,1047,83,1130,1130,0,0
14865,2019-04-21,593,0,593,47,640,640,0,0
14866,2019-04-21,621,0,621,49,670,670,0,0
14867,2019-04-21,982,0,982,78,1060,1060,0,0
14868,2019-04-21,342,0,342,18,360,360,0,0
14869,2019-04-21,260,0,260,20,280,280,0,0
14870,2019-04-21,399,0,399,31,430,430,0,0
14871,2019-04-21,1204,0,1204,96,1300,0,1300,0
14872,2019-04-21,788,0,788,62,850,850,0,0
14873,2019-04-21,250,0,250,20,270,270,0,0
14874,2019-04-21,616,-66,550,44,594,594,0,0
14875,2019-04-21,436,0,436,34,470,470,0,0
14876,2019-04-21,315,0,315,25,340,340,0,0
14877,2019-04-21,1575,0,1575,125,1700,1700,0,0
14878,2019-04-21,306,0,306,24,330,330,0,0
14879,2019-04-21,388,0,388,22,410,410,0,0
14880,2019-04-21,788,0,788,62,850,850,0,0
14881,2019-04-21,788,0,788,62,850,850,0,0
14882,2019-04-21,472,0,472,28,500,500,0,0
14883,2019-04-21,315,0,315,25,340,340,0,0
14884,2019-04-21,1306,0,1306,104,1410,0,1410,0
14885,2019-04-21,778,0,778,62,840,840,0,0
14886,2019-04-21,371,0,371,29,400,400,0,0
14887,2019-04-21,417,0,417,33,450,450,0,0
14888,2019-04-21,2741,0,2741,219,2960,2960,0,0
14889,2019-04-21,1510,0,1510,120,1630,1630,0,0
14890,2019-04-21,112,0,112,8,120,120,0,0
14891,2019-04-21,167,0,167,13,180,180,0,0
14892,2019-04-21,621,0,621,49,670,670,0,0
14893,2019-04-21,482,0,482,38,520,520,0,0
14894,2019-04-21,713,0,713,57,770,770,0,0
14895,2019-04-21,232,0,232,18,250,250,0,0
14896,2019-04-21,389,0,389,31,420,420,0,0
14897,2019-04-21,232,0,232,18,250,250,0,0
14898,2019-04-21,491,0,491,39,530,530,0,0
14899,2019-04-21,232,0,232,18,250,250,0,0
14900,2019-04-21,621,0,621,49,670,670,0,0
14901,2019-04-21,621,0,621,49,670,670,0,0
14902,2019-04-21,686,0,686,54,740,740,0,0
14903,2019-04-21,389,0,389,31,420,420,0,0
14904,2019-04-21,380,0,380,30,410,410,0,0
14905,2019-04-22,899,0,899,71,970,970,0,0
14906,2019-04-22,788,0,788,62,850,850,0,0
14907,2019-04-22,1815,0,1815,145,1960,1960,0,0
14908,2019-04-22,1778,0,1778,142,1920,1920,0,0
14909,2019-04-22,482,0,482,38,520,520,0,0
14910,2019-04-22,621,0,621,49,670,670,0,0
14911,2019-04-22,547,0,547,43,590,590,0,0
14912,2019-04-22,2462,0,2462,188,2650,2650,0,0
14913,2019-04-22,1639,0,1639,131,1770,1770,0,0
14914,2019-04-22,473,0,473,37,510,510,0,0
14915,2019-04-22,260,0,260,20,280,280,0,0
14916,2019-04-22,612,0,612,48,660,660,0,0
14917,2019-04-22,463,0,463,37,500,500,0,0
14918,2019-04-22,306,0,306,24,330,330,0,0
14919,2019-04-22,695,0,695,55,750,750,0,0
14920,2019-04-22,1601,0,1601,119,1720,1720,0,0
14921,2019-04-22,825,0,825,65,890,890,0,0
14922,2019-04-22,334,0,334,26,360,360,0,0
14923,2019-04-22,204,0,204,16,220,220,0,0
14924,2019-04-22,675,0,675,45,720,720,0,0
14925,2019-04-22,2501,0,2501,199,2700,2700,0,0
14926,2019-04-22,1815,0,1815,145,1960,1960,0,0
14927,2019-04-22,538,0,538,42,580,580,0,0
14928,2019-04-22,417,0,417,33,450,450,0,0
14929,2019-04-22,501,0,501,39,540,540,0,0
14930,2019-04-22,315,0,315,25,340,340,0,0
14931,2019-04-22,908,0,908,72,980,980,0,0
14932,2019-04-22,843,0,843,67,910,910,0,0
14933,2019-04-22,908,0,908,72,980,980,0,0
14934,2019-04-22,658,0,658,52,710,710,0,0
14935,2019-04-22,880,0,880,70,950,950,0,0
14936,2019-04-22,510,0,510,40,550,550,0,0
14937,2019-04-22,352,0,352,28,380,380,0,0
14938,2019-04-22,769,0,769,61,830,830,0,0
14939,2019-04-22,278,0,278,22,300,300,0,0
14940,2019-04-22,306,0,306,24,330,330,0,0
14941,2019-04-22,204,0,204,16,220,220,0,0
14942,2019-04-22,1815,0,1815,145,1960,1960,0,0
14943,2019-04-22,352,0,352,28,380,380,0,0
14944,2019-04-22,362,0,362,28,390,390,0,0
14945,2019-04-22,639,0,639,51,690,690,0,0
14946,2019-04-22,815,0,815,65,880,880,0,0
14947,2019-04-22,639,0,639,51,690,690,0,0
14948,2019-04-22,491,0,491,39,530,530,0,0
14949,2019-04-22,788,0,788,62,850,850,0,0
14950,2019-04-22,371,0,371,29,400,400,0,0
14951,2019-04-22,445,0,445,35,480,480,0,0
14952,2019-04-22,371,0,371,29,400,400,0,0
14953,2019-04-22,565,0,565,45,610,610,0,0
14954,2019-04-22,2482,0,2482,198,2680,2680,0,0
14955,2019-04-22,649,0,649,51,700,700,0,0
14956,2019-04-22,426,0,426,34,460,460,0,0
14957,2019-04-22,1630,0,1630,130,1760,1760,0,0
14958,2019-04-22,510,0,510,40,550,550,0,0
14959,2019-04-22,454,0,454,36,490,490,0,0
14960,2019-04-22,436,0,436,34,470,470,0,0
14961,2019-04-22,501,0,501,39,540,540,0,0
14962,2019-04-22,399,0,399,31,430,430,0,0
14963,2019-04-22,797,0,797,63,860,860,0,0
14964,2019-04-22,501,0,501,39,540,540,0,0
14965,2019-04-22,1120,0,1120,80,1200,1200,0,0
14966,2019-04-22,436,0,436,34,470,470,0,0
14967,2019-04-22,954,0,954,76,1030,1030,0,0
14968,2019-04-22,630,0,630,50,680,0,680,0
14969,2019-04-22,945,0,945,75,1020,1020,0,0
14970,2019-04-22,288,0,288,22,310,310,0,0
14971,2019-04-22,389,0,389,31,420,420,0,0
14972,2019-04-22,399,0,399,31,430,430,0,0
14973,2019-04-22,1260,0,1260,100,1360,1360,0,0
14974,2019-04-22,834,0,834,66,900,900,0,0
14975,2019-04-22,297,0,297,23,320,320,0,0
14976,2019-04-22,1232,0,1232,98,1330,1330,0,0
14977,2019-04-22,436,0,436,34,470,470,0,0
14978,2019-04-22,102,0,102,8,110,110,0,0
14979,2019-04-22,491,0,491,39,530,530,0,0
14980,2019-04-22,945,0,945,75,1020,1020,0,0
14981,2019-04-22,436,0,436,34,470,470,0,0
14982,2019-04-22,667,0,667,53,720,720,0,0
14983,2019-04-22,297,0,297,23,320,320,0,0
14984,2019-04-22,399,0,399,31,430,430,0,0
14985,2019-04-22,2112,0,2112,168,2280,0,2280,0
14986,2019-04-22,167,0,167,13,180,180,0,0
14987,2019-04-22,1075,0,1075,85,1160,1160,0,0
14988,2019-04-22,371,0,371,29,400,400,0,0
14989,2019-04-22,315,0,315,25,340,340,0,0
14990,2019-04-22,769,0,769,61,830,830,0,0
14991,2019-04-22,1315,0,1315,105,1420,1420,0,0
14992,2019-04-22,1815,0,1815,145,1960,1960,0,0
14993,2019-04-22,445,0,445,35,480,480,0,0
14994,2019-04-22,102,0,102,8,110,110,0,0
14995,2019-04-22,2112,0,2112,168,2280,2280,0,0
14996,2019-04-22,417,0,417,33,450,450,0,0
14997,2019-04-22,1288,0,1288,102,1390,1390,0,0
14998,2019-04-22,232,0,232,18,250,250,0,0
14999,2019-04-22,547,0,547,43,590,590,0,0
15000,2019-04-22,213,0,213,17,230,230,0,0
15001,2019-04-22,741,0,741,59,800,800,0,0
15002,2019-04-22,47,0,47,3,50,50,0,0
15003,2019-04-22,675,0,675,45,720,720,0,0
15004,2019-04-22,547,0,547,43,590,590,0,0
15005,2019-04-22,482,0,482,38,520,520,0,0
15006,2019-04-22,232,0,232,18,250,250,0,0
15007,2019-04-22,834,0,834,66,900,900,0,0
15008,2019-04-22,760,0,760,60,820,820,0,0
15009,2019-04-22,1575,0,1575,125,1700,1700,0,0
15010,2019-04-22,269,0,269,21,290,290,0,0
15011,2019-04-22,473,0,473,37,510,510,0,0
15012,2019-04-22,1426,0,1426,114,1540,1540,0,0
15013,2019-04-22,751,0,751,59,810,810,0,0
15014,2019-04-22,269,0,269,21,290,290,0,0
15015,2019-04-22,547,0,547,43,590,590,0,0
15016,2019-04-22,473,0,473,37,510,510,0,0
15017,2019-04-22,3119,0,3119,231,3350,0,3350,0
15018,2019-04-22,723,0,723,57,780,780,0,0
15019,2019-04-22,769,0,769,61,830,830,0,0
15020,2019-04-22,343,0,343,27,370,370,0,0
15021,2019-04-22,297,0,297,23,320,320,0,0
15022,2019-04-22,380,0,380,30,410,410,0,0
15023,2019-04-22,167,0,167,13,180,180,0,0
15024,2019-04-22,250,0,250,20,270,270,0,0
15025,2019-04-22,320,-68,252,20,272,272,0,0
15026,2019-04-22,501,0,501,39,540,540,0,0
15027,2019-04-22,1251,0,1251,99,1350,1350,0,0
15028,2019-04-22,982,0,982,78,1060,1060,0,0
15029,2019-04-22,278,0,278,22,300,300,0,0
15030,2019-04-22,1630,0,1630,130,1760,1760,0,0
15031,2019-04-22,204,0,204,16,220,220,0,0
15032,2019-04-22,200,0,200,15,215,215,0,0
15033,2019-04-23,889,0,889,71,960,960,0,0
15034,2019-04-23,1047,0,1047,83,1130,1130,0,0
15035,2019-04-23,269,0,269,21,290,290,0,0
15036,2019-04-23,852,0,852,68,920,920,0,0
15037,2019-04-23,260,0,260,20,280,280,0,0
15038,2019-04-23,436,0,436,34,470,470,0,0
15039,2019-04-23,528,0,528,42,570,570,0,0
15040,2019-04-23,408,0,408,32,440,440,0,0
15041,2019-04-23,852,0,852,68,920,920,0,0
15042,2019-04-23,843,0,843,67,910,0,910,0
15043,2019-04-23,260,0,260,20,280,280,0,0
15044,2019-04-23,389,0,389,31,420,420,0,0
15045,2019-04-23,241,0,241,19,260,260,0,0
15046,2019-04-23,658,0,658,52,710,710,0,0
15047,2019-04-23,1019,0,1019,81,1100,1100,0,0
15048,2019-04-23,417,0,417,33,450,450,0,0
15049,2019-04-23,1389,0,1389,111,1500,1500,0,0
15050,2019-04-23,93,0,93,7,100,100,0,0
15051,2019-04-23,1380,0,1380,110,1490,1490,0,0
15052,2019-04-23,315,0,315,25,340,340,0,0
15053,2019-04-23,399,0,399,31,430,430,0,0
15054,2019-04-23,473,0,473,37,510,510,0,0
15055,2019-04-23,3352,0,3352,268,3620,3620,0,0
15056,2019-04-23,917,0,917,73,990,990,0,0
15057,2019-04-23,1065,0,1065,85,1150,1150,0,0
15058,2019-04-23,1112,0,1112,88,1200,0,1200,0
15059,2019-04-23,917,0,917,73,990,990,0,0
15060,2019-04-23,638,0,638,42,680,680,0,0
15061,2019-04-23,315,0,315,25,340,340,0,0
15062,2019-04-23,850,0,850,50,900,900,0,0
15063,2019-04-23,601,0,601,39,640,640,0,0
15064,2019-04-23,658,0,658,52,710,710,0,0
15065,2019-04-23,1158,0,1158,92,1250,1250,0,0
15066,2019-04-23,288,0,288,22,310,310,0,0
15067,2019-04-23,351,0,351,19,370,370,0,0
15068,2019-04-23,982,0,982,78,1060,1060,0,0
15069,2019-04-23,862,0,862,68,930,930,0,0
15070,2019-04-23,741,0,741,59,800,800,0,0
15071,2019-04-23,630,0,630,50,680,680,0,0
15072,2019-04-23,260,0,260,20,280,280,0,0
15073,2019-04-23,204,0,204,16,220,220,0,0
15074,2019-04-24,575,0,575,45,620,620,0,0
15075,2019-04-24,908,0,908,72,980,980,0,0
15076,2019-04-24,1223,0,1223,97,1320,1320,0,0
15077,2019-04-24,1815,0,1815,145,1960,1960,0,0
15078,2019-04-24,473,0,473,37,510,510,0,0
15079,2019-04-24,547,0,547,43,590,590,0,0
15080,2019-04-24,417,0,417,33,450,450,0,0
15081,2019-04-24,463,0,463,37,500,500,0,0
15082,2019-04-24,621,0,621,49,670,670,0,0
15083,2019-04-24,649,0,649,51,700,700,0,0
15084,2019-04-24,527,0,527,33,560,560,0,0
15085,2019-04-24,352,0,352,28,380,380,0,0
15086,2019-04-24,751,0,751,59,810,810,0,0
15087,2019-04-24,778,0,778,62,840,840,0,0
15088,2019-04-24,454,0,454,36,490,490,0,0
15089,2019-04-24,2232,0,2232,178,2410,2410,0,0
15090,2019-04-24,510,0,510,40,550,550,0,0
15091,2019-04-24,1741,0,1741,139,1880,1880,0,0
15092,2019-04-24,445,0,445,35,480,480,0,0
15093,2019-04-24,482,0,482,38,520,520,0,0
15094,2019-04-24,1315,0,1315,105,1420,1420,0,0
15095,2019-04-24,704,0,704,56,760,760,0,0
15096,2019-04-24,463,0,463,37,500,500,0,0
15097,2019-04-24,501,0,501,39,540,540,0,0
15098,2019-04-24,176,0,176,14,190,190,0,0
15099,2019-04-24,241,0,241,19,260,260,0,0
15100,2019-04-24,538,0,538,42,580,580,0,0
15101,2019-04-24,510,0,510,40,550,550,0,0
15102,2019-04-24,778,0,778,62,840,840,0,0
15103,2019-04-24,223,0,223,17,240,240,0,0
15104,2019-04-24,426,0,426,34,460,460,0,0
15105,2019-04-24,325,0,325,25,350,350,0,0
15106,2019-04-24,380,0,380,30,410,410,0,0
15107,2019-04-24,908,0,908,72,980,980,0,0
15108,2019-04-24,112,0,112,8,120,120,0,0
15109,2019-04-24,1871,0,1871,149,2020,2020,0,0
15110,2019-04-24,269,0,269,21,290,290,0,0
15111,2019-04-24,482,0,482,38,520,520,0,0
15112,2019-04-24,751,0,751,59,810,810,0,0
15113,2019-04-24,649,0,649,51,700,700,0,0
15114,2019-04-24,612,0,612,48,660,660,0,0
15115,2019-04-24,806,0,806,64,870,870,0,0
15116,2019-04-24,667,0,667,53,720,720,0,0
15117,2019-04-24,769,0,769,61,830,830,0,0
15118,2019-04-24,1149,0,1149,91,1240,1240,0,0
15119,2019-04-24,1149,0,1149,91,1240,1240,0,0
15120,2019-04-24,538,0,538,42,580,580,0,0
15121,2019-04-24,649,0,649,51,700,700,0,0
15122,2019-04-24,788,0,788,62,850,850,0,0
15123,2019-04-24,2362,0,2362,188,2550,2550,0,0
15124,2019-04-24,788,0,788,62,850,850,0,0
15125,2019-04-24,343,0,343,27,370,370,0,0
15126,2019-04-24,2362,0,2362,188,2550,2550,0,0
15127,2019-04-24,445,0,445,35,480,480,0,0
15128,2019-04-24,788,0,788,62,850,850,0,0
15129,2019-04-24,241,0,241,19,260,260,0,0
15130,2019-04-24,408,0,408,32,440,440,0,0
15131,2019-04-24,1186,0,1186,94,1280,1280,0,0
15132,2019-04-24,2148,0,2148,162,2310,2310,0,0
15133,2019-04-24,454,0,454,36,490,490,0,0
15134,2019-04-24,908,0,908,72,980,980,0,0
15135,2019-04-24,538,0,538,42,580,580,0,0
15136,2019-04-24,806,0,806,64,870,870,0,0
15137,2019-04-24,908,0,908,72,980,980,0,0
15138,2019-04-24,1158,0,1158,92,1250,1250,0,0
15139,2019-04-24,527,-112,415,33,448,448,0,0
15140,2019-04-24,1186,0,1186,94,1280,1280,0,0
15141,2019-04-24,389,0,389,31,420,420,0,0
15142,2019-04-24,908,0,908,72,980,980,0,0
15143,2019-04-24,1000,0,1000,80,1080,1080,0,0
15144,2019-04-24,815,0,815,65,880,880,0,0
15145,2019-04-24,407,0,407,23,430,430,0,0
15146,2019-04-24,389,0,389,31,420,420,0,0
15147,2019-04-24,334,0,334,26,360,360,0,0
15148,2019-04-24,2760,0,2760,220,2980,2980,0,0
15149,2019-04-24,278,0,278,22,300,300,0,0
15150,2019-04-24,1075,0,1075,85,1160,1160,0,0
15151,2019-04-24,510,0,510,40,550,550,0,0
15152,2019-04-25,1880,0,1880,150,2030,2030,0,0
15153,2019-04-25,371,0,371,29,400,400,0,0
15154,2019-04-25,695,0,695,55,750,750,0,0
15155,2019-04-25,1158,0,1158,92,1250,1250,0,0
15156,2019-04-25,825,0,825,65,890,890,0,0
15157,2019-04-25,815,0,815,65,880,880,0,0
15158,2019-04-25,260,0,260,20,280,280,0,0
15159,2019-04-25,871,0,871,69,940,940,0,0
15160,2019-04-25,1093,0,1093,87,1180,1180,0,0
15161,2019-04-25,1862,0,1862,148,2010,2010,0,0
15162,2019-04-25,871,0,871,69,940,940,0,0
15163,2019-04-25,667,0,667,53,720,720,0,0
15164,2019-04-25,908,0,908,72,980,980,0,0
15165,2019-04-25,565,0,565,45,610,610,0,0
15166,2019-04-25,1297,0,1297,103,1400,1400,0,0
15167,2019-04-25,1334,0,1334,106,1440,1440,0,0
15168,2019-04-25,482,0,482,38,520,520,0,0
15169,2019-04-25,-491,0,-491,-39,-530,-530,0,0
15170,2019-04-25,889,0,889,71,960,960,0,0
15171,2019-04-25,1093,0,1093,87,1180,1180,0,0
15172,2019-04-25,426,0,426,34,460,0,460,0
15173,2019-04-25,491,0,491,39,530,530,0,0
15174,2019-04-25,982,0,982,78,1060,1060,0,0
15175,2019-04-25,1167,0,1167,93,1260,1260,0,0
15176,2019-04-25,982,0,982,78,1060,1060,0,0
15177,2019-04-25,843,0,843,67,910,910,0,0
15178,2019-04-25,389,0,389,31,420,420,0,0
15179,2019-04-25,899,0,899,71,970,970,0,0
15180,2019-04-25,1769,0,1769,141,1910,1910,0,0
15181,2019-04-25,963,0,963,77,1040,1040,0,0
15182,2019-04-25,-371,0,-371,-29,-400,-400,0,0
15183,2019-04-25,213,0,213,17,230,230,0,0
15184,2019-04-25,399,0,399,31,430,430,0,0
15185,2019-04-25,1075,0,1075,85,1160,0,1160,0
15186,2019-04-25,908,0,908,72,980,0,980,0
15187,2019-04-25,306,0,306,24,330,330,0,0
15188,2019-04-25,362,0,362,28,390,390,0,0
15189,2019-04-25,1176,0,1176,94,1270,1270,0,0
15190,2019-04-25,1454,0,1454,116,1570,1570,0,0
15191,2019-04-25,1010,0,1010,80,1090,1090,0,0
15192,2019-04-25,861,0,861,59,920,920,0,0
15193,2019-04-25,908,0,908,72,980,980,0,0
15194,2019-04-25,2010,0,2010,160,2170,2170,0,0
15195,2019-04-25,908,0,908,72,980,980,0,0
15196,2019-04-25,908,0,908,72,980,980,0,0
15197,2019-04-25,786,0,786,54,840,840,0,0
15198,2019-04-25,908,0,908,72,980,980,0,0
15199,2019-04-25,908,0,908,72,980,980,0,0
15200,2019-04-25,110,0,110,0,110,110,0,0
15201,2019-04-25,908,0,908,72,980,980,0,0
15202,2019-04-25,556,0,556,44,600,600,0,0
15203,2019-04-25,732,0,732,58,790,790,0,0
15204,2019-04-25,501,0,501,39,540,540,0,0
15205,2019-04-25,908,0,908,72,980,980,0,0
15206,2019-04-25,278,0,278,22,300,300,0,0
15207,2019-04-25,973,0,973,77,1050,1050,0,0
15208,2019-04-25,445,0,445,35,480,480,0,0
15209,2019-04-25,1102,0,1102,88,1190,1190,0,0
15210,2019-04-25,315,0,315,25,340,340,0,0
15211,2019-04-25,1806,0,1806,144,1950,0,1950,0
15212,2019-04-25,371,0,371,29,400,400,0,0
15213,2019-04-25,741,0,741,59,800,800,0,0
15214,2019-04-25,473,0,473,37,510,510,0,0
15215,2019-04-25,741,0,741,59,800,800,0,0
15216,2019-04-25,686,0,686,54,740,740,0,0
15217,2019-04-25,1028,0,1028,82,1110,1110,0,0
15218,2019-04-25,260,0,260,20,280,280,0,0
15219,2019-04-25,611,0,611,39,650,650,0,0
15220,2019-04-25,260,0,260,20,280,280,0,0
15221,2019-04-25,926,0,926,74,1000,1000,0,0
15222,2019-04-25,564,0,564,36,600,600,0,0
15223,2019-04-25,417,0,417,33,450,450,0,0
15224,2019-04-25,658,0,658,52,710,710,0,0
15225,2019-04-25,538,0,538,42,580,580,0,0
15226,2019-04-25,988,-210,778,62,840,840,0,0
15227,2019-04-25,1084,0,1084,86,1170,1170,0,0
15228,2019-04-25,491,0,491,39,530,530,0,0
15229,2019-04-25,612,0,612,48,660,660,0,0
15230,2019-04-25,269,0,269,21,290,290,0,0
15231,2019-04-25,796,0,796,54,850,850,0,0
15232,2019-04-25,491,0,491,39,530,530,0,0
15233,2019-04-25,899,0,899,71,970,970,0,0
15234,2019-04-25,269,0,269,21,290,290,0,0
15235,2019-04-25,1408,0,1408,112,1520,1520,0,0
15236,2019-04-25,269,0,269,21,290,290,0,0
15237,2019-04-25,417,0,417,33,450,0,450,0
15238,2019-04-25,889,0,889,71,960,960,0,0
15239,2019-04-25,321,0,321,25,346,346,0,0
15240,2019-04-25,889,0,889,71,960,960,0,0
15241,2019-04-25,954,0,954,76,1030,1030,0,0
15242,2019-04-25,612,0,612,48,660,660,0,0
15243,2019-04-25,1575,0,1575,125,1700,1700,0,0
15244,2019-04-25,695,0,695,55,750,750,0,0
15245,2019-04-25,176,0,176,14,190,190,0,0
15246,2019-04-25,371,0,371,29,400,400,0,0
15247,2019-04-25,315,0,315,25,340,340,0,0
15248,2019-04-25,527,0,527,33,560,560,0,0
15249,2019-04-25,528,0,528,42,570,570,0,0
15250,2019-04-25,686,0,686,54,740,740,0,0
15251,2019-04-25,93,0,93,7,100,100,0,0
15252,2019-04-25,834,0,834,66,900,900,0,0
15253,2019-04-25,454,0,454,36,490,490,0,0
15254,2019-04-25,538,0,538,42,580,580,0,0
15255,2019-04-25,315,0,315,25,340,340,0,0
15256,2019-04-25,260,0,260,20,280,280,0,0
15257,2019-04-25,371,0,371,29,400,400,0,0
15258,2019-04-25,1380,0,1380,110,1490,0,1490,0
15259,2019-04-25,3149,0,3149,251,3400,0,3400,0
15260,2019-04-25,481,0,481,29,510,510,0,0
15261,2019-04-25,788,0,788,62,850,850,0,0
15262,2019-04-25,788,0,788,62,850,850,0,0
15263,2019-04-25,1093,0,1093,87,1180,0,1180,0
15264,2019-04-25,0,0,0,0,0,0,0,0
15265,2019-04-25,1639,0,1639,131,1770,1770,0,0
15266,2019-04-25,249,0,249,11,260,260,0,0
15267,2019-04-25,889,0,889,71,960,960,0,0
15268,2019-04-25,2362,0,2362,188,2550,2550,0,0
15269,2019-04-25,852,0,852,68,920,920,0,0
15270,2019-04-25,1093,0,1093,87,1180,1180,0,0
15271,2019-04-25,593,0,593,47,640,640,0,0
15272,2019-04-26,389,0,389,31,420,420,0,0
15273,2019-04-26,388,0,388,22,410,410,0,0
15274,2019-04-26,713,0,713,57,770,770,0,0
15275,2019-04-26,2723,0,2723,217,2940,0,2940,0
15276,2019-04-26,278,0,278,22,300,300,0,0
15277,2019-04-26,908,0,908,72,980,980,0,0
15278,2019-04-26,1621,0,1621,129,1750,1750,0,0
15279,2019-04-26,1241,0,1241,99,1340,1340,0,0
15280,2019-04-26,908,0,908,72,980,980,0,0
15281,2019-04-26,908,0,908,72,980,980,0,0
15282,2019-04-26,908,0,908,72,980,980,0,0
15283,2019-04-26,908,0,908,72,980,980,0,0
15284,2019-04-26,908,0,908,72,980,980,0,0
15285,2019-04-26,815,0,815,65,880,880,0,0
15286,2019-04-26,538,0,538,42,580,580,0,0
15287,2019-04-26,908,0,908,72,980,980,0,0
15288,2019-04-26,871,0,871,69,940,940,0,0
15289,2019-04-26,2723,0,2723,217,2940,2940,0,0
15290,2019-04-26,1815,0,1815,145,1960,1960,0,0
15291,2019-04-26,491,0,491,39,530,530,0,0
15292,2019-04-26,232,0,232,18,250,250,0,0
15293,2019-04-26,862,0,862,68,930,930,0,0
15294,2019-04-26,908,0,908,72,980,980,0,0
15295,2019-04-26,667,0,667,53,720,720,0,0
15296,2019-04-26,1075,0,1075,85,1160,1160,0,0
15297,2019-04-26,501,0,501,39,540,540,0,0
15298,2019-04-26,500,0,500,40,540,540,0,0
15299,2019-04-26,1815,0,1815,145,1960,1960,0,0
15300,2019-04-26,1075,0,1075,85,1160,0,1160,0
15301,2019-04-26,584,0,584,46,630,630,0,0
15302,2019-04-26,325,0,325,25,350,350,0,0
15303,2019-04-26,1732,0,1732,138,1870,1870,0,0
15304,2019-04-26,741,0,741,59,800,800,0,0
15305,2019-04-26,167,0,167,13,180,180,0,0
15306,2019-04-26,542,-58,484,38,522,522,0,0
15307,2019-04-26,584,0,584,46,630,630,0,0
15308,2019-04-26,519,0,519,41,560,0,560,0
15309,2019-04-26,630,0,630,50,680,680,0,0
15310,2019-04-26,408,0,408,32,440,440,0,0
15311,2019-04-26,602,0,602,48,650,650,0,0
15312,2019-04-26,1046,0,1046,74,1120,1120,0,0
15313,2019-04-26,417,0,417,33,450,450,0,0
15314,2019-04-26,1981,0,1981,149,2130,2130,0,0
15315,2019-04-26,945,0,945,75,1020,1020,0,0
15316,2019-04-26,658,0,658,52,710,710,0,0
15317,2019-04-26,908,0,908,72,980,980,0,0
15318,2019-04-26,649,0,649,51,700,700,0,0
15319,2019-04-26,501,0,501,39,540,540,0,0
15320,2019-04-26,1575,0,1575,125,1700,1700,0,0
15321,2019-04-26,473,0,473,37,510,510,0,0
15322,2019-04-26,797,0,797,63,860,860,0,0
15323,2019-04-26,204,0,204,16,220,220,0,0
15324,2019-04-26,908,0,908,72,980,980,0,0
15325,2019-04-26,1473,0,1473,117,1590,1590,0,0
15326,2019-04-26,1815,0,1815,145,1960,1960,0,0
15327,2019-04-26,593,0,593,47,640,640,0,0
15328,2019-04-26,1084,0,1084,86,1170,1170,0,0
15329,2019-04-26,1102,0,1102,88,1190,1190,0,0
15330,2019-04-26,501,0,501,39,540,540,0,0
15331,2019-04-26,362,0,362,28,390,390,0,0
15332,2019-04-26,547,0,547,43,590,590,0,0
15333,2019-04-26,416,0,416,24,440,440,0,0
15334,2019-04-26,556,0,556,44,600,600,0,0
15335,2019-04-26,288,0,288,22,310,310,0,0
15336,2019-04-26,2306,0,2306,184,2490,2490,0,0
15337,2019-04-26,667,0,667,53,720,720,0,0
15338,2019-04-26,3028,0,3028,242,3270,3270,0,0
15339,2019-04-26,1325,0,1325,105,1430,1430,0,0
15340,2019-04-26,1334,0,1334,106,1440,1440,0,0
15341,2019-04-26,2723,0,2723,217,2940,2940,0,0
15342,2019-04-26,1963,0,1963,157,2120,2120,0,0
15343,2019-04-26,1815,0,1815,145,1960,0,1960,0
15344,2019-04-26,1815,0,1815,145,1960,1960,0,0
15345,2019-04-26,362,0,362,28,390,390,0,0
15346,2019-04-26,563,0,563,45,608,608,0,0
15347,2019-04-26,417,0,417,33,450,450,0,0
15348,2019-04-26,417,0,417,33,450,450,0,0
15349,2019-04-26,482,0,482,38,520,520,0,0
15350,2019-04-26,778,0,778,62,840,840,0,0
15351,2019-04-26,490,0,490,30,520,520,0,0
15352,2019-04-26,751,0,751,59,810,810,0,0
15353,2019-04-26,431,0,431,34,465,465,0,0
15354,2019-04-26,501,0,501,39,540,540,0,0
15355,2019-04-26,723,0,723,57,780,780,0,0
15356,2019-04-26,1473,0,1473,117,1590,1590,0,0
15357,2019-04-26,1055,0,1055,75,1130,1130,0,0
15358,2019-04-26,204,0,204,16,220,220,0,0
15359,2019-04-26,278,0,278,22,300,300,0,0
15360,2019-04-26,399,0,399,31,430,430,0,0
15361,2019-04-26,260,0,260,20,280,280,0,0
15362,2019-04-26,908,0,908,72,980,980,0,0
15363,2019-04-26,501,0,501,39,540,540,0,0
15364,2019-04-26,278,0,278,22,300,300,0,0
15365,2019-04-26,139,0,139,11,150,150,0,0
15366,2019-04-26,237,0,237,18,255,255,0,0
15367,2019-04-26,899,0,899,71,970,970,0,0
15368,2019-04-26,820,0,820,65,885,885,0,0
15369,2019-04-26,528,0,528,42,570,570,0,0
15370,2019-04-26,223,0,223,17,240,240,0,0
15371,2019-04-26,278,0,278,22,300,300,0,0
15372,2019-04-26,713,0,713,57,770,770,0,0
15373,2019-04-26,908,0,908,72,980,980,0,0
15374,2019-04-26,445,0,445,35,480,480,0,0
15375,2019-04-26,1908,0,1908,152,2060,2060,0,0
15376,2019-04-26,454,0,454,36,490,490,0,0
15377,2019-04-26,519,0,519,41,560,560,0,0
15378,2019-04-26,649,0,649,51,700,700,0,0
15379,2019-04-26,2251,0,2251,179,2430,2430,0,0
15380,2019-04-26,1055,0,1055,75,1130,1130,0,0
15381,2019-04-26,232,0,232,18,250,250,0,0
15382,2019-04-26,936,0,936,74,1010,1010,0,0
15383,2019-04-26,232,0,232,18,250,250,0,0
15384,2019-04-26,741,0,741,59,800,800,0,0
15385,2019-04-26,315,0,315,25,340,340,0,0
15386,2019-04-26,362,0,362,28,390,390,0,0
15387,2019-04-26,908,0,908,72,980,980,0,0
15388,2019-04-26,2305,0,2305,175,2480,2480,0,0
15389,2019-04-26,1815,0,1815,145,1960,1960,0,0
15390,2019-04-26,-908,0,-908,-72,-980,-980,0,0
15391,2019-04-26,1371,0,1371,109,1480,1480,0,0
15392,2019-04-26,908,0,908,72,980,980,0,0
15393,2019-04-26,908,0,908,72,980,980,0,0
15394,2019-04-26,908,0,908,72,980,980,0,0
15395,2019-04-26,389,0,389,31,420,420,0,0
15396,2019-04-26,2723,0,2723,217,2940,2940,0,0
15397,2019-04-26,908,0,908,72,980,980,0,0
15398,2019-04-26,268,0,268,12,280,280,0,0
15399,2019-04-26,908,0,908,72,980,980,0,0
15400,2019-04-26,269,0,269,21,290,290,0,0
15401,2019-04-26,1815,0,1815,145,1960,1960,0,0
15402,2019-04-26,797,0,797,63,860,860,0,0
15403,2019-04-26,2667,0,2667,213,2880,2880,0,0
15404,2019-04-26,1056,0,1056,84,1140,1140,0,0
15405,2019-04-27,1815,0,1815,145,1960,1960,0,0
15406,2019-04-27,1546,0,1546,114,1660,1660,0,0
15407,2019-04-27,510,0,510,40,550,550,0,0
15408,2019-04-27,1676,0,1676,134,1810,1810,0,0
15409,2019-04-27,139,0,139,11,150,150,0,0
15410,2019-04-27,658,0,658,52,710,710,0,0
15411,2019-04-27,834,0,834,66,900,900,0,0
15412,2019-04-27,936,0,936,74,1010,1010,0,0
15413,2019-04-27,786,0,786,54,840,840,0,0
15414,2019-04-27,1176,0,1176,94,1270,1270,0,0
15415,2019-04-27,1815,0,1815,145,1960,1960,0,0
15416,2019-04-27,2093,0,2093,167,2260,2260,0,0
15417,2019-04-27,1815,0,1815,145,1960,1960,0,0
15418,2019-04-27,1047,0,1047,83,1130,1130,0,0
15419,2019-04-27,425,0,425,25,450,450,0,0
15420,2019-04-27,889,0,889,71,960,960,0,0
15421,2019-04-27,1788,0,1788,142,1930,0,1930,0
15422,2019-04-27,584,0,584,46,630,630,0,0
15423,2019-04-27,334,0,334,26,360,360,0,0
15424,2019-04-27,251,0,251,19,270,270,0,0
15425,2019-04-27,1352,0,1352,108,1460,1460,0,0
15426,2019-04-27,713,0,713,57,770,770,0,0
15427,2019-04-27,501,0,501,39,540,0,540,0
15428,2019-04-27,1815,0,1815,145,1960,0,1960,0
15429,2019-04-27,547,0,547,43,590,590,0,0
15430,2019-04-27,945,0,945,75,1020,1020,0,0
15431,2019-04-27,973,0,973,77,1050,1050,0,0
15432,2019-04-27,371,0,371,29,400,400,0,0
15433,2019-04-27,575,0,575,45,620,620,0,0
15434,2019-04-27,612,0,612,48,660,660,0,0
15435,2019-04-27,250,0,250,20,270,270,0,0
15436,2019-04-27,139,0,139,11,150,150,0,0
15437,2019-04-27,362,0,362,28,390,390,0,0
15438,2019-04-27,204,0,204,16,220,220,0,0
15439,2019-04-27,399,0,399,31,430,430,0,0
15440,2019-04-27,2723,0,2723,217,2940,2940,0,0
15441,2019-04-27,639,0,639,51,690,690,0,0
15442,2019-04-27,602,0,602,48,650,650,0,0
15443,2019-04-27,325,0,325,25,350,350,0,0
15444,2019-04-27,862,0,862,68,930,930,0,0
15445,2019-04-27,1380,0,1380,110,1490,1490,0,0
15446,2019-04-27,1889,0,1889,151,2040,2040,0,0
15447,2019-04-27,908,0,908,72,980,980,0,0
15448,2019-04-27,2204,0,2204,176,2380,2380,0,0
15449,2019-04-27,232,0,232,18,250,250,0,0
15450,2019-04-27,741,0,741,59,800,800,0,0
15451,2019-04-27,399,0,399,31,430,430,0,0
15452,2019-04-27,2723,0,2723,217,2940,2940,0,0
15453,2019-04-27,908,0,908,72,980,980,0,0
15454,2019-04-27,908,0,908,72,980,980,0,0
15455,2019-04-27,749,0,749,51,800,800,0,0
15456,2019-04-27,250,0,250,20,270,270,0,0
15457,2019-04-27,806,0,806,64,870,870,0,0
15458,2019-04-27,1815,0,1815,145,1960,0,1960,0
15459,2019-04-27,389,0,389,31,420,420,0,0
15460,2019-04-27,1815,0,1815,145,1960,1960,0,0
15461,2019-04-27,445,0,445,35,480,480,0,0
15462,2019-04-27,232,0,232,18,250,250,0,0
15463,2019-04-27,852,0,852,68,920,920,0,0
15464,2019-04-27,686,0,686,54,740,740,0,0
15465,2019-04-27,982,0,982,78,1060,1060,0,0
15466,2019-04-27,908,0,908,72,980,980,0,0
15467,2019-04-27,908,0,908,72,980,980,0,0
15468,2019-04-27,139,0,139,11,150,150,0,0
15469,2019-04-27,1167,0,1167,93,1260,0,1260,0
15470,2019-04-27,602,0,602,48,650,650,0,0
15471,2019-04-27,778,0,778,62,840,840,0,0
15472,2019-04-27,1112,0,1112,88,1200,1200,0,0
15473,2019-04-27,686,0,686,54,740,0,740,0
15474,2019-04-27,908,0,908,72,980,980,0,0
15475,2019-04-27,908,0,908,72,980,980,0,0
15476,2019-04-27,788,0,788,62,850,0,850,0
15477,2019-04-27,1102,0,1102,88,1190,1190,0,0
15478,2019-04-27,565,0,565,45,610,610,0,0
15479,2019-04-27,334,0,334,26,360,360,0,0
15480,2019-04-27,815,0,815,65,880,880,0,0
15481,2019-04-27,686,0,686,54,740,740,0,0
15482,2019-04-27,639,0,639,51,690,690,0,0
15483,2019-04-27,1343,0,1343,107,1450,1450,0,0
15484,2019-04-27,1315,0,1315,105,1420,1420,0,0
15485,2019-04-27,417,0,417,33,450,450,0,0
15486,2019-04-27,704,0,704,56,760,760,0,0
15487,2019-04-27,362,0,362,28,390,390,0,0
15488,2019-04-27,1463,0,1463,117,1580,1580,0,0
15489,2019-04-27,2269,0,2269,181,2450,0,2450,0
15490,2019-04-27,167,0,167,13,180,180,0,0
15491,2019-04-27,343,0,343,27,370,370,0,0
15492,2019-04-27,602,0,602,48,650,650,0,0
15493,2019-04-27,889,0,889,71,960,960,0,0
15494,2019-04-27,1713,0,1713,137,1850,1850,0,0
15495,2019-04-27,565,0,565,45,610,610,0,0
15496,2019-04-27,871,0,871,69,940,940,0,0
15497,2019-04-27,612,0,612,48,660,660,0,0
15498,2019-04-27,24,0,24,1,25,25,0,0
15499,2019-04-27,695,0,695,55,750,750,0,0
15500,2019-04-27,732,0,732,58,790,790,0,0
15501,2019-04-27,1778,0,1778,142,1920,1920,0,0
15502,2019-04-27,908,0,908,72,980,980,0,0
15503,2019-04-27,362,0,362,28,390,390,0,0
15504,2019-04-27,751,0,751,59,810,810,0,0
15505,2019-04-27,1657,0,1657,123,1780,1780,0,0
15506,2019-04-27,269,0,269,21,290,0,290,0
15507,2019-04-27,389,0,389,31,420,420,0,0
15508,2019-04-27,213,0,213,17,230,230,0,0
15509,2019-04-27,362,0,362,28,390,390,0,0
15510,2019-04-27,269,0,269,21,290,290,0,0
15511,2019-04-27,704,0,704,56,760,760,0,0
15512,2019-04-27,547,0,547,43,590,590,0,0
15513,2019-04-27,723,0,723,57,780,780,0,0
15514,2019-04-27,501,0,501,39,540,540,0,0
15515,2019-04-27,593,0,593,47,640,640,0,0
15516,2019-04-27,1621,0,1621,129,1750,1750,0,0
15517,2019-04-27,1269,0,1269,101,1370,1370,0,0
15518,2019-04-27,2723,0,2723,217,2940,2940,0,0
15519,2019-04-27,639,0,639,51,690,690,0,0
15520,2019-04-27,908,0,908,72,980,980,0,0
15521,2019-04-27,1815,0,1815,145,1960,1960,0,0
15522,2019-04-27,825,0,825,65,890,890,0,0
15523,2019-04-27,1149,0,1149,91,1240,1240,0,0
15524,2019-04-27,862,0,862,68,930,930,0,0
15525,2019-04-27,1343,0,1343,107,1450,0,1450,0
15526,2019-04-27,343,0,343,27,370,370,0,0
15527,2019-04-27,1621,0,1621,129,1750,1750,0,0
15528,2019-04-27,269,0,269,21,290,290,0,0
15529,2019-04-27,426,0,426,34,460,460,0,0
15530,2019-04-27,399,0,399,31,430,430,0,0
15531,2019-04-27,1056,0,1056,84,1140,1140,0,0
15532,2019-04-27,760,0,760,60,820,820,0,0
15533,2019-04-27,899,0,899,71,970,970,0,0
15534,2019-04-27,315,0,315,25,340,340,0,0
15535,2019-04-27,195,0,195,15,210,210,0,0
15536,2019-04-27,278,0,278,22,300,300,0,0
15537,2019-04-27,862,0,862,68,930,930,0,0
15538,2019-04-27,167,0,167,13,180,180,0,0
15539,2019-04-27,204,0,204,16,220,220,0,0
15540,2019-04-27,482,0,482,38,520,520,0,0
15541,2019-04-27,491,0,491,39,530,530,0,0
15542,2019-04-27,1084,0,1084,86,1170,1170,0,0
15543,2019-04-27,370,0,370,20,390,390,0,0
15544,2019-04-27,981,0,981,69,1050,1050,0,0
15545,2019-04-27,851,0,851,59,910,910,0,0
15546,2019-04-27,769,0,769,61,830,830,0,0
15547,2019-04-27,1232,0,1232,98,1330,1330,0,0
15548,2019-04-27,547,0,547,43,590,590,0,0
15549,2019-04-27,1454,0,1454,116,1570,1570,0,0
15550,2019-04-27,1241,0,1241,99,1340,1340,0,0
15551,2019-04-27,3630,0,3630,290,3920,3920,0,0
15552,2019-04-27,1371,0,1371,109,1480,1480,0,0
15553,2019-04-27,741,0,741,59,800,800,0,0
15554,2019-04-27,917,0,917,73,990,990,0,0
15555,2019-04-27,426,0,426,34,460,460,0,0
15556,2019-04-27,454,0,454,36,490,490,0,0
15557,2019-04-27,1815,0,1815,145,1960,0,1960,0
15558,2019-04-27,325,0,325,25,350,350,0,0
15559,2019-04-27,352,0,352,28,380,380,0,0
15560,2019-04-27,639,0,639,51,690,690,0,0
15561,2019-04-27,769,0,769,61,830,830,0,0
15562,2019-04-27,139,0,139,11,150,150,0,0
15563,2019-04-27,1445,0,1445,115,1560,1560,0,0
15564,2019-04-27,463,0,463,37,500,500,0,0
15565,2019-04-27,426,0,426,34,460,460,0,0
15566,2019-04-27,436,0,436,34,470,470,0,0
15567,2019-04-27,538,0,538,42,580,580,0,0
15568,2019-04-27,232,0,232,18,250,250,0,0
15569,2019-04-27,556,0,556,44,600,600,0,0
15570,2019-04-27,788,0,788,62,850,850,0,0
15571,2019-04-27,573,0,573,37,610,610,0,0
15572,2019-04-27,1158,0,1158,92,1250,0,1250,0
15573,2019-04-27,639,0,639,51,690,690,0,0
15574,2019-04-27,315,0,315,25,340,340,0,0
15575,2019-04-27,1278,0,1278,102,1380,1380,0,0
15576,2019-04-27,436,0,436,34,470,470,0,0
15577,2019-04-27,1760,0,1760,140,1900,1900,0,0
15578,2019-04-27,602,0,602,48,650,650,0,0
15579,2019-04-27,704,0,704,56,760,760,0,0
15580,2019-04-27,982,0,982,78,1060,1060,0,0
15581,2019-04-27,2723,0,2723,217,2940,2940,0,0
15582,2019-04-27,908,0,908,72,980,980,0,0
15583,2019-04-27,880,0,880,70,950,950,0,0
15584,2019-04-27,991,0,991,79,1070,1070,0,0
15585,2019-04-27,908,0,908,72,980,980,0,0
15586,2019-04-27,1371,0,1371,109,1480,1480,0,0
15587,2019-04-27,732,0,732,58,790,790,0,0
15588,2019-04-27,584,0,584,46,630,630,0,0
15589,2019-04-27,1001,0,1001,79,1080,1080,0,0
15590,2019-04-27,1047,0,1047,83,1130,1130,0,0
15591,2019-04-27,871,0,871,69,940,940,0,0
15592,2019-04-27,251,0,251,19,270,270,0,0
15593,2019-04-27,1815,0,1815,145,1960,0,1960,0
15594,2019-04-27,1436,0,1436,114,1550,0,1550,0
15595,2019-04-27,1815,0,1815,145,1960,1960,0,0
15596,2019-04-27,139,0,139,11,150,150,0,0
15597,2019-04-27,473,0,473,37,510,0,510,0
15598,2019-04-27,1612,0,1612,128,1740,1740,0,0
15599,2019-04-27,538,0,538,42,580,580,0,0
15600,2019-04-27,-370,0,-370,-30,-400,-400,0,0
15601,2019-04-27,751,0,751,59,810,810,0,0
15602,2019-04-27,1149,0,1149,91,1240,1240,0,0
15603,2019-04-27,547,0,547,43,590,590,0,0
15604,2019-04-27,575,0,575,45,620,620,0,0
15605,2019-04-27,732,0,732,58,790,790,0,0
15606,2019-04-27,1352,0,1352,108,1460,1460,0,0
15607,2019-04-27,1815,0,1815,145,1960,1960,0,0
15608,2019-04-27,3288,0,3288,262,3550,3550,0,0
15609,2019-04-27,1815,0,1815,145,1960,1960,0,0
15610,2019-04-27,3112,0,3112,248,3360,3360,0,0
15611,2019-04-27,778,0,778,62,840,840,0,0
15612,2019-04-27,2723,0,2723,217,2940,2940,0,0
15613,2019-04-27,519,0,519,41,560,560,0,0
15614,2019-04-27,565,0,565,45,610,610,0,0
15615,2019-04-27,630,0,630,50,680,680,0,0
15616,2019-04-27,519,0,519,41,560,560,0,0
15617,2019-04-27,1862,0,1862,148,2010,2010,0,0
15618,2019-04-27,482,0,482,38,520,520,0,0
15619,2019-04-27,399,0,399,31,430,430,0,0
15620,2019-04-27,232,0,232,18,250,250,0,0
15621,2019-04-27,325,0,325,25,350,350,0,0
15622,2019-04-27,612,0,612,48,660,660,0,0
15623,2019-04-27,723,0,723,57,780,780,0,0
15624,2019-04-27,1936,0,1936,154,2090,2090,0,0
15625,2019-04-27,288,0,288,22,310,310,0,0
15626,2019-04-27,288,0,288,22,310,310,0,0
15627,2019-04-27,1112,0,1112,88,1200,1200,0,0
15628,2019-04-27,1815,0,1815,145,1960,1960,0,0
15629,2019-04-27,325,0,325,25,350,350,0,0
15630,2019-04-27,482,0,482,38,520,520,0,0
15631,2019-04-27,1899,0,1899,151,2050,2050,0,0
15632,2019-04-27,1223,0,1223,97,1320,1320,0,0
15633,2019-04-27,704,0,704,56,760,0,760,0
15634,2019-04-27,926,0,926,74,1000,1000,0,0
15635,2019-04-27,1498,0,1498,102,1600,1600,0,0
15636,2019-04-27,510,0,510,40,550,550,0,0
15637,2019-04-28,445,0,445,35,480,480,0,0
15638,2019-04-28,908,0,908,72,980,980,0,0
15639,2019-04-28,223,0,223,17,240,240,0,0
15640,2019-04-28,2028,0,2028,162,2190,2190,0,0
15641,2019-04-28,1157,0,1157,83,1240,1240,0,0
15642,2019-04-28,880,0,880,70,950,950,0,0
15643,2019-04-28,399,0,399,31,430,430,0,0
15644,2019-04-28,908,0,908,72,980,980,0,0
15645,2019-04-28,908,0,908,72,980,980,0,0
15646,2019-04-28,685,0,685,45,730,730,0,0
15647,2019-04-28,630,0,630,50,680,680,0,0
15648,2019-04-28,8334,0,8334,666,9000,9000,0,0
15649,2019-04-28,380,0,380,30,410,410,0,0
15650,2019-04-28,445,0,445,35,480,480,0,0
15651,2019-04-28,908,0,908,72,980,980,0,0
15652,2019-04-28,917,0,917,73,990,990,0,0
15653,2019-04-28,482,0,482,38,520,520,0,0
15654,2019-04-28,269,0,269,21,290,290,0,0
15655,2019-04-28,2028,0,2028,162,2190,2190,0,0
15656,2019-04-28,723,0,723,57,780,780,0,0
15657,2019-04-28,1723,0,1723,137,1860,1860,0,0
15658,2019-04-28,2047,0,2047,163,2210,2210,0,0
15659,2019-04-28,325,0,325,25,350,350,0,0
15660,2019-04-28,3046,0,3046,234,3280,3280,0,0
15661,2019-04-28,713,0,713,57,770,770,0,0
15662,2019-04-28,686,0,686,54,740,740,0,0
15663,2019-04-28,1306,0,1306,104,1410,1410,0,0
15664,2019-04-28,1452,0,1452,98,1550,1550,0,0
15665,2019-04-28,260,0,260,20,280,280,0,0
15666,2019-04-28,232,0,232,18,250,250,0,0
15667,2019-04-28,4102,0,4102,328,4430,4430,0,0
15668,2019-04-28,1769,0,1769,141,1910,1910,0,0
15669,2019-04-28,851,0,851,59,910,910,0,0
15670,2019-04-28,908,0,908,72,980,980,0,0
15671,2019-04-28,908,0,908,72,980,980,0,0
15672,2019-04-28,1056,0,1056,84,1140,1140,0,0
15673,2019-04-28,815,0,815,65,880,880,0,0
15674,2019-04-28,2426,0,2426,194,2620,2620,0,0
15675,2019-04-28,1815,0,1815,145,1960,1960,0,0
15676,2019-04-28,1760,0,1760,140,1900,1900,0,0
15677,2019-04-28,713,0,713,57,770,770,0,0
15678,2019-04-28,1176,0,1176,94,1270,1270,0,0
15679,2019-04-28,260,0,260,20,280,280,0,0
15680,2019-04-28,908,0,908,72,980,980,0,0
15681,2019-04-28,306,0,306,24,330,330,0,0
15682,2019-04-28,1815,0,1815,145,1960,1960,0,0
15683,2019-04-28,565,0,565,45,610,610,0,0
15684,2019-04-28,1815,0,1815,145,1960,1960,0,0
15685,2019-04-28,584,0,584,46,630,630,0,0
15686,2019-04-28,453,0,453,27,480,480,0,0
15687,2019-04-28,945,0,945,75,1020,1020,0,0
15688,2019-04-28,834,0,834,66,900,900,0,0
15689,2019-04-28,1158,0,1158,92,1250,1250,0,0
15690,2019-04-28,102,0,102,8,110,110,0,0
15691,2019-04-28,482,0,482,38,520,520,0,0
15692,2019-04-28,1760,0,1760,140,1900,1900,0,0
15693,2019-04-28,908,0,908,72,980,980,0,0
15694,2019-04-28,1084,0,1084,86,1170,1170,0,0
15695,2019-04-28,936,0,936,74,1010,1010,0,0
15696,2019-04-28,871,0,871,69,940,940,0,0
15697,2019-04-28,547,0,547,43,590,590,0,0
15698,2019-04-28,1639,0,1639,131,1770,1770,0,0
15699,2019-04-28,926,0,926,74,1000,1000,0,0
15700,2019-04-28,1815,0,1815,145,1960,1960,0,0
15701,2019-04-28,695,0,695,55,750,750,0,0
15702,2019-04-28,797,0,797,63,860,860,0,0
15703,2019-04-28,1269,0,1269,101,1370,1370,0,0
15704,2019-04-28,212,0,212,8,220,220,0,0
15705,2019-04-28,2454,0,2454,196,2650,2650,0,0
15706,2019-04-28,862,0,862,68,930,930,0,0
15707,2019-04-28,491,0,491,39,530,530,0,0
15708,2019-04-28,547,0,547,43,590,590,0,0
15709,2019-04-28,908,0,908,72,980,980,0,0
15710,2019-04-28,908,0,908,72,980,980,0,0
15711,2019-04-28,232,0,232,18,250,250,0,0
15712,2019-04-28,436,0,436,34,470,470,0,0
15713,2019-04-28,1306,0,1306,104,1410,0,1410,0
15714,2019-04-28,806,0,806,64,870,870,0,0
15715,2019-04-28,908,0,908,72,980,980,0,0
15716,2019-04-28,695,0,695,55,750,750,0,0
15717,2019-04-28,167,0,167,13,180,180,0,0
15718,2019-04-28,167,0,167,13,180,180,0,0
15719,2019-04-28,1973,0,1973,157,2130,2130,0,0
15720,2019-04-28,741,0,741,59,800,800,0,0
15721,2019-04-28,1204,0,1204,96,1300,1300,0,0
15722,2019-04-28,630,0,630,50,680,680,0,0
15723,2019-04-28,713,0,713,57,770,770,0,0
15724,2019-04-28,473,0,473,37,510,510,0,0
15725,2019-04-28,232,0,232,18,250,250,0,0
15726,2019-04-28,723,0,723,57,780,780,0,0
15727,2019-04-28,260,0,260,20,280,280,0,0
15728,2019-04-28,908,0,908,72,980,980,0,0
15729,2019-04-28,371,0,371,29,400,400,0,0
15730,2019-04-28,232,0,232,18,250,250,0,0
15731,2019-04-28,1815,0,1815,145,1960,1960,0,0
15732,2019-04-28,1621,0,1621,129,1750,1750,0,0
15733,2019-04-28,1751,0,1751,139,1890,1890,0,0
15734,2019-04-28,-491,0,-491,-39,-530,-530,0,0
15735,2019-04-28,584,0,584,46,630,630,0,0
15736,2019-04-28,510,0,510,40,550,550,0,0
15737,2019-04-28,1019,0,1019,81,1100,1100,0,0
15738,2019-04-28,528,0,528,42,570,570,0,0
15739,2019-04-28,2954,0,2954,236,3190,3190,0,0
15740,2019-04-28,510,0,510,40,550,550,0,0
15741,2019-04-28,482,0,482,38,520,520,0,0
15742,2019-04-28,1510,0,1510,120,1630,1630,0,0
15743,2019-04-28,667,0,667,53,720,720,0,0
15744,2019-04-28,658,0,658,52,710,710,0,0
15745,2019-04-28,352,0,352,28,380,380,0,0
15746,2019-04-28,806,0,806,64,870,870,0,0
15747,2019-04-28,908,0,908,72,980,980,0,0
15748,2019-04-28,908,0,908,72,980,980,0,0
15749,2019-04-28,584,0,584,46,630,630,0,0
15750,2019-04-28,482,0,482,38,520,520,0,0
15751,2019-04-28,538,0,538,42,580,580,0,0
15752,2019-04-28,1454,0,1454,116,1570,1570,0,0
15753,2019-04-28,751,0,751,59,810,810,0,0
15754,2019-04-28,649,0,649,51,700,700,0,0
15755,2019-04-28,908,0,908,72,980,980,0,0
15756,2019-04-28,908,0,908,72,980,980,0,0
15757,2019-04-28,269,0,269,21,290,290,0,0
15758,2019-04-28,1038,0,1038,82,1120,1120,0,0
15759,2019-04-28,621,0,621,49,670,670,0,0
15760,2019-04-28,288,0,288,22,310,310,0,0
15761,2019-04-28,1639,0,1639,131,1770,1770,0,0
15762,2019-04-28,250,0,250,20,270,270,0,0
15763,2019-04-28,649,0,649,51,700,700,0,0
15764,2019-04-28,1269,0,1269,101,1370,1370,0,0
15765,2019-04-28,501,0,501,39,540,540,0,0
15766,2019-04-28,334,0,334,26,360,360,0,0
15767,2019-04-28,1815,0,1815,145,1960,0,1960,0
15768,2019-04-28,260,0,260,20,280,280,0,0
15769,2019-04-28,834,0,834,66,900,900,0,0
15770,2019-04-28,3630,0,3630,290,3920,3920,0,0
15771,2019-04-28,1204,0,1204,96,1300,1300,0,0
15772,2019-04-28,1815,0,1815,145,1960,1960,0,0
15773,2019-04-28,1306,0,1306,104,1410,1410,0,0
15774,2019-04-28,2325,0,2325,185,2510,2510,0,0
15775,2019-04-28,723,0,723,57,780,780,0,0
15776,2019-04-28,1352,0,1352,108,1460,1460,0,0
15777,2019-04-28,1676,0,1676,134,1810,1810,0,0
15778,2019-04-28,278,0,278,22,300,0,300,0
15779,2019-04-28,417,0,417,33,450,450,0,0
15780,2019-04-28,473,0,473,37,510,510,0,0
15781,2019-04-28,639,0,639,51,690,690,0,0
15782,2019-04-28,112,0,112,8,120,120,0,0
15783,2019-04-28,741,0,741,59,800,800,0,0
15784,2019-04-28,1277,0,1277,93,1370,1370,0,0
15785,2019-04-28,417,0,417,33,450,450,0,0
15786,2019-04-28,315,0,315,25,340,340,0,0
15787,2019-04-28,388,0,388,22,410,410,0,0
15788,2019-04-28,1112,0,1112,88,1200,1200,0,0
15789,2019-04-28,426,0,426,34,460,0,460,0
15790,2019-04-28,862,0,862,68,930,930,0,0
15791,2019-04-28,379,0,379,21,400,400,0,0
15792,2019-04-28,908,0,908,72,980,980,0,0
15793,2019-04-28,862,0,862,68,930,930,0,0
15794,2019-04-28,232,0,232,18,250,250,0,0
15795,2019-04-28,278,0,278,22,300,300,0,0
15796,2019-04-28,973,0,973,77,1050,1050,0,0
15797,2019-04-28,260,0,260,20,280,280,0,0
15798,2019-04-28,297,0,297,23,320,320,0,0
15799,2019-04-28,1352,0,1352,108,1460,1460,0,0
15800,2019-04-28,658,0,658,52,710,710,0,0
15801,2019-04-28,362,0,362,28,390,390,0,0
15802,2019-04-28,297,0,297,23,320,320,0,0
15803,2019-04-28,528,0,528,42,570,570,0,0
15804,2019-04-28,362,0,362,28,390,390,0,0
15805,2019-04-28,555,0,555,35,590,590,0,0
15806,2019-04-28,769,0,769,61,830,830,0,0
15807,2019-04-28,399,0,399,31,430,430,0,0
15808,2019-04-28,371,0,371,29,400,400,0,0
15809,2019-04-28,723,0,723,57,780,780,0,0
15810,2019-04-28,1149,0,1149,91,1240,1240,0,0
15811,2019-04-28,251,0,251,19,270,270,0,0
15812,2019-04-28,593,0,593,47,640,640,0,0
15813,2019-04-28,251,0,251,19,270,270,0,0
15814,2019-04-28,288,0,288,22,310,310,0,0
15815,2019-04-28,425,0,425,25,450,450,0,0
15816,2019-04-28,445,0,445,35,480,480,0,0
15817,2019-04-28,306,0,306,24,330,330,0,0
15818,2019-04-28,510,0,510,40,550,550,0,0
15819,2019-04-28,1278,0,1278,102,1380,1380,0,0
15820,2019-04-28,297,0,297,23,320,320,0,0
15821,2019-04-28,278,0,278,22,300,300,0,0
15822,2019-04-28,288,0,288,22,310,310,0,0
15823,2019-04-28,334,0,334,26,360,360,0,0
15824,2019-04-28,2260,0,2260,180,2440,2440,0,0
15825,2019-04-28,352,0,352,28,380,380,0,0
15826,2019-04-28,1019,0,1019,81,1100,1100,0,0
15827,2019-04-28,260,0,260,20,280,280,0,0
15828,2019-04-28,814,0,814,56,870,870,0,0
15829,2019-04-28,751,0,751,59,810,810,0,0
15830,2019-04-28,241,0,241,19,260,260,0,0
15831,2019-04-28,630,0,630,50,680,680,0,0
15832,2019-04-28,1297,0,1297,103,1400,1400,0,0
15833,2019-04-28,325,0,325,25,350,350,0,0
15834,2019-04-28,213,0,213,17,230,230,0,0
15835,2019-04-28,575,0,575,45,620,620,0,0
15836,2019-04-28,399,0,399,31,430,430,0,0
15837,2019-04-28,399,0,399,31,430,430,0,0
15838,2019-04-28,491,0,491,39,530,530,0,0
15839,2019-04-28,389,0,389,31,420,420,0,0
15840,2019-04-28,917,0,917,73,990,990,0,0
15841,2019-04-28,990,0,990,70,1060,1060,0,0
15842,2019-04-28,510,0,510,40,550,550,0,0
15843,2019-04-28,1185,0,1185,85,1270,1270,0,0
15844,2019-04-28,1047,0,1047,83,1130,1130,0,0
15845,2019-04-28,139,0,139,11,150,150,0,0
15846,2019-04-28,47,0,47,3,50,50,0,0
15847,2019-04-28,1222,0,1222,88,1310,1310,0,0
15848,2019-04-28,2083,0,2083,157,2240,2240,0,0
15849,2019-04-28,445,0,445,35,480,480,0,0
15850,2019-04-28,1871,0,1871,149,2020,0,2020,0
15851,2019-04-28,760,0,760,60,820,820,0,0
15852,2019-04-28,167,0,167,13,180,180,0,0
15853,2019-04-28,1815,0,1815,145,1960,1960,0,0
15854,2019-04-28,315,0,315,25,340,340,0,0
15855,2019-04-28,463,0,463,37,500,500,0,0
15856,2019-04-28,278,0,278,22,300,300,0,0
15857,2019-04-28,1064,0,1064,76,1140,1140,0,0
15858,2019-04-28,473,0,473,37,510,0,510,0
15859,2019-04-28,963,0,963,77,1040,1040,0,0
15860,2019-04-28,2102,0,2102,168,2270,2270,0,0
15861,2019-04-28,926,0,926,74,1000,1000,0,0
15862,2019-04-28,1815,0,1815,145,1960,1960,0,0
15863,2019-04-28,1047,0,1047,83,1130,1130,0,0
15864,2019-04-28,186,0,186,14,200,200,0,0
15865,2019-04-28,7260,0,7260,580,7840,0,7840,0
15866,2019-04-28,1945,0,1945,155,2100,2100,0,0
15867,2019-04-28,139,0,139,11,150,150,0,0
15868,2019-04-28,1815,0,1815,145,1960,1960,0,0
15869,2019-04-28,1389,0,1389,111,1500,1500,0,0
15870,2019-04-28,380,0,380,30,410,410,0,0
15871,2019-04-28,2084,0,2084,166,2250,2250,0,0
15872,2019-04-28,769,0,769,61,830,830,0,0
15873,2019-04-28,1815,0,1815,145,1960,1960,0,0
15874,2019-04-28,1815,0,1815,145,1960,1960,0,0
15875,2019-04-28,2778,0,2778,222,3000,3000,0,0
15876,2019-04-28,519,0,519,41,560,560,0,0
15877,2019-04-28,1815,0,1815,145,1960,1960,0,0
15878,2019-04-28,1112,0,1112,88,1200,1200,0,0
15879,2019-04-28,1815,0,1815,145,1960,1960,0,0
15880,2019-04-28,862,0,862,68,930,930,0,0
15881,2019-04-28,1815,0,1815,145,1960,1960,0,0
15882,2019-04-28,1815,0,1815,145,1960,0,1960,0
15883,2019-04-28,584,0,584,46,630,630,0,0
15884,2019-04-28,176,0,176,14,190,190,0,0
15885,2019-04-28,1297,0,1297,103,1400,1400,0,0
15886,2019-04-28,1815,0,1815,145,1960,1960,0,0
15887,2019-04-28,47,0,47,3,50,50,0,0
15888,2019-04-28,3120,0,3120,240,3360,0,3360,0
15889,2019-04-28,306,0,306,24,330,330,0,0
15890,2019-04-28,850,0,850,50,900,900,0,0
15891,2019-04-28,806,0,806,64,870,870,0,0
15892,2019-04-28,362,0,362,28,390,390,0,0
15893,2019-04-28,556,0,556,44,600,600,0,0
15894,2019-04-28,1361,0,1361,99,1460,1460,0,0
15895,2019-04-28,399,0,399,31,430,430,0,0
15896,2019-04-28,639,0,639,51,690,690,0,0
15897,2019-04-28,667,0,667,53,720,720,0,0
15898,2019-04-28,1112,0,1112,88,1200,1200,0,0
15899,2019-04-28,408,0,408,32,440,440,0,0
15900,2019-04-28,389,0,389,31,420,420,0,0
15901,2019-04-28,889,0,889,71,960,960,0,0
15902,2019-04-28,1444,0,1444,106,1550,1550,0,0
15903,2019-04-28,814,0,814,56,870,870,0,0
15904,2019-04-28,195,0,195,15,210,0,210,0
15905,2019-04-28,2010,0,2010,160,2170,2170,0,0
15906,2019-04-28,473,0,473,37,510,0,510,0
15907,2019-04-28,1815,0,1815,145,1960,0,1960,0
15908,2019-04-28,241,0,241,19,260,0,260,0
15909,2019-04-28,1407,0,1407,103,1510,1510,0,0
15910,2019-04-28,925,0,925,65,990,990,0,0
15911,2019-04-28,908,0,908,72,980,980,0,0
15912,2019-04-28,546,-116,430,34,464,464,0,0
15913,2019-04-28,2038,0,2038,162,2200,2200,0,0
15914,2019-04-28,806,0,806,64,870,870,0,0
15915,2019-04-28,1158,0,1158,92,1250,1250,0,0
15916,2019-04-28,223,0,223,17,240,240,0,0
15917,2019-04-28,945,0,945,75,1020,1020,0,0
15918,2019-04-28,269,0,269,21,290,290,0,0
15919,2019-04-28,788,0,788,62,850,850,0,0
15920,2019-04-28,1815,0,1815,145,1960,0,1960,0
15921,2019-04-28,500,0,500,40,540,540,0,0
15922,2019-04-28,1815,0,1815,145,1960,1960,0,0
15923,2019-04-29,1093,0,1093,87,1180,1180,0,0
15924,2019-04-29,425,0,425,25,450,450,0,0
15925,2019-04-29,630,0,630,50,680,680,0,0
15926,2019-04-29,889,0,889,71,960,960,0,0
15927,2019-04-29,862,0,862,68,930,930,0,0
15928,2019-04-29,667,0,667,53,720,720,0,0
15929,2019-04-29,954,0,954,76,1030,1030,0,0
15930,2019-04-29,704,0,704,56,760,760,0,0
15931,2019-04-29,908,0,908,72,980,980,0,0
15932,2019-04-29,908,0,908,72,980,980,0,0
15933,2019-04-29,176,0,176,14,190,190,0,0
15934,2019-04-29,1417,0,1417,113,1530,1530,0,0
15935,2019-04-29,732,0,732,58,790,0,790,0
15936,2019-04-29,417,0,417,33,450,450,0,0
15937,2019-04-29,1630,0,1630,130,1760,1760,0,0
15938,2019-04-29,676,0,676,54,730,730,0,0
15939,2019-04-29,1889,0,1889,151,2040,2040,0,0
15940,2019-04-29,445,0,445,35,480,480,0,0
15941,2019-04-29,908,0,908,72,980,980,0,0
15942,2019-04-29,510,0,510,40,550,550,0,0
15943,2019-04-29,1565,0,1565,125,1690,1690,0,0
15944,2019-04-29,500,0,500,40,540,540,0,0
15945,2019-04-29,149,0,149,11,160,160,0,0
15946,2019-04-29,528,0,528,42,570,570,0,0
15947,2019-04-29,1399,0,1399,111,1510,0,1510,0
15948,2019-04-29,1815,0,1815,145,1960,1960,0,0
15949,2019-04-29,908,0,908,72,980,980,0,0
15950,2019-04-29,2186,0,2186,174,2360,2360,0,0
15951,2019-04-29,908,0,908,72,980,980,0,0
15952,2019-04-29,639,0,639,51,690,690,0,0
15953,2019-04-29,499,0,499,31,530,0,530,0
15954,2019-04-29,908,0,908,72,980,980,0,0
15955,2019-04-29,908,0,908,72,980,980,0,0
15956,2019-04-29,658,0,658,52,710,710,0,0
15957,2019-04-29,667,0,667,53,720,720,0,0
15958,2019-04-29,806,0,806,64,870,870,0,0
15959,2019-04-29,269,0,269,21,290,290,0,0
15960,2019-04-29,389,0,389,31,420,0,420,0
15961,2019-04-29,667,0,667,53,720,720,0,0
15962,2019-04-29,1815,0,1815,145,1960,1960,0,0
15963,2019-04-29,565,0,565,45,610,610,0,0
15964,2019-04-29,2723,0,2723,217,2940,2940,0,0
15965,2019-04-29,436,0,436,34,470,470,0,0
15966,2019-04-29,612,0,612,48,660,660,0,0
15967,2019-04-29,1298,-139,1159,92,1251,1251,0,0
15968,2019-04-29,862,0,862,68,930,930,0,0
15969,2019-04-29,519,0,519,41,560,560,0,0
15970,2019-04-29,1749,0,1749,131,1880,1880,0,0
15971,2019-04-29,260,0,260,20,280,280,0,0
15972,2019-04-29,112,0,112,8,120,120,0,0
15973,2019-04-29,1408,0,1408,112,1520,1520,0,0
15974,2019-04-29,93,0,93,7,100,100,0,0
15975,2019-04-29,741,0,741,59,800,800,0,0
15976,2019-04-29,139,0,139,11,150,150,0,0
15977,2019-04-29,732,0,732,58,790,790,0,0
15978,2019-04-29,1019,0,1019,81,1100,1100,0,0
15979,2019-04-29,769,0,769,61,830,830,0,0
15980,2019-04-29,713,0,713,57,770,770,0,0
15981,2019-04-29,1380,0,1380,110,1490,1490,0,0
15982,2019-04-29,556,-118,438,34,472,472,0,0
15983,2019-04-29,797,0,797,63,860,860,0,0
15984,2019-04-29,565,0,565,45,610,610,0,0
15985,2019-04-29,908,0,908,72,980,980,0,0
15986,2019-04-29,491,0,491,39,530,530,0,0
15987,2019-04-29,908,0,908,72,980,980,0,0
15988,2019-04-29,1278,0,1278,102,1380,1380,0,0
15989,2019-04-29,1158,0,1158,92,1250,1250,0,0
15990,2019-04-29,473,0,473,37,510,510,0,0
15991,2019-04-29,593,0,593,47,640,640,0,0
15992,2019-04-29,621,0,621,49,670,670,0,0
15993,2019-04-29,583,0,583,37,620,620,0,0
15994,2019-04-29,112,0,112,8,120,120,0,0
15995,2019-04-29,288,0,288,22,310,310,0,0
15996,2019-04-29,417,0,417,33,450,450,0,0
15997,2019-04-29,908,0,908,72,980,980,0,0
15998,2019-04-29,2695,0,2695,215,2910,2910,0,0
15999,2019-04-29,362,0,362,28,390,390,0,0
16000,2019-04-29,426,0,426,34,460,460,0,0
16001,2019-04-29,444,0,444,26,470,470,0,0
16002,2019-04-29,259,0,259,11,270,270,0,0
16003,2019-04-29,1269,0,1269,101,1370,1370,0,0
16004,2019-04-29,2258,0,2258,162,2420,2420,0,0
16005,2019-04-29,286,0,286,14,300,300,0,0
16006,2019-04-29,825,0,825,65,890,890,0,0
16007,2019-04-29,639,0,639,51,690,690,0,0
16008,2019-04-29,1038,0,1038,82,1120,1120,0,0
16009,2019-04-29,639,0,639,51,690,690,0,0
16010,2019-04-29,1630,0,1630,130,1760,1760,0,0
16011,2019-04-29,889,0,889,71,960,960,0,0
16012,2019-04-29,538,0,538,42,580,580,0,0
16013,2019-04-29,751,0,751,59,810,810,0,0
16014,2019-04-29,362,0,362,28,390,390,0,0
16015,2019-04-29,760,0,760,60,820,820,0,0
16016,2019-04-29,1760,0,1760,140,1900,1900,0,0
16017,2019-04-29,630,0,630,50,680,680,0,0
16018,2019-04-29,167,0,167,13,180,180,0,0
16019,2019-04-29,3417,0,3417,273,3690,3690,0,0
16020,2019-04-29,2723,0,2723,217,2940,2940,0,0
16021,2019-04-29,862,0,862,68,930,930,0,0
16022,2019-04-29,491,0,491,39,530,530,0,0
16023,2019-04-29,315,0,315,25,340,340,0,0
16024,2019-04-29,945,0,945,75,1020,1020,0,0
16025,2019-04-29,1723,0,1723,137,1860,0,1860,0
16026,2019-04-29,1769,0,1769,141,1910,1910,0,0
16027,2019-04-29,973,0,973,77,1050,1050,0,0
16028,2019-04-29,1815,0,1815,145,1960,1960,0,0
16029,2019-04-29,751,0,751,59,810,810,0,0
16030,2019-04-29,102,0,102,8,110,110,0,0
16031,2019-04-29,380,0,380,30,410,410,0,0
16032,2019-04-29,1676,0,1676,134,1810,1810,0,0
16033,2019-04-29,417,0,417,33,450,450,0,0
16034,2019-04-29,704,0,704,56,760,760,0,0
16035,2019-04-29,834,0,834,66,900,900,0,0
16036,2019-04-29,1751,0,1751,139,1890,1890,0,0
16037,2019-04-29,454,0,454,36,490,490,0,0
16038,2019-04-29,825,0,825,65,890,890,0,0
16039,2019-04-29,575,0,575,45,620,620,0,0
16040,2019-04-29,167,0,167,13,180,180,0,0
16041,2019-04-29,2999,0,2999,231,3230,3230,0,0
16042,2019-04-29,769,0,769,61,830,830,0,0
16043,2019-04-29,1712,0,1712,128,1840,1840,0,0
16044,2019-04-29,871,0,871,69,940,940,0,0
16045,2019-04-29,491,0,491,39,530,530,0,0
16046,2019-04-29,843,0,843,67,910,910,0,0
16047,2019-04-29,509,0,509,31,540,540,0,0
16048,2019-04-29,371,0,371,29,400,400,0,0
16049,2019-04-29,556,0,556,44,600,600,0,0
16050,2019-04-29,1343,0,1343,107,1450,1450,0,0
16051,2019-04-29,769,0,769,61,830,830,0,0
16052,2019-04-29,149,0,149,11,160,160,0,0
16053,2019-04-29,926,0,926,74,1000,1000,0,0
16054,2019-04-29,315,0,315,25,340,340,0,0
16055,2019-04-29,741,0,741,59,800,800,0,0
16056,2019-04-29,1815,0,1815,145,1960,1960,0,0
16057,2019-04-29,593,0,593,47,640,640,0,0
16058,2019-04-29,2723,0,2723,217,2940,2940,0,0
16059,2019-04-29,306,0,306,24,330,330,0,0
16060,2019-04-29,2139,0,2139,171,2310,2310,0,0
16061,2019-04-29,510,0,510,40,550,550,0,0
16062,2019-04-29,417,0,417,33,450,450,0,0
16063,2019-04-29,223,0,223,17,240,240,0,0
16064,2019-04-29,1704,0,1704,136,1840,1840,0,0
16065,2019-04-29,1306,0,1306,104,1410,1410,0,0
16066,2019-04-29,1010,0,1010,80,1090,1090,0,0
16067,2019-04-29,170,-36,134,10,144,144,0,0
16068,2019-04-29,834,0,834,66,900,900,0,0
16069,2019-04-29,1723,0,1723,137,1860,1860,0,0
16070,2019-04-29,1223,0,1223,97,1320,1320,0,0
16071,2019-04-29,417,0,417,33,450,450,0,0
16072,2019-04-29,501,0,501,39,540,540,0,0
16073,2019-04-29,2167,0,2167,173,2340,0,2340,0
16074,2019-04-29,917,0,917,73,990,0,990,0
16075,2019-04-29,658,0,658,52,710,710,0,0
16076,2019-04-29,982,0,982,78,1060,1060,0,0
16077,2019-04-29,371,0,371,29,400,400,0,0
16078,2019-04-29,121,0,121,9,130,130,0,0
16079,2019-04-29,519,0,519,41,560,560,0,0
16080,2019-04-29,2186,0,2186,174,2360,0,2360,0
16081,2019-04-29,334,0,334,26,360,360,0,0
16082,2019-04-29,575,0,575,45,620,620,0,0
16083,2019-04-29,963,0,963,77,1040,1040,0,0
16084,2019-04-29,426,0,426,34,460,460,0,0
16085,2019-04-29,741,0,741,59,800,800,0,0
16086,2019-04-29,510,0,510,40,550,550,0,0
16087,2019-04-29,371,0,371,29,400,400,0,0
16088,2019-04-29,399,0,399,31,430,430,0,0
16089,2019-04-29,176,0,176,14,190,190,0,0
16090,2019-04-29,1843,0,1843,147,1990,0,1990,0
16091,2019-04-29,1732,0,1732,138,1870,1870,0,0
16092,2019-04-29,344,-73,271,21,292,292,0,0
16093,2019-04-29,1815,0,1815,145,1960,1960,0,0
16094,2019-04-29,556,0,556,44,600,600,0,0
16095,2019-04-29,741,0,741,59,800,800,0,0
16096,2019-04-29,491,0,491,39,530,530,0,0
16097,2019-04-29,1158,0,1158,92,1250,1250,0,0
16098,2019-04-29,1584,0,1584,126,1710,1710,0,0
16099,2019-04-29,1176,0,1176,94,1270,1270,0,0
16100,2019-04-29,371,0,371,29,400,400,0,0
16101,2019-04-29,769,0,769,61,830,830,0,0
16102,2019-04-29,1167,0,1167,93,1260,1260,0,0
16103,2019-04-29,602,0,602,48,650,650,0,0
16104,2019-04-29,371,0,371,29,400,400,0,0
16105,2019-04-29,463,0,463,37,500,500,0,0
16106,2019-04-29,639,0,639,51,690,690,0,0
16107,2019-04-29,399,0,399,31,430,0,430,0
16108,2019-04-29,362,0,362,28,390,390,0,0
16109,2019-04-29,1463,0,1463,117,1580,1580,0,0
16110,2019-04-29,-1871,0,-1871,-149,-2020,-2020,0,0
16111,2019-04-29,1399,0,1399,111,1510,1510,0,0
16112,2019-04-29,1871,0,1871,149,2020,2020,0,0
16113,2019-04-29,1871,0,1871,149,2020,2020,0,0
16114,2019-04-29,362,0,362,28,390,390,0,0
16115,2019-04-29,491,0,491,39,530,530,0,0
16116,2019-04-29,1204,0,1204,96,1300,1300,0,0
16117,2019-04-29,741,0,741,59,800,800,0,0
16118,2019-04-29,454,0,454,36,490,490,0,0
16119,2019-04-29,639,0,639,51,690,690,0,0
16120,2019-04-29,889,0,889,71,960,960,0,0
16121,2019-04-29,1815,0,1815,145,1960,1960,0,0
16122,2019-04-29,825,0,825,65,890,890,0,0
16123,2019-04-29,334,0,334,26,360,360,0,0
16124,2019-04-29,528,0,528,42,570,570,0,0
16125,2019-04-29,288,0,288,22,310,310,0,0
16126,2019-04-29,491,0,491,39,530,530,0,0
16127,2019-04-29,1343,0,1343,107,1450,1450,0,0
16128,2019-04-29,315,0,315,25,340,340,0,0
16129,2019-04-29,723,0,723,57,780,780,0,0
16130,2019-04-29,528,0,528,42,570,570,0,0
16131,2019-04-29,751,0,751,59,810,810,0,0
16132,2019-04-29,852,0,852,68,920,920,0,0
16133,2019-04-29,1334,0,1334,106,1440,1440,0,0
16134,2019-04-29,1815,0,1815,145,1960,1960,0,0
16135,2019-04-29,621,0,621,49,670,670,0,0
16136,2019-04-29,602,0,602,48,650,650,0,0
16137,2019-04-29,565,0,565,45,610,610,0,0
16138,2019-04-29,1751,0,1751,139,1890,1890,0,0
16139,2019-04-29,1973,0,1973,157,2130,2130,0,0
16140,2019-04-29,2723,0,2723,217,2940,2940,0,0
16141,2019-04-29,417,0,417,33,450,450,0,0
16142,2019-04-29,926,0,926,74,1000,1000,0,0
16143,2019-04-29,3630,0,3630,290,3920,3920,0,0
16144,2019-04-29,2723,0,2723,217,2940,2940,0,0
16145,2019-04-29,1815,0,1815,145,1960,1960,0,0
16146,2019-04-29,1815,0,1815,145,1960,1960,0,0
16147,2019-04-29,1815,0,1815,145,1960,0,1960,0
16148,2019-04-29,288,0,288,22,310,310,0,0
16149,2019-04-29,389,0,389,31,420,420,0,0
16150,2019-04-29,1315,0,1315,105,1420,1420,0,0
16151,2019-04-29,1815,0,1815,145,1960,1960,0,0
16152,2019-04-29,583,0,583,37,620,620,0,0
16153,2019-04-29,954,0,954,76,1030,1030,0,0
16154,2019-04-29,426,0,426,34,460,460,0,0
16155,2019-04-29,1815,0,1815,145,1960,1960,0,0
16156,2019-04-29,834,0,834,66,900,900,0,0
16157,2019-04-29,973,0,973,77,1050,1050,0,0
16158,2019-04-29,149,0,149,11,160,160,0,0
16159,2019-04-29,1843,0,1843,147,1990,1990,0,0
16160,2019-04-29,2723,0,2723,217,2940,0,2940,0
16161,2019-04-29,463,0,463,37,500,500,0,0
16162,2019-04-29,1815,0,1815,145,1960,1960,0,0
16163,2019-04-29,908,0,908,72,980,980,0,0
16164,2019-04-29,2723,0,2723,217,2940,2940,0,0
16165,2019-04-29,908,0,908,72,980,980,0,0
16166,2019-04-29,1251,0,1251,99,1350,1350,0,0
16167,2019-04-29,1232,0,1232,98,1330,1330,0,0
16168,2019-04-29,908,0,908,72,980,980,0,0
16169,2019-04-29,417,0,417,33,450,450,0,0
16170,2019-04-29,1482,0,1482,118,1600,1600,0,0
16171,2019-04-29,167,0,167,13,180,180,0,0
16172,2019-04-29,1352,0,1352,108,1460,1460,0,0
16173,2019-04-29,601,0,601,39,640,640,0,0
16174,2019-04-29,741,0,741,59,800,800,0,0
16175,2019-04-29,565,0,565,45,610,610,0,0
16176,2019-04-29,367,-78,289,23,312,312,0,0
16177,2019-04-29,908,0,908,72,980,980,0,0
16178,2019-04-29,778,0,778,62,840,840,0,0
16179,2019-04-29,1815,0,1815,145,1960,0,1960,0
16180,2019-04-29,1815,0,1815,145,1960,1960,0,0
16181,2019-04-29,463,0,463,37,500,500,0,0
16182,2019-04-29,2723,0,2723,217,2940,0,2940,0
16183,2019-04-29,1278,0,1278,102,1380,1380,0,0
16184,2019-04-29,1917,0,1917,153,2070,0,2070,0
16185,2019-04-29,1084,0,1084,86,1170,1170,0,0
16186,2019-04-29,686,0,686,54,740,740,0,0
16187,2019-04-29,908,0,908,72,980,980,0,0
16188,2019-04-29,1815,0,1815,145,1960,1960,0,0
16189,2019-04-29,908,0,908,72,980,980,0,0
16190,2019-04-29,908,0,908,72,980,980,0,0
16191,2019-04-29,908,0,908,72,980,980,0,0
16192,2019-04-29,2723,0,2723,217,2940,2940,0,0
16193,2019-04-30,1260,0,1260,100,1360,1360,0,0
16194,2019-04-30,575,0,575,45,620,620,0,0
16195,2019-04-30,334,0,334,26,360,360,0,0
16196,2019-04-30,510,0,510,40,550,550,0,0
16197,2019-04-30,1620,0,1620,120,1740,1740,0,0
16198,2019-04-30,908,0,908,72,980,980,0,0
16199,2019-04-30,482,0,482,38,520,520,0,0
16200,2019-04-30,1112,0,1112,88,1200,0,1200,0
16201,2019-04-30,408,0,408,32,440,440,0,0
16202,2019-04-30,1010,0,1010,80,1090,0,1090,0
16203,2019-04-30,436,0,436,34,470,470,0,0
16204,2019-04-30,565,0,565,45,610,610,0,0
16205,2019-04-30,3630,0,3630,290,3920,3920,0,0
16206,2019-04-30,2204,0,2204,176,2380,2380,0,0
16207,2019-04-30,1628,0,1628,112,1740,1740,0,0
16208,2019-04-30,528,0,528,42,570,570,0,0
16209,2019-04-30,741,0,741,59,800,800,0,0
16210,2019-04-30,649,0,649,51,700,700,0,0
16211,2019-04-30,612,0,612,48,660,660,0,0
16212,2019-04-30,1519,0,1519,121,1640,1640,0,0
16213,2019-04-30,352,0,352,28,380,380,0,0
16214,2019-04-30,815,0,815,65,880,880,0,0
16215,2019-04-30,667,0,667,53,720,720,0,0
16216,2019-04-30,1806,0,1806,144,1950,1950,0,0
16217,2019-04-30,352,0,352,28,380,380,0,0
16218,2019-04-30,1815,0,1815,145,1960,1960,0,0
16219,2019-04-30,908,0,908,72,980,980,0,0
16220,2019-04-30,908,0,908,72,980,980,0,0
16221,2019-04-30,2973,0,2973,237,3210,3210,0,0
16222,2019-04-30,1815,0,1815,145,1960,1960,0,0
16223,2019-04-30,2723,0,2723,217,2940,2940,0,0
16224,2019-04-30,852,0,852,68,920,0,920,0
16225,2019-04-30,1260,0,1260,100,1360,1360,0,0
16226,2019-04-30,399,0,399,31,430,430,0,0
16227,2019-04-30,2121,0,2121,169,2290,2290,0,0
16228,2019-04-30,436,0,436,34,470,470,0,0
16229,2019-04-30,213,0,213,17,230,230,0,0
16230,2019-04-30,982,0,982,78,1060,1060,0,0
16231,2019-04-30,5445,0,5445,435,5880,5880,0,0
16232,2019-04-30,288,0,288,22,310,310,0,0
16233,2019-04-30,1001,0,1001,79,1080,1080,0,0
16234,2019-04-30,676,0,676,54,730,730,0,0
16235,2019-04-30,621,0,621,49,670,670,0,0
16236,2019-04-30,547,0,547,43,590,590,0,0
16237,2019-04-30,167,0,167,13,180,180,0,0
16238,2019-04-30,260,0,260,20,280,280,0,0
16239,2019-04-30,908,0,908,72,980,0,980,0
16240,2019-04-30,908,0,908,72,980,980,0,0
16241,2019-04-30,1028,0,1028,82,1110,1110,0,0
16242,2019-04-30,213,0,213,17,230,230,0,0
16243,2019-04-30,1815,0,1815,145,1960,1960,0,0
16244,2019-04-30,926,0,926,74,1000,0,1000,0
16245,2019-04-30,2435,0,2435,185,2620,2620,0,0
16246,2019-04-30,593,0,593,47,640,640,0,0
16247,2019-04-30,102,0,102,8,110,110,0,0
16248,2019-04-30,1732,0,1732,138,1870,1870,0,0
16249,2019-04-30,454,0,454,36,490,490,0,0
16250,2019-04-30,751,0,751,59,810,810,0,0
16251,2019-04-30,973,0,973,77,1050,1050,0,0
16252,2019-04-30,436,0,436,34,470,470,0,0
16253,2019-04-30,565,0,565,45,610,610,0,0
16254,2019-04-30,1259,0,1259,91,1350,0,1350,0
16255,2019-04-30,667,0,667,53,720,720,0,0
16256,2019-04-30,1269,0,1269,101,1370,1370,0,0
16257,2019-04-30,250,0,250,20,270,270,0,0
16258,2019-04-30,425,0,425,25,450,450,0,0
16259,2019-04-30,621,0,621,49,670,670,0,0
16260,2019-04-30,843,0,843,67,910,910,0,0
16261,2019-04-30,732,0,732,58,790,790,0,0
16262,2019-04-30,260,0,260,20,280,280,0,0
16263,2019-04-30,-908,0,-908,-72,-980,-980,0,0
16264,2019-04-30,250,0,250,20,270,270,0,0
16265,2019-04-30,1389,0,1389,111,1500,1500,0,0
16266,2019-04-30,667,0,667,53,720,720,0,0
16267,2019-04-30,1251,0,1251,99,1350,1350,0,0
16268,2019-04-30,751,0,751,59,810,810,0,0
16269,2019-04-30,222,0,222,8,230,230,0,0
16270,2019-04-30,908,0,908,72,980,980,0,0
16271,2019-04-30,1852,0,1852,148,2000,2000,0,0
16272,2019-04-30,510,0,510,40,550,550,0,0
16273,2019-04-30,223,0,223,17,240,240,0,0
16274,2019-04-30,260,0,260,20,280,280,0,0
16275,2019-04-30,528,0,528,42,570,570,0,0
16276,2019-04-30,1260,0,1260,100,1360,1360,0,0
16277,2019-04-30,4278,0,4278,342,4620,4620,0,0
16278,2019-04-30,1251,0,1251,99,1350,1350,0,0
16279,2019-04-30,1741,0,1741,139,1880,1880,0,0
16280,2019-04-30,991,0,991,79,1070,0,1070,0
16281,2019-04-30,2065,0,2065,165,2230,2230,0,0
16282,2019-04-30,639,0,639,51,690,690,0,0
16283,2019-04-30,908,0,908,72,980,980,0,0
16284,2019-04-30,704,0,704,56,760,760,0,0
16285,2019-04-30,769,0,769,61,830,830,0,0
16286,2019-04-30,490,0,490,30,520,520,0,0
16287,2019-04-30,1445,0,1445,115,1560,1560,0,0
16288,2019-04-30,399,0,399,31,430,430,0,0
16289,2019-04-30,686,0,686,54,740,740,0,0
16290,2019-04-30,-1251,0,-1251,-99,-1350,-1350,0,0
16291,2019-04-30,612,0,612,48,660,660,0,0
16292,2019-04-30,436,0,436,34,470,470,0,0
16293,2019-04-30,547,0,547,43,590,590,0,0
16294,2019-04-30,371,0,371,29,400,400,0,0
16295,2019-04-30,1251,0,1251,99,1350,1350,0,0
16296,2019-04-30,371,0,371,29,400,400,0,0
16297,2019-04-30,769,0,769,61,830,830,0,0
16298,2019-04-30,575,0,575,45,620,620,0,0
16299,2019-04-30,315,0,315,25,340,340,0,0
16300,2019-04-30,352,0,352,28,380,380,0,0
16301,2019-04-30,732,0,732,58,790,790,0,0
16302,2019-04-30,593,0,593,47,640,640,0,0
16303,2019-04-30,1176,0,1176,94,1270,1270,0,0
16304,2019-04-30,2158,0,2158,172,2330,0,2330,0
16305,2019-04-30,1334,0,1334,106,1440,1440,0,0
16306,2019-04-30,241,0,241,19,260,260,0,0
16307,2019-04-30,352,0,352,28,380,380,0,0
16308,2019-04-30,612,0,612,48,660,660,0,0
16309,2019-04-30,1083,0,1083,77,1160,1160,0,0
16310,2019-04-30,399,0,399,31,430,430,0,0
16311,2019-04-30,260,0,260,20,280,280,0,0
16312,2019-04-30,1880,0,1880,150,2030,2030,0,0
16313,2019-04-30,908,0,908,72,980,980,0,0
16314,2019-04-30,473,0,473,37,510,510,0,0
16315,2019-04-30,741,0,741,59,800,800,0,0
16316,2019-04-30,1815,0,1815,145,1960,1960,0,0
16317,2019-04-30,1612,0,1612,128,1740,1740,0,0
16318,2019-04-30,908,0,908,72,980,980,0,0
16319,2019-04-30,908,0,908,72,980,980,0,0
16320,2019-04-30,1047,0,1047,83,1130,1130,0,0
16321,2019-04-30,1815,0,1815,145,1960,1960,0,0
16322,2019-04-30,1426,0,1426,114,1540,1540,0,0
16323,2019-04-30,501,0,501,39,540,540,0,0
16324,2019-04-30,1760,0,1760,140,1900,1900,0,0
16325,2019-04-30,1815,0,1815,145,1960,0,1960,0
16326,2019-04-30,1463,0,1463,117,1580,1580,0,0
16327,2019-04-30,1815,0,1815,145,1960,1960,0,0
16328,2019-04-30,879,0,879,61,940,940,0,0
16329,2019-04-30,1519,0,1519,121,1640,1640,0,0
16330,2019-04-30,454,0,454,36,490,490,0,0
16331,2019-04-30,334,0,334,26,360,360,0,0
16332,2019-04-30,315,0,315,25,340,340,0,0
16333,2019-04-30,908,0,908,72,980,980,0,0
16334,2019-04-30,260,0,260,20,280,280,0,0
16335,2019-04-30,176,0,176,14,190,190,0,0
16336,2019-04-30,593,0,593,47,640,640,0,0
16337,2019-04-30,482,0,482,38,520,520,0,0
16338,2019-04-30,1121,0,1121,89,1210,1210,0,0
16339,2019-04-30,871,0,871,69,940,940,0,0
16340,2019-04-30,1297,0,1297,103,1400,1400,0,0
16341,2019-04-30,732,0,732,58,790,790,0,0
16342,2019-04-30,371,0,371,29,400,400,0,0
16343,2019-04-30,297,0,297,23,320,320,0,0
16344,2019-04-30,510,0,510,40,550,550,0,0
16345,2019-04-30,862,0,862,68,930,930,0,0
16346,2019-04-30,204,0,204,16,220,220,0,0
16347,2019-04-30,1195,0,1195,95,1290,1290,0,0
16348,2019-04-30,973,0,973,77,1050,1050,0,0
16349,2019-04-30,362,0,362,28,390,390,0,0
16350,2019-04-30,621,0,621,49,670,670,0,0
16351,2019-04-30,1343,0,1343,107,1450,1450,0,0
16352,2019-04-30,297,0,297,23,320,320,0,0
16353,2019-04-30,1325,0,1325,105,1430,1430,0,0
16354,2019-04-30,399,0,399,31,430,430,0,0
16355,2019-04-30,769,0,769,61,830,830,0,0
16356,2019-04-30,741,0,741,59,800,800,0,0
16357,2019-04-30,386,-82,304,24,328,328,0,0
16358,2019-04-30,1195,0,1195,95,1290,1290,0,0
16359,2019-04-30,167,0,167,13,180,180,0,0
16360,2019-04-30,1917,0,1917,153,2070,2070,0,0
16361,2019-04-30,454,0,454,36,490,490,0,0
16362,2019-04-30,491,0,491,39,530,530,0,0
16363,2019-04-30,352,0,352,28,380,380,0,0
16364,2019-04-30,2723,0,2723,217,2940,2940,0,0
16365,2019-04-30,1815,0,1815,145,1960,1960,0,0
16366,2019-04-30,908,0,908,72,980,980,0,0
16367,2019-04-30,2723,0,2723,217,2940,2940,0,0
16368,2019-04-30,130,0,130,10,140,140,0,0
16369,2019-04-30,232,0,232,18,250,250,0,0
16370,2019-04-30,204,0,204,16,220,220,0,0
16371,2019-04-30,797,0,797,63,860,860,0,0
16372,2019-04-30,565,0,565,45,610,610,0,0
16373,2019-04-30,260,0,260,20,280,280,0,0
16374,2019-04-30,371,0,371,29,400,400,0,0
16375,2019-04-30,2149,0,2149,171,2320,2320,0,0
16376,2019-04-30,2278,0,2278,182,2460,2460,0,0
16377,2019-04-30,1325,0,1325,105,1430,1430,0,0
16378,2019-04-30,1399,0,1399,111,1510,1510,0,0
16379,2019-04-30,1547,0,1547,123,1670,1670,0,0
16380,2019-04-30,1815,0,1815,145,1960,1960,0,0
16381,2019-04-30,815,0,815,65,880,880,0,0
16382,2019-04-30,260,0,260,20,280,280,0,0
16383,2019-04-30,463,0,463,37,500,500,0,0
16384,2019-04-30,139,0,139,11,150,150,0,0
16385,2019-04-30,195,0,195,15,210,210,0,0
16386,2019-04-30,112,0,112,8,120,120,0,0
16387,2019-04-30,843,0,843,67,910,910,0,0
16388,2019-04-30,732,0,732,58,790,790,0,0
16389,2019-04-30,315,0,315,25,340,340,0,0
16390,2019-04-30,639,0,639,51,690,690,0,0
16391,2019-04-30,1788,0,1788,142,1930,1930,0,0
16392,2019-04-30,232,0,232,18,250,250,0,0
16393,2019-04-30,1528,0,1528,122,1650,1650,0,0
16394,2019-04-30,389,0,389,31,420,420,0,0
16395,2019-04-30,352,0,352,28,380,380,0,0
16396,2019-04-30,306,0,306,24,330,330,0,0
16397,2019-04-30,1260,0,1260,100,1360,1360,0,0
16398,2019-04-30,436,0,436,34,470,470,0,0
16399,2019-04-30,1084,0,1084,86,1170,1170,0,0
16400,2019-04-30,139,0,139,11,150,150,0,0
16401,2019-04-30,1056,0,1056,84,1140,1140,0,0
16402,2019-04-30,-112,0,-112,-8,-120,-120,0,0
16403,2019-04-30,112,0,112,8,120,120,0,0
16404,2019-04-30,112,0,112,8,120,120,0,0
16405,2019-04-30,2204,0,2204,176,2380,2380,0,0
16406,2019-04-30,491,0,491,39,530,530,0,0
16407,2019-04-30,899,0,899,71,970,970,0,0
16408,2019-04-30,954,0,954,76,1030,1030,0,0
16409,2019-04-30,176,0,176,14,190,190,0,0
16410,2019-04-30,501,0,501,39,540,540,0,0
16411,2019-04-30,1130,0,1130,90,1220,1220,0,0
16412,2019-04-30,1112,0,1112,88,1200,1200,0,0
16413,2019-04-30,334,0,334,26,360,360,0,0
16414,2019-04-30,1112,0,1112,88,1200,1200,0,0
16415,2019-04-30,843,0,843,67,910,910,0,0
16416,2019-04-30,389,0,389,31,420,420,0,0
16417,2019-04-30,1028,0,1028,82,1110,1110,0,0
16418,2019-04-30,908,0,908,72,980,980,0,0
16419,2019-04-30,167,0,167,13,180,180,0,0
16420,2019-04-30,3630,0,3630,290,3920,0,3920,0
16421,2019-04-30,334,0,334,26,360,360,0,0
16422,2019-04-30,1251,0,1251,99,1350,1350,0,0
16423,2019-04-30,269,0,269,21,290,290,0,0
16424,2019-04-30,1612,0,1612,128,1740,1740,0,0
16425,2019-04-30,769,0,769,61,830,830,0,0
16426,2019-04-30,1815,0,1815,145,1960,1960,0,0
16427,2019-04-30,491,0,491,39,530,530,0,0
16428,2019-04-30,538,0,538,42,580,580,0,0
16429,2019-04-30,389,0,389,31,420,420,0,0
16430,2019-04-30,1815,0,1815,145,1960,1960,0,0
16431,2019-04-30,1815,0,1815,145,1960,1960,0,0
16432,2019-04-30,741,0,741,59,800,0,800,0
16433,2019-04-30,1028,0,1028,82,1110,1110,0,0
16434,2019-04-30,732,0,732,58,790,790,0,0
16435,2019-04-30,278,0,278,22,300,300,0,0
16436,2019-04-30,547,0,547,43,590,590,0,0
16437,2019-04-30,2416,0,2416,184,2600,0,2600,0
16438,2019-04-30,538,0,538,42,580,580,0,0
16439,2019-04-30,769,0,769,61,830,0,830,0
16440,2019-04-30,1815,0,1815,145,1960,1960,0,0
16441,2019-04-30,1362,0,1362,108,1470,1470,0,0
16442,2019-04-30,491,0,491,39,530,530,0,0
16443,2019-04-30,797,0,797,63,860,860,0,0
16444,2019-04-30,797,0,797,63,860,860,0,0
16445,2019-04-30,945,0,945,75,1020,1020,0,0
16446,2019-04-30,1473,0,1473,117,1590,1590,0,0
16447,2019-04-30,899,0,899,71,970,970,0,0
16448,2019-04-30,1417,0,1417,113,1530,0,1530,0
16449,2019-04-30,760,0,760,60,820,820,0,0
16450,2019-04-30,880,0,880,70,950,950,0,0
16451,2019-04-30,713,0,713,57,770,770,0,0
16452,2019-04-30,1371,0,1371,109,1480,1480,0,0
16453,2019-04-30,778,0,778,62,840,840,0,0
16454,2019-04-30,547,0,547,43,590,590,0,0
16455,2019-04-30,982,0,982,78,1060,1060,0,0
16456,2019-04-30,232,0,232,18,250,250,0,0
16457,2019-04-30,852,0,852,68,920,920,0,0
16458,2019-04-30,408,0,408,32,440,440,0,0
16459,2019-04-30,1704,0,1704,136,1840,1840,0,0
16460,2019-04-30,112,0,112,8,120,120,0,0
16461,2019-04-30,388,0,388,22,410,410,0,0
16462,2019-04-30,3584,0,3584,286,3870,3870,0,0
16463,2019-04-30,389,0,389,31,420,420,0,0
16464,2019-04-30,908,0,908,72,980,980,0,0
16465,2019-04-30,371,0,371,29,400,400,0,0
16466,2019-04-30,1038,0,1038,82,1120,1120,0,0
16467,2019-04-30,925,0,925,65,990,990,0,0
16468,2019-04-30,880,0,880,70,950,950,0,0
16469,2019-04-30,1167,0,1167,93,1260,1260,0,0
16470,2019-04-30,-2723,0,-2723,-217,-2940,-2940,0,0
16471,2019-04-30,1815,0,1815,145,1960,1960,0,0
16472,2019-04-30,908,0,908,72,980,980,0,0
16473,2019-04-30,2723,0,2723,217,2940,2940,0,0
16474,2019-04-30,797,0,797,63,860,860,0,0
16475,2019-04-30,250,0,250,20,270,270,0,0
16476,2019-04-30,1528,0,1528,122,1650,1650,0,0
16477,2019-04-30,250,0,250,20,270,270,0,0
16478,2019-04-30,917,0,917,73,990,990,0,0
16479,2019-04-30,786,0,786,54,840,840,0,0
16480,2019-04-30,889,0,889,71,960,960,0,0
16481,2019-04-30,1815,0,1815,145,1960,1960,0,0
16482,2019-04-30,325,0,325,25,350,350,0,0
16483,2019-04-30,2424,0,2424,176,2600,2600,0,0
16484,2019-04-30,306,0,306,24,330,330,0,0
16485,2019-04-30,139,0,139,11,150,150,0,0
16486,2019-04-30,2723,0,2723,217,2940,2940,0,0
16487,2019-04-30,649,0,649,51,700,700,0,0
16488,2019-04-30,908,0,908,72,980,980,0,0
16489,2019-04-30,454,0,454,36,490,490,0,0
16490,2019-04-30,916,0,916,64,980,980,0,0
16491,2019-04-30,444,0,444,26,470,470,0,0
16492,2019-04-30,639,0,639,51,690,690,0,0
16493,2019-04-30,797,0,797,63,860,860,0,0
16494,2019-04-30,889,0,889,71,960,960,0,0
16495,2019-05-01,2047,0,2047,163,2210,2210,0,0
16496,2019-05-01,315,0,315,25,340,340,0,0
16497,2019-05-01,908,0,908,72,980,980,0,0
16498,2019-05-01,445,0,445,35,480,480,0,0
16499,2019-05-01,223,0,223,17,240,0,240,0
16500,2019-05-01,371,0,371,29,400,400,0,0
16501,2019-05-01,1399,0,1399,111,1510,1510,0,0
16502,2019-05-01,695,0,695,55,750,750,0,0
16503,2019-05-01,1038,0,1038,82,1120,1120,0,0
16504,2019-05-01,2269,0,2269,181,2450,2450,0,0
16505,2019-05-01,250,0,250,20,270,270,0,0
16506,2019-05-01,315,0,315,25,340,340,0,0
16507,2019-05-01,343,0,343,27,370,370,0,0
16508,2019-05-01,954,0,954,76,1030,0,1030,0
16509,2019-05-01,973,0,973,77,1050,1050,0,0
16510,2019-05-01,1815,0,1815,145,1960,1960,0,0
16511,2019-05-01,1362,0,1362,108,1470,1470,0,0
16512,2019-05-01,575,0,575,45,620,620,0,0
16513,2019-05-01,649,0,649,51,700,700,0,0
16514,2019-05-01,880,0,880,70,950,950,0,0
16515,2019-05-01,1649,0,1649,131,1780,1780,0,0
16516,2019-05-01,408,0,408,32,440,440,0,0
16517,2019-05-01,1806,0,1806,144,1950,1950,0,0
16518,2019-05-01,2251,0,2251,179,2430,2430,0,0
16519,2019-05-01,2352,0,2352,188,2540,2540,0,0
16520,2019-05-01,704,0,704,56,760,760,0,0
16521,2019-05-01,1899,0,1899,151,2050,2050,0,0
16522,2019-05-01,676,0,676,54,730,730,0,0
16523,2019-05-01,1536,0,1536,114,1650,1650,0,0
16524,2019-05-01,1473,0,1473,117,1590,1590,0,0
16525,2019-05-01,612,0,612,48,660,660,0,0
16526,2019-05-01,1815,0,1815,145,1960,1960,0,0
16527,2019-05-01,695,0,695,55,750,750,0,0
16528,2019-05-01,519,0,519,41,560,560,0,0
16529,2019-05-01,2084,0,2084,166,2250,2250,0,0
16530,2019-05-01,1815,0,1815,145,1960,1960,0,0
16531,2019-05-01,982,0,982,78,1060,1060,0,0
16532,2019-05-01,2723,0,2723,217,2940,2940,0,0
16533,2019-05-01,538,0,538,42,580,580,0,0
16534,2019-05-01,843,0,843,67,910,910,0,0
16535,2019-05-01,491,0,491,39,530,530,0,0
16536,2019-05-01,1098,0,1098,87,1185,1185,0,0
16537,2019-05-01,788,0,788,62,850,850,0,0
16538,2019-05-01,1454,0,1454,116,1570,1570,0,0
16539,2019-05-01,482,0,482,38,520,520,0,0
16540,2019-05-01,991,0,991,79,1070,1070,0,0
16541,2019-05-01,325,0,325,25,350,350,0,0
16542,2019-05-01,676,0,676,54,730,730,0,0
16543,2019-05-01,704,0,704,56,760,760,0,0
16544,2019-05-01,473,0,473,37,510,510,0,0
16545,2019-05-01,473,0,473,37,510,510,0,0
16546,2019-05-01,1019,0,1019,81,1100,1100,0,0
16547,2019-05-01,1473,0,1473,117,1590,1590,0,0
16548,2019-05-01,649,0,649,51,700,700,0,0
16549,2019-05-01,3112,0,3112,248,3360,3360,0,0
16550,2019-05-01,584,0,584,46,630,630,0,0
16551,2019-05-01,1547,0,1547,123,1670,1670,0,0
16552,2019-05-01,399,0,399,31,430,430,0,0
16553,2019-05-01,399,0,399,31,430,430,0,0
16554,2019-05-01,371,0,371,29,400,400,0,0
16555,2019-05-01,389,0,389,31,420,420,0,0
16556,2019-05-01,232,0,232,18,250,250,0,0
16557,2019-05-01,2278,0,2278,182,2460,2460,0,0
16558,2019-05-01,259,0,259,11,270,270,0,0
16559,2019-05-01,288,0,288,22,310,310,0,0
16560,2019-05-01,723,0,723,57,780,780,0,0
16561,2019-05-01,500,0,500,40,540,540,0,0
16562,2019-05-01,778,0,778,62,840,840,0,0
16563,2019-05-01,1019,0,1019,81,1100,1100,0,0
16564,2019-05-01,1186,0,1186,94,1280,1280,0,0
16565,2019-05-01,741,0,741,59,800,800,0,0
16566,2019-05-01,1723,0,1723,137,1860,1860,0,0
16567,2019-05-01,491,0,491,39,530,530,0,0
16568,2019-05-01,102,0,102,8,110,110,0,0
16569,2019-05-01,2788,0,2788,222,3010,3010,0,0
16570,2019-05-01,380,0,380,30,410,410,0,0
16571,2019-05-01,1815,0,1815,145,1960,1960,0,0
16572,2019-05-01,1815,0,1815,145,1960,1960,0,0
16573,2019-05-01,565,0,565,45,610,610,0,0
16574,2019-05-01,666,0,666,44,710,710,0,0
16575,2019-05-01,195,0,195,15,210,210,0,0
16576,2019-05-01,1815,0,1815,145,1960,1960,0,0
16577,2019-05-01,843,0,843,67,910,910,0,0
16578,2019-05-01,1815,0,1815,145,1960,1960,0,0
16579,2019-05-01,232,0,232,18,250,250,0,0
16580,2019-05-01,2213,0,2213,177,2390,2390,0,0
16581,2019-05-01,269,0,269,21,290,290,0,0
16582,2019-05-01,1112,0,1112,88,1200,1200,0,0
16583,2019-05-01,1658,0,1658,132,1790,1790,0,0
16584,2019-05-01,924,0,924,56,980,980,0,0
16585,2019-05-01,389,0,389,31,420,420,0,0
16586,2019-05-01,723,0,723,57,780,780,0,0
16587,2019-05-01,343,0,343,27,370,370,0,0
16588,2019-05-01,1167,0,1167,93,1260,1260,0,0
16589,2019-05-01,1010,0,1010,80,1090,1090,0,0
16590,2019-05-01,2389,0,2389,191,2580,2580,0,0
16591,2019-05-01,667,0,667,53,720,720,0,0
16592,2019-05-01,139,0,139,11,150,150,0,0
16593,2019-05-01,732,0,732,58,790,790,0,0
16594,2019-05-01,3630,0,3630,290,3920,0,3920,0
16595,2019-05-01,181,0,181,14,195,195,0,0
16596,2019-05-01,862,0,862,68,930,930,0,0
16597,2019-05-01,1380,0,1380,110,1490,1490,0,0
16598,2019-05-01,1084,0,1084,86,1170,1170,0,0
16599,2019-05-01,834,0,834,66,900,900,0,0
16600,2019-05-01,962,0,962,68,1030,1030,0,0
16601,2019-05-01,1575,0,1575,125,1700,1700,0,0
16602,2019-05-01,380,0,380,30,410,0,410,0
16603,2019-05-01,676,0,676,54,730,0,730,0
16604,2019-05-01,1972,0,1972,148,2120,0,2120,0
16605,2019-05-01,102,0,102,8,110,110,0,0
16606,2019-05-01,1880,0,1880,150,2030,2030,0,0
16607,2019-05-01,278,0,278,22,300,300,0,0
16608,2019-05-01,1491,0,1491,119,1610,1610,0,0
16609,2019-05-01,352,0,352,28,380,380,0,0
16610,2019-05-01,362,0,362,28,390,390,0,0
16611,2019-05-01,1278,0,1278,102,1380,1380,0,0
16612,2019-05-01,269,0,269,21,290,290,0,0
16613,2019-05-01,1463,0,1463,117,1580,1580,0,0
16614,2019-05-01,797,0,797,63,860,860,0,0
16615,2019-05-01,621,0,621,49,670,670,0,0
16616,2019-05-01,463,0,463,37,500,500,0,0
16617,2019-05-01,315,0,315,25,340,340,0,0
16618,2019-05-01,741,0,741,59,800,800,0,0
16619,2019-05-01,232,0,232,18,250,250,0,0
16620,2019-05-01,167,0,167,13,180,180,0,0
16621,2019-05-01,741,0,741,59,800,800,0,0
16622,2019-05-01,760,0,760,60,820,820,0,0
16623,2019-05-01,1945,0,1945,155,2100,2100,0,0
16624,2019-05-01,2019,0,2019,161,2180,2180,0,0
16625,2019-05-01,991,0,991,79,1070,1070,0,0
16626,2019-05-01,982,0,982,78,1060,0,1060,0
16627,2019-05-01,2306,0,2306,184,2490,2490,0,0
16628,2019-05-01,862,0,862,68,930,930,0,0
16629,2019-05-01,602,0,602,48,650,650,0,0
16630,2019-05-01,658,0,658,52,710,710,0,0
16631,2019-05-01,223,0,223,17,240,240,0,0
16632,2019-05-01,334,0,334,26,360,360,0,0
16633,2019-05-01,741,0,741,59,800,800,0,0
16634,2019-05-01,1083,0,1083,77,1160,1160,0,0
16635,2019-05-01,1426,0,1426,114,1540,1540,0,0
16636,2019-05-01,306,0,306,24,330,330,0,0
16637,2019-05-01,732,0,732,58,790,790,0,0
16638,2019-05-01,362,0,362,28,390,390,0,0
16639,2019-05-01,1056,0,1056,84,1140,1140,0,0
16640,2019-05-01,1010,0,1010,80,1090,1090,0,0
16641,2019-05-01,463,0,463,37,500,500,0,0
16642,2019-05-01,815,0,815,65,880,880,0,0
16643,2019-05-01,741,0,741,59,800,800,0,0
16644,2019-05-01,1760,0,1760,140,1900,1900,0,0
16645,2019-05-01,1112,0,1112,88,1200,1200,0,0
16646,2019-05-01,362,0,362,28,390,390,0,0
16647,2019-05-01,463,0,463,37,500,500,0,0
16648,2019-05-01,278,0,278,22,300,0,300,0
16649,2019-05-01,612,0,612,48,660,660,0,0
16650,2019-05-01,112,0,112,8,120,120,0,0
16651,2019-05-01,232,0,232,18,250,250,0,0
16652,2019-05-01,232,0,232,18,250,250,0,0
16653,2019-05-01,112,0,112,8,120,120,0,0
16654,2019-05-01,1362,0,1362,108,1470,1470,0,0
16655,2019-05-01,149,0,149,11,160,160,0,0
16656,2019-05-01,1741,0,1741,139,1880,1880,0,0
16657,2019-05-01,1093,0,1093,87,1180,1180,0,0
16658,2019-05-01,1982,0,1982,158,2140,2140,0,0
16659,2019-05-01,972,0,972,68,1040,0,1040,0
16660,2019-05-01,1398,0,1398,102,1500,1500,0,0
16661,2019-05-01,269,0,269,21,290,290,0,0
16662,2019-05-01,473,0,473,37,510,510,0,0
16663,2019-05-01,862,0,862,68,930,0,930,0
16664,2019-05-01,908,0,908,72,980,980,0,0
16665,2019-05-01,213,0,213,17,230,230,0,0
16666,2019-05-01,1501,0,1501,119,1620,1620,0,0
16667,2019-05-01,621,0,621,49,670,670,0,0
16668,2019-05-01,584,0,584,46,630,630,0,0
16669,2019-05-01,389,0,389,31,420,420,0,0
16670,2019-05-01,232,0,232,18,250,250,0,0
16671,2019-05-01,889,0,889,71,960,960,0,0
16672,2019-05-01,399,0,399,31,430,430,0,0
16673,2019-05-01,2158,0,2158,172,2330,2330,0,0
16674,2019-05-01,1399,0,1399,111,1510,1510,0,0
16675,2019-05-01,1712,0,1712,128,1840,1840,0,0
16676,2019-05-01,2723,0,2723,217,2940,0,2940,0
16677,2019-05-01,408,0,408,32,440,440,0,0
16678,2019-05-01,491,0,491,39,530,530,0,0
16679,2019-05-01,797,0,797,63,860,860,0,0
16680,2019-05-01,1176,0,1176,94,1270,1270,0,0
16681,2019-05-01,593,0,593,47,640,640,0,0
16682,2019-05-01,945,0,945,75,1020,1020,0,0
16683,2019-05-01,1278,0,1278,102,1380,1380,0,0
16684,2019-05-01,321,0,321,25,346,346,0,0
16685,2019-05-01,3630,0,3630,290,3920,0,3920,0
16686,2019-05-01,288,0,288,22,310,310,0,0
16687,2019-05-01,547,0,547,43,590,590,0,0
16688,2019-05-01,408,0,408,32,440,440,0,0
16689,2019-05-01,1648,0,1648,122,1770,1770,0,0
16690,2019-05-01,1815,0,1815,145,1960,1960,0,0
16691,2019-05-01,251,0,251,19,270,270,0,0
16692,2019-05-01,760,0,760,60,820,820,0,0
16693,2019-05-01,362,0,362,28,390,390,0,0
16694,2019-05-01,1815,0,1815,145,1960,1960,0,0
16695,2019-05-01,908,0,908,72,980,980,0,0
16696,2019-05-01,3501,0,3501,279,3780,3780,0,0
16697,2019-05-01,1149,0,1149,91,1240,1240,0,0
16698,2019-05-01,1815,0,1815,145,1960,1960,0,0
16699,2019-05-01,482,0,482,38,520,520,0,0
16700,2019-05-01,2047,0,2047,163,2210,2210,0,0
16701,2019-05-01,806,0,806,64,870,870,0,0
16702,2019-05-01,797,0,797,63,860,860,0,0
16703,2019-05-01,1176,0,1176,94,1270,1270,0,0
16704,2019-05-01,899,0,899,71,970,970,0,0
16705,2019-05-01,2723,0,2723,217,2940,2940,0,0
16706,2019-05-01,1815,0,1815,145,1960,1960,0,0
16707,2019-05-01,1815,0,1815,145,1960,1960,0,0
16708,2019-05-01,1815,0,1815,145,1960,1960,0,0
16709,2019-05-01,2723,0,2723,217,2940,2940,0,0
16710,2019-05-01,575,0,575,45,620,0,620,0
16711,2019-05-01,93,0,93,7,100,100,0,0
16712,2019-05-01,908,0,908,72,980,980,0,0
16713,2019-05-01,751,0,751,59,810,810,0,0
16714,2019-05-01,917,0,917,73,990,990,0,0
16715,2019-05-01,1093,0,1093,87,1180,1180,0,0
16716,2019-05-01,639,0,639,51,690,690,0,0
16717,2019-05-01,444,0,444,26,470,0,470,0
16718,2019-05-01,862,0,862,68,930,930,0,0
16719,2019-05-02,399,0,399,31,430,430,0,0
16720,2019-05-02,249,0,249,11,260,260,0,0
16721,2019-05-02,380,0,380,30,410,410,0,0
16722,2019-05-02,389,0,389,31,420,420,0,0
16723,2019-05-02,1269,0,1269,101,1370,1370,0,0
16724,2019-05-02,806,0,806,64,870,870,0,0
16725,2019-05-02,621,0,621,49,670,670,0,0
16726,2019-05-02,463,0,463,37,500,500,0,0
16727,2019-05-02,3630,0,3630,290,3920,3920,0,0
16728,2019-05-02,667,0,667,53,720,720,0,0
16729,2019-05-02,2093,0,2093,167,2260,2260,0,0
16730,2019-05-02,898,0,898,62,960,960,0,0
16731,2019-05-02,908,0,908,72,980,980,0,0
16732,2019-05-02,612,0,612,48,660,660,0,0
16733,2019-05-02,232,0,232,18,250,250,0,0
16734,2019-05-02,399,0,399,31,430,430,0,0
16735,2019-05-02,954,0,954,76,1030,1030,0,0
16736,2019-05-02,1352,0,1352,108,1460,1460,0,0
16737,2019-05-02,519,0,519,41,560,560,0,0
16738,2019-05-02,658,0,658,52,710,710,0,0
16739,2019-05-02,945,0,945,75,1020,1020,0,0
16740,2019-05-02,917,0,917,73,990,990,0,0
16741,2019-05-02,306,0,306,24,330,330,0,0
16742,2019-05-02,360,0,360,20,380,380,0,0
16743,2019-05-02,2723,0,2723,217,2940,0,2940,0
16744,2019-05-02,482,0,482,38,520,520,0,0
16745,2019-05-02,1463,0,1463,117,1580,1580,0,0
16746,2019-05-02,621,0,621,49,670,670,0,0
16747,2019-05-02,112,0,112,8,120,120,0,0
16748,2019-05-02,2362,0,2362,188,2550,2550,0,0
16749,2019-05-02,917,0,917,73,990,990,0,0
16750,2019-05-02,649,0,649,51,700,700,0,0
16751,2019-05-02,102,0,102,8,110,110,0,0
16752,2019-05-02,167,0,167,13,180,180,0,0
16753,2019-05-02,1593,0,1593,127,1720,1720,0,0
16754,2019-05-02,649,0,649,51,700,700,0,0
16755,2019-05-02,575,0,575,45,620,620,0,0
16756,2019-05-02,908,0,908,72,980,980,0,0
16757,2019-05-02,908,0,908,72,980,980,0,0
16758,2019-05-02,982,0,982,78,1060,0,1060,0
16759,2019-05-02,1092,0,1092,78,1170,1170,0,0
16760,2019-05-02,1584,0,1584,126,1710,1710,0,0
16761,2019-05-02,945,0,945,75,1020,1020,0,0
16762,2019-05-02,639,0,639,51,690,690,0,0
16763,2019-05-02,445,0,445,35,480,480,0,0
16764,2019-05-02,1519,0,1519,121,1640,1640,0,0
16765,2019-05-02,519,0,519,41,560,560,0,0
16766,2019-05-02,667,0,667,53,720,720,0,0
16767,2019-05-02,2180,-45,2135,170,2305,2305,0,0
16768,2019-05-02,1267,0,1267,83,1350,1350,0,0
16769,2019-05-02,602,0,602,48,650,650,0,0
16770,2019-05-02,1288,0,1288,102,1390,1390,0,0
16771,2019-05-02,908,0,908,72,980,980,0,0
16772,2019-05-02,908,0,908,72,980,980,0,0
16773,2019-05-02,389,0,389,31,420,420,0,0
16774,2019-05-02,334,0,334,26,360,360,0,0
16775,2019-05-02,149,0,149,11,160,160,0,0
16776,2019-05-02,806,0,806,64,870,870,0,0
16777,2019-05-02,528,0,528,42,570,570,0,0
16778,2019-05-02,778,0,778,62,840,840,0,0
16779,2019-05-02,815,0,815,65,880,880,0,0
16780,2019-05-02,889,0,889,71,960,960,0,0
16781,2019-05-02,547,0,547,43,590,590,0,0
16782,2019-05-02,788,0,788,62,850,850,0,0
16783,2019-05-02,1788,0,1788,142,1930,1930,0,0
16784,2019-05-02,1158,0,1158,92,1250,1250,0,0
16785,2019-05-02,658,0,658,52,710,710,0,0
16786,2019-05-02,1546,0,1546,114,1660,1660,0,0
16787,2019-05-02,1982,0,1982,158,2140,2140,0,0
16788,2019-05-02,278,0,278,22,300,300,0,0
16789,2019-05-02,260,0,260,20,280,280,0,0
16790,2019-05-02,908,0,908,72,980,980,0,0
16791,2019-05-02,778,0,778,62,840,840,0,0
16792,2019-05-02,1639,0,1639,131,1770,1770,0,0
16793,2019-05-02,760,0,760,60,820,820,0,0
16794,2019-05-02,399,0,399,31,430,430,0,0
16795,2019-05-02,926,0,926,74,1000,1000,0,0
16796,2019-05-02,186,0,186,14,200,200,0,0
16797,2019-05-02,3491,0,3491,279,3770,3770,0,0
16798,2019-05-02,584,0,584,46,630,630,0,0
16799,2019-05-02,352,0,352,28,380,380,0,0
16800,2019-05-02,1158,0,1158,92,1250,1250,0,0
16801,2019-05-02,1463,0,1463,117,1580,1580,0,0
16802,2019-05-02,1232,0,1232,98,1330,1330,0,0
16803,2019-05-02,621,0,621,49,670,670,0,0
16804,2019-05-02,584,0,584,46,630,630,0,0
16805,2019-05-02,1056,0,1056,84,1140,1140,0,0
16806,2019-05-02,408,0,408,32,440,440,0,0
16807,2019-05-02,630,0,630,50,680,680,0,0
16808,2019-05-02,1815,0,1815,145,1960,1960,0,0
16809,2019-05-02,241,0,241,19,260,260,0,0
16810,2019-05-02,797,0,797,63,860,860,0,0
16811,2019-05-02,371,0,371,29,400,400,0,0
16812,2019-05-02,149,0,149,11,160,160,0,0
16813,2019-05-02,538,0,538,42,580,580,0,0
16814,2019-05-02,1186,0,1186,94,1280,1280,0,0
16815,2019-05-02,1815,0,1815,145,1960,1960,0,0
16816,2019-05-02,491,0,491,39,530,530,0,0
16817,2019-05-02,3630,0,3630,290,3920,3920,0,0
16818,2019-05-02,1343,0,1343,107,1450,0,1450,0
16819,2019-05-02,1815,0,1815,145,1960,1960,0,0
16820,2019-05-02,1815,0,1815,145,1960,1960,0,0
16821,2019-05-02,454,0,454,36,490,490,0,0
16822,2019-05-02,362,0,362,28,390,390,0,0
16823,2019-05-02,926,0,926,74,1000,1000,0,0
16824,2019-05-02,880,0,880,70,950,950,0,0
16825,2019-05-02,4639,0,4639,371,5010,5010,0,0
16826,2019-05-02,547,0,547,43,590,590,0,0
16827,2019-05-02,695,0,695,55,750,750,0,0
16828,2019-05-02,593,0,593,47,640,640,0,0
16829,2019-05-02,584,0,584,46,630,630,0,0
16830,2019-05-02,1815,0,1815,145,1960,1960,0,0
16831,2019-05-02,805,0,805,55,860,860,0,0
16832,2019-05-02,362,0,362,28,390,390,0,0
16833,2019-05-02,389,0,389,31,420,420,0,0
16834,2019-05-02,399,0,399,31,430,430,0,0
16835,2019-05-02,778,0,778,62,840,840,0,0
16836,2019-05-02,260,0,260,20,280,280,0,0
16837,2019-05-02,1092,0,1092,78,1170,1170,0,0
16838,2019-05-02,1473,0,1473,117,1590,1590,0,0
16839,2019-05-02,482,0,482,38,520,520,0,0
16840,2019-05-02,732,0,732,58,790,790,0,0
16841,2019-05-02,1166,0,1166,84,1250,1250,0,0
16842,2019-05-02,981,0,981,69,1050,1050,0,0
16843,2019-05-02,1093,0,1093,87,1180,1180,0,0
16844,2019-05-02,2723,0,2723,217,2940,2940,0,0
16845,2019-05-02,1815,0,1815,145,1960,1960,0,0
16846,2019-05-02,1815,0,1815,145,1960,1960,0,0
16847,2019-05-02,1861,0,1861,139,2000,2000,0,0
16848,2019-05-02,1815,0,1815,145,1960,1960,0,0
16849,2019-05-02,917,0,917,73,990,990,0,0
16850,2019-05-02,954,0,954,76,1030,1030,0,0
16851,2019-05-02,1176,0,1176,94,1270,1270,0,0
16852,2019-05-02,167,0,167,13,180,180,0,0
16853,2019-05-02,278,0,278,22,300,300,0,0
16854,2019-05-02,167,0,167,13,180,180,0,0
16855,2019-05-02,547,0,547,43,590,590,0,0
16856,2019-05-02,917,0,917,73,990,990,0,0
16857,2019-05-02,306,0,306,24,330,330,0,0
16858,2019-05-02,1815,0,1815,145,1960,1960,0,0
16859,2019-05-02,260,0,260,20,280,280,0,0
16860,2019-05-02,704,0,704,56,760,760,0,0
16861,2019-05-02,2638,0,2638,202,2840,2840,0,0
16862,2019-05-02,842,0,842,58,900,900,0,0
16863,2019-05-02,1019,0,1019,81,1100,1100,0,0
16864,2019-05-02,778,0,778,62,840,840,0,0
16865,2019-05-02,908,0,908,72,980,980,0,0
16866,2019-05-02,788,0,788,62,850,850,0,0
16867,2019-05-02,899,0,899,71,970,970,0,0
16868,2019-05-02,463,0,463,37,500,500,0,0
16869,2019-05-02,769,0,769,61,830,830,0,0
16870,2019-05-02,1176,0,1176,94,1270,1270,0,0
16871,2019-05-02,713,0,713,57,770,770,0,0
16872,2019-05-02,389,0,389,31,420,420,0,0
16873,2019-05-02,760,0,760,60,820,820,0,0
16874,2019-05-02,1001,0,1001,79,1080,1080,0,0
16875,2019-05-02,389,0,389,31,420,420,0,0
16876,2019-05-02,1028,0,1028,82,1110,1110,0,0
16877,2019-05-02,1056,0,1056,84,1140,1140,0,0
16878,2019-05-02,2167,0,2167,173,2340,2340,0,0
16879,2019-05-02,1704,0,1704,136,1840,1840,0,0
16880,2019-05-02,1176,0,1176,94,1270,0,1270,0
16881,2019-05-02,593,0,593,47,640,640,0,0
16882,2019-05-02,593,0,593,47,640,640,0,0
16883,2019-05-02,1176,0,1176,94,1270,1270,0,0
16884,2019-05-02,528,0,528,42,570,570,0,0
16885,2019-05-02,778,0,778,62,840,840,0,0
16886,2019-05-02,741,0,741,59,800,800,0,0
16887,2019-05-02,538,0,538,42,580,580,0,0
16888,2019-05-02,584,0,584,46,630,630,0,0
16889,2019-05-02,528,0,528,42,570,570,0,0
16890,2019-05-02,371,0,371,29,400,400,0,0
16891,2019-05-02,584,0,584,46,630,630,0,0
16892,2019-05-02,399,0,399,31,430,430,0,0
16893,2019-05-02,1658,0,1658,132,1790,1790,0,0
16894,2019-05-02,751,0,751,59,810,810,0,0
16895,2019-05-02,556,0,556,44,600,600,0,0
16896,2019-05-02,1806,0,1806,144,1950,1950,0,0
16897,2019-05-02,676,0,676,54,730,730,0,0
16898,2019-05-02,241,0,241,19,260,260,0,0
16899,2019-05-02,982,0,982,78,1060,1060,0,0
16900,2019-05-02,1139,0,1139,91,1230,1230,0,0
16901,2019-05-02,501,0,501,39,540,540,0,0
16902,2019-05-02,362,0,362,28,390,390,0,0
16903,2019-05-02,139,0,139,11,150,150,0,0
16904,2019-05-02,575,0,575,45,620,620,0,0
16905,2019-05-02,445,0,445,35,480,480,0,0
16906,2019-05-02,584,0,584,46,630,630,0,0
16907,2019-05-02,639,0,639,51,690,690,0,0
16908,2019-05-02,592,0,592,38,630,630,0,0
16909,2019-05-02,251,0,251,19,270,270,0,0
16910,2019-05-02,288,0,288,22,310,310,0,0
16911,2019-05-02,3630,0,3630,290,3920,3920,0,0
16912,2019-05-02,778,0,778,62,840,840,0,0
16913,2019-05-02,3630,0,3630,290,3920,3920,0,0
16914,2019-05-02,260,0,260,20,280,280,0,0
16915,2019-05-02,323,0,323,17,340,340,0,0
16916,2019-05-02,741,0,741,59,800,800,0,0
16917,2019-05-02,297,0,297,23,320,320,0,0
16918,2019-05-02,3121,0,3121,249,3370,3370,0,0
16919,2019-05-02,2723,0,2723,217,2940,2940,0,0
16920,2019-05-02,362,0,362,28,390,390,0,0
16921,2019-05-02,778,0,778,62,840,840,0,0
16922,2019-05-02,565,0,565,45,610,610,0,0
16923,2019-05-02,675,0,675,45,720,720,0,0
16924,2019-05-02,260,0,260,20,280,280,0,0
16925,2019-05-02,269,0,269,21,290,290,0,0
16926,2019-05-02,510,0,510,40,550,550,0,0
16927,2019-05-02,1649,0,1649,131,1780,1780,0,0
16928,2019-05-02,334,0,334,26,360,360,0,0
16929,2019-05-02,445,0,445,35,480,480,0,0
16930,2019-05-02,778,0,778,62,840,840,0,0
16931,2019-05-02,269,0,269,21,290,290,0,0
16932,2019-05-02,2297,0,2297,183,2480,2480,0,0
16933,2019-05-02,306,0,306,24,330,330,0,0
16934,2019-05-02,277,0,277,13,290,290,0,0
16935,2019-05-02,399,0,399,31,430,430,0,0
16936,2019-05-02,399,0,399,31,430,430,0,0
16937,2019-05-02,491,0,491,39,530,530,0,0
16938,2019-05-02,528,0,528,42,570,570,0,0
16939,2019-05-02,167,0,167,13,180,180,0,0
16940,2019-05-02,1936,0,1936,154,2090,2090,0,0
16941,2019-05-02,408,0,408,32,440,440,0,0
16942,2019-05-02,2723,0,2723,217,2940,2940,0,0
16943,2019-05-02,491,0,491,39,530,530,0,0
16944,2019-05-02,306,0,306,24,330,330,0,0
16945,2019-05-02,916,0,916,64,980,980,0,0
16946,2019-05-02,1186,0,1186,94,1280,1280,0,0
16947,2019-05-02,1334,0,1334,106,1440,1440,0,0
16948,2019-05-02,5445,0,5445,435,5880,5880,0,0
16949,2019-05-02,1473,0,1473,117,1590,1590,0,0
16950,2019-05-02,1639,0,1639,131,1770,1770,0,0
16951,2019-05-02,1139,0,1139,91,1230,1230,0,0
16952,2019-05-02,288,0,288,22,310,310,0,0
16953,2019-05-02,788,0,788,62,850,850,0,0
16954,2019-05-02,269,0,269,21,290,290,0,0
16955,2019-05-02,1815,0,1815,145,1960,1960,0,0
16956,2019-05-02,1815,0,1815,145,1960,1960,0,0
16957,2019-05-02,908,0,908,72,980,980,0,0
16958,2019-05-02,1510,0,1510,120,1630,1630,0,0
16959,2019-05-02,815,0,815,65,880,880,0,0
16960,2019-05-02,1038,0,1038,82,1120,1120,0,0
16961,2019-05-02,491,0,491,39,530,530,0,0
16962,2019-05-02,667,0,667,53,720,720,0,0
16963,2019-05-02,1667,0,1667,133,1800,1800,0,0
16964,2019-05-02,473,0,473,37,510,510,0,0
16965,2019-05-02,908,0,908,72,980,980,0,0
16966,2019-05-02,343,0,343,27,370,370,0,0
16967,2019-05-02,751,0,751,59,810,810,0,0
16968,2019-05-02,473,0,473,37,510,510,0,0
16969,2019-05-02,778,0,778,62,840,840,0,0
16970,2019-05-02,880,0,880,70,950,950,0,0
16971,2019-05-02,954,0,954,76,1030,1030,0,0
16972,2019-05-02,899,0,899,71,970,970,0,0
16973,2019-05-02,416,0,416,24,440,440,0,0
16974,2019-05-02,251,0,251,19,270,270,0,0
16975,2019-05-02,1538,0,1538,122,1660,1660,0,0
16976,2019-05-02,443,0,443,17,460,460,0,0
16977,2019-05-02,908,0,908,72,980,980,0,0
16978,2019-05-02,1038,0,1038,82,1120,1120,0,0
16979,2019-05-02,1195,0,1195,95,1290,1290,0,0
16980,2019-05-02,1463,0,1463,117,1580,1580,0,0
16981,2019-05-02,399,0,399,31,430,430,0,0
16982,2019-05-02,241,0,241,19,260,260,0,0
16983,2019-05-02,1436,0,1436,114,1550,1550,0,0
16984,2019-05-02,232,0,232,18,250,250,0,0
16985,2019-05-02,167,0,167,13,180,180,0,0
16986,2019-05-02,565,0,565,45,610,610,0,0
16987,2019-05-02,1028,0,1028,82,1110,1110,0,0
16988,2019-05-02,998,-212,786,62,848,848,0,0
16989,2019-05-02,362,0,362,28,390,390,0,0
16990,2019-05-02,963,0,963,77,1040,1040,0,0
16991,2019-05-02,325,0,325,25,350,350,0,0
16992,2019-05-02,1815,0,1815,145,1960,1960,0,0
16993,2019-05-02,797,0,797,63,860,860,0,0
16994,2019-05-02,2723,0,2723,217,2940,2940,0,0
16995,2019-05-02,1056,0,1056,84,1140,0,1140,0
16996,2019-05-02,2723,0,2723,217,2940,2940,0,0
16997,2019-05-02,908,0,908,72,980,980,0,0
16998,2019-05-02,908,0,908,72,980,980,0,0
16999,2019-05-02,2723,0,2723,217,2940,2940,0,0
17000,2019-05-02,908,0,908,72,980,980,0,0
17001,2019-05-02,908,0,908,72,980,980,0,0
17002,2019-05-02,1038,0,1038,82,1120,1120,0,0
17003,2019-05-02,1121,0,1121,89,1210,1210,0,0
17004,2019-05-02,908,0,908,72,980,980,0,0
17005,2019-05-02,862,0,862,68,930,930,0,0
17006,2019-05-02,1527,0,1527,113,1640,1640,0,0
17007,2019-05-02,602,0,602,48,650,650,0,0
17008,2019-05-02,1806,0,1806,144,1950,0,1950,0
17009,2019-05-02,1815,0,1815,145,1960,1960,0,0
17010,2019-05-02,3630,0,3630,290,3920,3920,0,0
17011,2019-05-02,760,0,760,60,820,820,0,0
17012,2019-05-02,751,0,751,59,810,810,0,0
17013,2019-05-03,116,0,116,9,125,125,0,0
17014,2019-05-03,232,0,232,18,250,250,0,0
17015,2019-05-03,1982,0,1982,158,2140,2140,0,0
17016,2019-05-03,1815,0,1815,145,1960,1960,0,0
17017,2019-05-03,1167,0,1167,93,1260,1260,0,0
17018,2019-05-03,491,0,491,39,530,530,0,0
17019,2019-05-03,676,0,676,54,730,730,0,0
17020,2019-05-03,463,0,463,37,500,0,500,0
17021,2019-05-03,1815,0,1815,145,1960,1960,0,0
17022,2019-05-03,389,0,389,31,420,420,0,0
17023,2019-05-03,1963,0,1963,157,2120,2120,0,0
17024,2019-05-03,908,0,908,72,980,980,0,0
17025,2019-05-03,445,0,445,35,480,480,0,0
17026,2019-05-03,630,0,630,50,680,680,0,0
17027,2019-05-03,334,0,334,26,360,360,0,0
17028,2019-05-03,334,0,334,26,360,360,0,0
17029,2019-05-03,1167,0,1167,93,1260,1260,0,0
17030,2019-05-03,1834,0,1834,146,1980,0,1980,0
17031,2019-05-03,1362,0,1362,108,1470,1470,0,0
17032,2019-05-03,491,0,491,39,530,530,0,0
17033,2019-05-03,1315,0,1315,105,1420,0,1420,0
17034,2019-05-03,1769,0,1769,141,1910,1910,0,0
17035,2019-05-03,454,0,454,36,490,490,0,0
17036,2019-05-03,1732,0,1732,138,1870,1870,0,0
17037,2019-05-03,704,0,704,56,760,0,760,0
17038,2019-05-03,167,0,167,13,180,180,0,0
17039,2019-05-03,528,0,528,42,570,570,0,0
17040,2019-05-03,1149,0,1149,91,1240,1240,0,0
17041,2019-05-03,362,0,362,28,390,390,0,0
17042,2019-05-03,1815,0,1815,145,1960,1960,0,0
17043,2019-05-03,1815,0,1815,145,1960,1960,0,0
17044,2019-05-03,1251,0,1251,99,1350,0,1350,0
17045,2019-05-03,1167,0,1167,93,1260,1260,0,0
17046,2019-05-03,973,0,973,77,1050,1050,0,0
17047,2019-05-03,1028,0,1028,82,1110,1110,0,0
17048,2019-05-03,334,0,334,26,360,360,0,0
17049,2019-05-03,806,0,806,64,870,870,0,0
17050,2019-05-03,491,0,491,39,530,530,0,0
17051,2019-05-03,889,0,889,71,960,960,0,0
17052,2019-05-03,880,0,880,70,950,950,0,0
17053,2019-05-03,371,0,371,29,400,400,0,0
17054,2019-05-03,389,0,389,31,420,420,0,0
17055,2019-05-03,416,0,416,24,440,440,0,0
17056,2019-05-03,1195,0,1195,95,1290,1290,0,0
17057,2019-05-03,1223,0,1223,97,1320,1320,0,0
17058,2019-05-03,1019,0,1019,81,1100,1100,0,0
17059,2019-05-03,621,0,621,49,670,670,0,0
17060,2019-05-03,769,0,769,61,830,830,0,0
17061,2019-05-03,417,0,417,33,450,450,0,0
17062,2019-05-03,167,0,167,13,180,180,0,0
17063,2019-05-03,1195,0,1195,95,1290,1290,0,0
17064,2019-05-03,334,0,334,26,360,360,0,0
17065,2019-05-03,723,0,723,57,780,780,0,0
17066,2019-05-03,973,0,973,77,1050,1050,0,0
17067,2019-05-03,602,0,602,48,650,650,0,0
17068,2019-05-03,945,0,945,75,1020,1020,0,0
17069,2019-05-03,704,0,704,56,760,760,0,0
17070,2019-05-03,1732,0,1732,138,1870,1870,0,0
17071,2019-05-03,149,0,149,11,160,160,0,0
17072,2019-05-03,1056,0,1056,84,1140,1140,0,0
17073,2019-05-03,204,0,204,16,220,220,0,0
17074,2019-05-03,1223,0,1223,97,1320,1320,0,0
17075,2019-05-03,362,0,362,28,390,390,0,0
17076,2019-05-03,510,0,510,40,550,550,0,0
17077,2019-05-03,2723,0,2723,217,2940,2940,0,0
17078,2019-05-03,389,0,389,31,420,420,0,0
17079,2019-05-03,1718,0,1718,137,1855,1855,0,0
17080,2019-05-03,2723,0,2723,217,2940,2940,0,0
17081,2019-05-03,786,0,786,54,840,840,0,0
17082,2019-05-03,778,0,778,62,840,840,0,0
17083,2019-05-03,1482,0,1482,118,1600,1600,0,0
17084,2019-05-03,843,0,843,67,910,0,910,0
17085,2019-05-03,760,0,760,60,820,820,0,0
17086,2019-05-03,491,0,491,39,530,530,0,0
17087,2019-05-03,408,0,408,32,440,440,0,0
17088,2019-05-03,1815,0,1815,145,1960,1960,0,0
17089,2019-05-03,149,0,149,11,160,160,0,0
17090,2019-05-03,445,0,445,35,480,480,0,0
17091,2019-05-03,288,0,288,22,310,310,0,0
17092,2019-05-03,843,0,843,67,910,910,0,0
17093,2019-05-03,232,0,232,18,250,250,0,0
17094,2019-05-03,1167,0,1167,93,1260,1260,0,0
17095,2019-05-03,528,0,528,42,570,570,0,0
17096,2019-05-03,815,0,815,65,880,880,0,0
17097,2019-05-03,250,0,250,20,270,270,0,0
17098,2019-05-03,1371,0,1371,109,1480,1480,0,0
17099,2019-05-03,362,0,362,28,390,390,0,0
17100,2019-05-03,445,0,445,35,480,480,0,0
17101,2019-05-03,973,0,973,77,1050,0,1050,0
17102,2019-05-03,925,0,925,65,990,990,0,0
17103,2019-05-03,649,0,649,51,700,700,0,0
17104,2019-05-03,2352,0,2352,188,2540,2540,0,0
17105,2019-05-03,1815,0,1815,145,1960,1960,0,0
17106,2019-05-03,908,0,908,72,980,980,0,0
17107,2019-05-03,1501,0,1501,119,1620,1620,0,0
17108,2019-05-03,843,0,843,67,910,910,0,0
17109,2019-05-03,1186,0,1186,94,1280,1280,0,0
17110,2019-05-03,917,0,917,73,990,0,990,0
17111,2019-05-03,167,0,167,13,180,180,0,0
17112,2019-05-03,121,0,121,9,130,130,0,0
17113,2019-05-03,575,0,575,45,620,620,0,0
17114,2019-05-03,982,0,982,78,1060,1060,0,0
17115,2019-05-03,501,0,501,39,540,540,0,0
17116,2019-05-03,528,0,528,42,570,570,0,0
17117,2019-05-03,491,0,491,39,530,530,0,0
17118,2019-05-03,167,0,167,13,180,180,0,0
17119,2019-05-03,825,0,825,65,890,890,0,0
17120,2019-05-03,899,0,899,71,970,970,0,0
17121,2019-05-03,676,0,676,54,730,730,0,0
17122,2019-05-03,1352,0,1352,108,1460,1460,0,0
17123,2019-05-03,1675,0,1675,125,1800,1800,0,0
17124,2019-05-03,1751,0,1751,139,1890,1890,0,0
17125,2019-05-03,1675,0,1675,125,1800,1800,0,0
17126,2019-05-03,732,0,732,58,790,790,0,0
17127,2019-05-03,232,0,232,18,250,250,0,0
17128,2019-05-03,1954,0,1954,156,2110,2110,0,0
17129,2019-05-03,945,0,945,75,1020,0,1020,0
17130,2019-05-03,1149,0,1149,91,1240,1240,0,0
17131,2019-05-03,695,0,695,55,750,750,0,0
17132,2019-05-03,510,0,510,40,550,550,0,0
17133,2019-05-03,788,0,788,62,850,850,0,0
17134,2019-05-03,1047,0,1047,83,1130,1130,0,0
17135,2019-05-03,325,0,325,25,350,350,0,0
17136,2019-05-03,454,0,454,36,490,490,0,0
17137,2019-05-03,741,0,741,59,800,800,0,0
17138,2019-05-03,751,0,751,59,810,810,0,0
17139,2019-05-03,204,0,204,16,220,220,0,0
17140,2019-05-03,2723,0,2723,217,2940,2940,0,0
17141,2019-05-03,2723,0,2723,217,2940,2940,0,0
17142,2019-05-03,686,0,686,54,740,740,0,0
17143,2019-05-03,788,0,788,62,850,850,0,0
17144,2019-05-03,1158,0,1158,92,1250,1250,0,0
17145,2019-05-03,830,0,830,40,870,870,0,0
17146,2019-05-03,260,0,260,20,280,280,0,0
17147,2019-05-03,112,0,112,8,120,120,0,0
17148,2019-05-03,204,0,204,16,220,220,0,0
17149,2019-05-03,1362,0,1362,108,1470,1470,0,0
17150,2019-05-03,232,0,232,18,250,250,0,0
17151,2019-05-03,385,0,385,30,415,415,0,0
17152,2019-05-03,1232,0,1232,98,1330,1330,0,0
17153,2019-05-03,778,0,778,62,840,840,0,0
17154,2019-05-03,260,0,260,20,280,280,0,0
17155,2019-05-03,47,0,47,3,50,50,0,0
17156,2019-05-03,371,0,371,29,400,400,0,0
17157,2019-05-03,778,0,778,62,840,840,0,0
17158,2019-05-03,389,0,389,31,420,420,0,0
17159,2019-05-03,389,0,389,31,420,420,0,0
17160,2019-05-03,778,0,778,62,840,840,0,0
17161,2019-05-03,232,0,232,18,250,250,0,0
17162,2019-05-03,389,0,389,31,420,420,0,0
17163,2019-05-03,399,0,399,31,430,430,0,0
17164,2019-05-03,181,0,181,14,195,195,0,0
17165,2019-05-03,1176,0,1176,94,1270,1270,0,0
17166,2019-05-03,501,0,501,39,540,540,0,0
17167,2019-05-03,343,0,343,27,370,370,0,0
17168,2019-05-03,343,0,343,27,370,370,0,0
17169,2019-05-03,1176,0,1176,94,1270,1270,0,0
17170,2019-05-03,149,0,149,11,160,160,0,0
17171,2019-05-03,269,0,269,21,290,290,0,0
17172,2019-05-03,260,0,260,20,280,280,0,0
17173,2019-05-03,991,0,991,79,1070,1070,0,0
17174,2019-05-03,1778,0,1778,142,1920,1920,0,0
17175,2019-05-03,501,0,501,39,540,0,540,0
17176,2019-05-03,417,0,417,33,450,450,0,0
17177,2019-05-03,1084,0,1084,86,1170,1170,0,0
17178,2019-05-03,556,0,556,44,600,600,0,0
17179,2019-05-03,565,0,565,45,610,610,0,0
17180,2019-05-03,482,0,482,38,520,520,0,0
17181,2019-05-03,1815,0,1815,145,1960,0,1960,0
17182,2019-05-03,880,0,880,70,950,950,0,0
17183,2019-05-03,2723,0,2723,217,2940,2940,0,0
17184,2019-05-03,380,0,380,30,410,410,0,0
17185,2019-05-03,1815,0,1815,145,1960,1960,0,0
17186,2019-05-03,315,0,315,25,340,340,0,0
17187,2019-05-03,306,0,306,24,330,330,0,0
17188,2019-05-03,602,0,602,48,650,650,0,0
17189,2019-05-03,834,0,834,66,900,900,0,0
17190,2019-05-03,334,0,334,26,360,360,0,0
17191,2019-05-03,1408,0,1408,112,1520,1520,0,0
17192,2019-05-03,1862,0,1862,148,2010,0,2010,0
17193,2019-05-03,4019,0,4019,321,4340,0,4340,0
17194,2019-05-03,334,0,334,26,360,360,0,0
17195,2019-05-03,954,0,954,76,1030,1030,0,0
17196,2019-05-03,630,0,630,50,680,680,0,0
17197,2019-05-03,1130,0,1130,90,1220,1220,0,0
17198,2019-05-03,389,0,389,31,420,420,0,0
17199,2019-05-03,704,0,704,56,760,760,0,0
17200,2019-05-03,325,0,325,25,350,350,0,0
17201,2019-05-03,1010,0,1010,80,1090,1090,0,0
17202,2019-05-03,723,0,723,57,780,780,0,0
17203,2019-05-03,880,0,880,70,950,950,0,0
17204,2019-05-03,315,0,315,25,340,340,0,0
17205,2019-05-03,112,0,112,8,120,120,0,0
17206,2019-05-03,1075,0,1075,85,1160,1160,0,0
17207,2019-05-03,556,0,556,44,600,600,0,0
17208,2019-05-03,1908,0,1908,152,2060,2060,0,0
17209,2019-05-03,1001,0,1001,79,1080,1080,0,0
17210,2019-05-03,463,0,463,37,500,500,0,0
17211,2019-05-03,1315,0,1315,105,1420,1420,0,0
17212,2019-05-03,1047,0,1047,83,1130,1130,0,0
17213,2019-05-03,1325,0,1325,105,1430,1430,0,0
17214,2019-05-03,1815,0,1815,145,1960,0,1960,0
17215,2019-05-03,1158,0,1158,92,1250,1250,0,0
17216,2019-05-03,973,0,973,77,1050,1050,0,0
17217,2019-05-03,343,0,343,27,370,370,0,0
17218,2019-05-03,1815,0,1815,145,1960,1960,0,0
17219,2019-05-03,1815,0,1815,145,1960,1960,0,0
17220,2019-05-03,1815,0,1815,145,1960,1960,0,0
17221,2019-05-03,1815,0,1815,145,1960,1960,0,0
17222,2019-05-03,1028,0,1028,82,1110,0,1110,0
17223,2019-05-03,241,0,241,19,260,260,0,0
17224,2019-05-03,399,0,399,31,430,430,0,0
17225,2019-05-03,3630,0,3630,290,3920,3920,0,0
17226,2019-05-03,1232,0,1232,98,1330,1330,0,0
17227,2019-05-03,954,0,954,76,1030,1030,0,0
17228,2019-05-03,510,0,510,40,550,550,0,0
17229,2019-05-03,593,0,593,47,640,640,0,0
17230,2019-05-03,723,0,723,57,780,780,0,0
17231,2019-05-03,1658,0,1658,132,1790,1790,0,0
17232,2019-05-03,1815,0,1815,145,1960,1960,0,0
17233,2019-05-03,676,0,676,54,730,730,0,0
17234,2019-05-03,389,0,389,31,420,420,0,0
17235,2019-05-03,908,0,908,72,980,980,0,0
17236,2019-05-03,723,0,723,57,780,780,0,0
17237,2019-05-03,528,0,528,42,570,570,0,0
17238,2019-05-03,1130,0,1130,90,1220,1220,0,0
17239,2019-05-03,612,0,612,48,660,660,0,0
17240,2019-05-03,2723,0,2723,217,2940,2940,0,0
17241,2019-05-03,908,0,908,72,980,0,980,0
17242,2019-05-03,519,0,519,41,560,560,0,0
17243,2019-05-03,1241,0,1241,99,1340,1340,0,0
17244,2019-05-03,3630,0,3630,290,3920,0,3920,0
17245,2019-05-03,1278,0,1278,102,1380,1380,0,0
17246,2019-05-03,908,0,908,72,980,980,0,0
17247,2019-05-03,528,0,528,42,570,570,0,0
17248,2019-05-03,2723,0,2723,217,2940,2940,0,0
17249,2019-05-03,195,0,195,15,210,210,0,0
17250,2019-05-03,288,0,288,22,310,310,0,0
17251,2019-05-03,269,0,269,21,290,290,0,0
17252,2019-05-03,371,0,371,29,400,400,0,0
17253,2019-05-03,1149,0,1149,91,1240,1240,0,0
17254,2019-05-03,501,0,501,39,540,540,0,0
17255,2019-05-03,260,0,260,20,280,280,0,0
17256,2019-05-03,362,0,362,28,390,390,0,0
17257,2019-05-03,1482,0,1482,118,1600,0,1600,0
17258,2019-05-03,788,0,788,62,850,850,0,0
17259,2019-05-03,1288,0,1288,102,1390,1390,0,0
17260,2019-05-03,232,0,232,18,250,250,0,0
17261,2019-05-03,130,0,130,10,140,140,0,0
17262,2019-05-03,1130,0,1130,90,1220,1220,0,0
17263,2019-05-03,1991,0,1991,159,2150,2150,0,0
17264,2019-05-03,1815,0,1815,145,1960,1960,0,0
17265,2019-05-03,908,0,908,72,980,980,0,0
17266,2019-05-03,686,0,686,54,740,740,0,0
17267,2019-05-03,-1815,0,-1815,-145,-1960,-1960,0,0
17268,2019-05-03,380,0,380,30,410,410,0,0
17269,2019-05-03,2399,0,2399,191,2590,2590,0,0
17270,2019-05-03,1815,0,1815,145,1960,1960,0,0
17271,2019-05-03,481,0,481,29,510,510,0,0
17272,2019-05-03,297,0,297,23,320,320,0,0
17273,2019-05-03,362,0,362,28,390,390,0,0
17274,2019-05-03,1786,0,1786,134,1920,1920,0,0
17275,2019-05-03,1815,0,1815,145,1960,1960,0,0
17276,2019-05-03,1815,0,1815,145,1960,1960,0,0
17277,2019-05-03,1815,0,1815,145,1960,1960,0,0
17278,2019-05-03,2723,0,2723,217,2940,2940,0,0
17279,2019-05-04,149,0,149,11,160,160,0,0
17280,2019-05-04,1815,0,1815,145,1960,1960,0,0
17281,2019-05-04,741,0,741,59,800,800,0,0
17282,2019-05-04,2001,0,2001,159,2160,2160,0,0
17283,2019-05-04,110,0,110,0,110,110,0,0
17284,2019-05-04,1038,0,1038,82,1120,1120,0,0
17285,2019-05-04,249,0,249,11,260,260,0,0
17286,2019-05-04,528,0,528,42,570,570,0,0
17287,2019-05-04,481,0,481,29,510,510,0,0
17288,2019-05-04,1033,0,1033,82,1115,1115,0,0
17289,2019-05-04,1352,0,1352,108,1460,1460,0,0
17290,2019-05-04,746,0,746,24,770,770,0,0
17291,2019-05-04,2093,0,2093,167,2260,2260,0,0
17292,2019-05-04,1815,0,1815,145,1960,1960,0,0
17293,2019-05-04,167,0,167,13,180,180,0,0
17294,2019-05-04,167,0,167,13,180,180,0,0
17295,2019-05-04,195,0,195,15,210,210,0,0
17296,2019-05-04,908,0,908,72,980,980,0,0
17297,2019-05-04,1649,0,1649,131,1780,1780,0,0
17298,2019-05-04,2723,0,2723,217,2940,2940,0,0
17299,2019-05-04,852,0,852,68,920,920,0,0
17300,2019-05-04,962,0,962,68,1030,1030,0,0
17301,2019-05-04,454,0,454,36,490,490,0,0
17302,2019-05-04,612,0,612,48,660,660,0,0
17303,2019-05-04,1112,0,1112,88,1200,1200,0,0
17304,2019-05-04,1963,0,1963,157,2120,2120,0,0
17305,2019-05-04,1630,0,1630,130,1760,1760,0,0
17306,2019-05-04,862,0,862,68,930,930,0,0
17307,2019-05-04,2121,0,2121,169,2290,0,2290,0
17308,2019-05-04,1241,0,1241,99,1340,1340,0,0
17309,2019-05-04,1815,0,1815,145,1960,1960,0,0
17310,2019-05-04,908,0,908,72,980,980,0,0
17311,2019-05-04,139,0,139,11,150,150,0,0
17312,2019-05-04,806,0,806,64,870,870,0,0
17313,2019-05-04,2723,0,2723,217,2940,2940,0,0
17314,2019-05-04,1815,0,1815,145,1960,1960,0,0
17315,2019-05-04,1204,0,1204,96,1300,1300,0,0
17316,2019-05-04,917,0,917,73,990,990,0,0
17317,2019-05-04,1695,0,1695,135,1830,1830,0,0
17318,2019-05-04,1075,0,1075,85,1160,1160,0,0
17319,2019-05-04,908,0,908,72,980,980,0,0
17320,2019-05-04,954,0,954,76,1030,1030,0,0
17321,2019-05-04,1584,0,1584,126,1710,1710,0,0
17322,2019-05-04,1028,0,1028,82,1110,1110,0,0
17323,2019-05-04,1445,0,1445,115,1560,1560,0,0
17324,2019-05-04,1306,0,1306,104,1410,1410,0,0
17325,2019-05-04,1176,0,1176,94,1270,1270,0,0
17326,2019-05-04,260,0,260,20,280,280,0,0
17327,2019-05-04,1889,0,1889,151,2040,2040,0,0
17328,2019-05-04,584,0,584,46,630,630,0,0
17329,2019-05-04,139,0,139,11,150,150,0,0
17330,2019-05-04,612,0,612,48,660,660,0,0
17331,2019-05-04,889,0,889,71,960,960,0,0
17332,2019-05-04,1047,0,1047,83,1130,0,1130,0
17333,2019-05-04,991,0,991,79,1070,1070,0,0
17334,2019-05-04,362,0,362,28,390,390,0,0
17335,2019-05-04,473,0,473,37,510,510,0,0
17336,2019-05-04,1713,0,1713,137,1850,1850,0,0
17337,2019-05-04,519,0,519,41,560,560,0,0
17338,2019-05-04,167,0,167,13,180,180,0,0
17339,2019-05-04,260,0,260,20,280,280,0,0
17340,2019-05-04,880,0,880,70,950,950,0,0
17341,2019-05-04,1556,0,1556,124,1680,1680,0,0
17342,2019-05-04,315,0,315,25,340,340,0,0
17343,2019-05-04,482,0,482,38,520,520,0,0
17344,2019-05-04,2107,0,2107,168,2275,2275,0,0
17345,2019-05-04,667,0,667,53,720,720,0,0
17346,2019-05-04,695,0,695,55,750,750,0,0
17347,2019-05-04,908,0,908,72,980,980,0,0
17348,2019-05-04,899,0,899,71,970,970,0,0
17349,2019-05-04,334,0,334,26,360,360,0,0
17350,2019-05-04,1815,0,1815,145,1960,1960,0,0
17351,2019-05-04,491,0,491,39,530,530,0,0
17352,2019-05-04,547,0,547,43,590,590,0,0
17353,2019-05-04,621,0,621,49,670,670,0,0
17354,2019-05-04,2288,0,2288,182,2470,2470,0,0
17355,2019-05-04,2325,0,2325,185,2510,2510,0,0
17356,2019-05-04,232,0,232,18,250,250,0,0
17357,2019-05-04,259,0,259,11,270,270,0,0
17358,2019-05-04,47,0,47,3,50,50,0,0
17359,2019-05-04,454,0,454,36,490,490,0,0
17360,2019-05-04,362,0,362,28,390,390,0,0
17361,2019-05-04,413,0,413,32,445,445,0,0
17362,2019-05-04,667,0,667,53,720,720,0,0
17363,2019-05-04,251,0,251,19,270,270,0,0
17364,2019-05-04,862,0,862,68,930,930,0,0
17365,2019-05-04,880,0,880,70,950,950,0,0
17366,2019-05-04,1815,0,1815,145,1960,1960,0,0
17367,2019-05-04,769,0,769,61,830,830,0,0
17368,2019-05-04,834,0,834,66,900,900,0,0
17369,2019-05-04,1686,0,1686,134,1820,1820,0,0
17370,2019-05-04,389,0,389,31,420,420,0,0
17371,2019-05-04,528,0,528,42,570,570,0,0
17372,2019-05-04,1232,0,1232,98,1330,1330,0,0
17373,2019-05-04,852,0,852,68,920,920,0,0
17374,2019-05-04,825,0,825,65,890,890,0,0
17375,2019-05-04,852,0,852,68,920,920,0,0
17376,2019-05-04,769,0,769,61,830,830,0,0
17377,2019-05-04,1499,0,1499,111,1610,1610,0,0
17378,2019-05-04,389,0,389,31,420,420,0,0
17379,2019-05-04,561,0,561,44,605,605,0,0
17380,2019-05-04,1556,0,1556,124,1680,1680,0,0
17381,2019-05-04,1084,0,1084,86,1170,1170,0,0
17382,2019-05-04,676,0,676,54,730,0,730,0
17383,2019-05-04,936,0,936,74,1010,1010,0,0
17384,2019-05-04,936,0,936,74,1010,1010,0,0
17385,2019-05-04,1047,0,1047,83,1130,1130,0,0
17386,2019-05-04,232,0,232,18,250,250,0,0
17387,2019-05-04,500,0,500,40,540,540,0,0
17388,2019-05-04,1001,0,1001,79,1080,1080,0,0
17389,2019-05-04,426,0,426,34,460,460,0,0
17390,2019-05-04,1408,0,1408,112,1520,1520,0,0
17391,2019-05-04,269,0,269,21,290,290,0,0
17392,2019-05-04,731,0,731,49,780,780,0,0
17393,2019-05-04,528,0,528,42,570,570,0,0
17394,2019-05-04,797,0,797,63,860,860,0,0
17395,2019-05-04,315,0,315,25,340,340,0,0
17396,2019-05-04,1010,0,1010,80,1090,1090,0,0
17397,2019-05-04,825,0,825,65,890,890,0,0
17398,2019-05-04,334,0,334,26,360,360,0,0
17399,2019-05-04,593,0,593,47,640,640,0,0
17400,2019-05-04,269,0,269,21,290,290,0,0
17401,2019-05-04,565,0,565,45,610,610,0,0
17402,2019-05-04,797,0,797,63,860,860,0,0
17403,2019-05-04,1907,0,1907,143,2050,2050,0,0
17404,2019-05-04,277,0,277,13,290,290,0,0
17405,2019-05-04,686,0,686,54,740,740,0,0
17406,2019-05-04,769,0,769,61,830,830,0,0
17407,2019-05-04,426,0,426,34,460,460,0,0
17408,2019-05-04,805,0,805,55,860,860,0,0
17409,2019-05-04,2482,0,2482,198,2680,2680,0,0
17410,2019-05-04,1093,0,1093,87,1180,1180,0,0
17411,2019-05-04,1223,0,1223,97,1320,1320,0,0
17412,2019-05-04,565,0,565,45,610,610,0,0
17413,2019-05-04,778,0,778,62,840,840,0,0
17414,2019-05-04,1038,0,1038,82,1120,1120,0,0
17415,2019-05-04,2399,0,2399,191,2590,0,2590,0
17416,2019-05-04,732,0,732,58,790,790,0,0
17417,2019-05-04,491,0,491,39,530,530,0,0
17418,2019-05-04,788,0,788,62,850,850,0,0
17419,2019-05-04,1667,0,1667,133,1800,1800,0,0
17420,2019-05-04,982,0,982,78,1060,1060,0,0
17421,2019-05-04,-491,0,-491,-39,-530,-530,0,0
17422,2019-05-04,371,0,371,29,400,400,0,0
17423,2019-05-04,556,0,556,44,600,600,0,0
17424,2019-05-04,880,0,880,70,950,950,0,0
17425,2019-05-04,1176,0,1176,94,1270,1270,0,0
17426,2019-05-04,186,0,186,14,200,200,0,0
17427,2019-05-04,362,0,362,28,390,390,0,0
17428,2019-05-04,630,0,630,50,680,680,0,0
17429,2019-05-04,334,0,334,26,360,360,0,0
17430,2019-05-04,732,0,732,58,790,790,0,0
17431,2019-05-04,1010,0,1010,80,1090,0,1090,0
17432,2019-05-04,232,0,232,18,250,250,0,0
17433,2019-05-04,334,0,334,26,360,360,0,0
17434,2019-05-04,1501,0,1501,119,1620,1620,0,0
17435,2019-05-04,306,0,306,24,330,330,0,0
17436,2019-05-04,2436,0,2436,194,2630,2630,0,0
17437,2019-05-04,362,0,362,28,390,390,0,0
17438,2019-05-04,1167,0,1167,93,1260,1260,0,0
17439,2019-05-04,1639,0,1639,131,1770,0,1770,0
17440,2019-05-04,260,0,260,20,280,280,0,0
17441,2019-05-04,334,0,334,26,360,360,0,0
17442,2019-05-04,167,0,167,13,180,180,0,0
17443,2019-05-04,1010,0,1010,80,1090,1090,0,0
17444,2019-05-04,306,0,306,24,330,330,0,0
17445,2019-05-04,584,0,584,46,630,630,0,0
17446,2019-05-04,611,0,611,39,650,650,0,0
17447,2019-05-04,602,0,602,48,650,650,0,0
17448,2019-05-04,3667,0,3667,293,3960,3960,0,0
17449,2019-05-04,2001,0,2001,159,2160,2160,0,0
17450,2019-05-04,454,0,454,36,490,490,0,0
17451,2019-05-04,741,0,741,59,800,800,0,0
17452,2019-05-04,2806,0,2806,224,3030,3030,0,0
17453,2019-05-04,556,0,556,44,600,600,0,0
17454,2019-05-04,852,0,852,68,920,920,0,0
17455,2019-05-04,528,0,528,42,570,0,570,0
17456,2019-05-04,510,0,510,40,550,550,0,0
17457,2019-05-04,389,0,389,31,420,420,0,0
17458,2019-05-04,399,0,399,31,430,430,0,0
17459,2019-05-04,528,0,528,42,570,570,0,0
17460,2019-05-04,278,0,278,22,300,300,0,0
17461,2019-05-04,556,0,556,44,600,600,0,0
17462,2019-05-04,491,0,491,39,530,530,0,0
17463,2019-05-04,186,0,186,14,200,200,0,0
17464,2019-05-04,472,0,472,37,509,509,0,0
17465,2019-05-04,232,0,232,18,250,250,0,0
17466,2019-05-04,908,0,908,72,980,980,0,0
17467,2019-05-04,908,0,908,72,980,980,0,0
17468,2019-05-04,1129,0,1129,81,1210,1210,0,0
17469,2019-05-04,1815,0,1815,145,1960,1960,0,0
17470,2019-05-04,389,0,389,31,420,420,0,0
17471,2019-05-04,880,0,880,70,950,950,0,0
17472,2019-05-04,741,0,741,59,800,800,0,0
17473,2019-05-04,2723,0,2723,217,2940,2940,0,0
17474,2019-05-04,908,0,908,72,980,980,0,0
17475,2019-05-04,1675,0,1675,125,1800,1800,0,0
17476,2019-05-04,991,0,991,79,1070,1070,0,0
17477,2019-05-04,167,0,167,13,180,180,0,0
17478,2019-05-04,1925,0,1925,145,2070,2070,0,0
17479,2019-05-04,2277,0,2277,173,2450,0,2450,0
17480,2019-05-04,213,0,213,17,230,230,0,0
17481,2019-05-04,269,0,269,21,290,290,0,0
17482,2019-05-04,612,0,612,48,660,660,0,0
17483,2019-05-04,917,0,917,73,990,990,0,0
17484,2019-05-04,1259,0,1259,91,1350,1350,0,0
17485,2019-05-04,1251,0,1251,99,1350,1350,0,0
17486,2019-05-04,389,0,389,31,420,420,0,0
17487,2019-05-04,389,0,389,31,420,420,0,0
17488,2019-05-04,1297,0,1297,103,1400,1400,0,0
17489,2019-05-04,991,0,991,79,1070,1070,0,0
17490,2019-05-04,343,0,343,27,370,370,0,0
17491,2019-05-04,1009,0,1009,71,1080,1080,0,0
17492,2019-05-04,898,0,898,62,960,960,0,0
17493,2019-05-04,760,0,760,60,820,820,0,0
17494,2019-05-04,1482,0,1482,118,1600,1600,0,0
17495,2019-05-04,1843,0,1843,147,1990,1990,0,0
17496,2019-05-04,297,0,297,23,320,320,0,0
17497,2019-05-04,1203,0,1203,87,1290,1290,0,0
17498,2019-05-04,362,0,362,28,390,390,0,0
17499,2019-05-04,963,0,963,77,1040,1040,0,0
17500,2019-05-04,139,0,139,11,150,150,0,0
17501,2019-05-04,362,0,362,28,390,390,0,0
17502,2019-05-04,565,0,565,45,610,610,0,0
17503,2019-05-04,362,0,362,28,390,390,0,0
17504,2019-05-04,306,0,306,24,330,330,0,0
17505,2019-05-04,371,0,371,29,400,400,0,0
17506,2019-05-04,741,0,741,59,800,800,0,0
17507,2019-05-04,1176,0,1176,94,1270,0,1270,0
17508,2019-05-04,251,0,251,19,270,270,0,0
17509,2019-05-04,213,0,213,17,230,230,0,0
17510,2019-05-04,510,0,510,40,550,550,0,0
17511,2019-05-04,667,0,667,53,720,720,0,0
17512,2019-05-04,186,0,186,14,200,200,0,0
17513,2019-05-04,510,0,510,40,550,0,550,0
17514,2019-05-04,806,0,806,64,870,870,0,0
17515,2019-05-04,741,0,741,59,800,800,0,0
17516,2019-05-04,149,0,149,11,160,160,0,0
17517,2019-05-04,1945,0,1945,155,2100,2100,0,0
17518,2019-05-04,232,0,232,18,250,250,0,0
17519,2019-05-04,232,0,232,18,250,250,0,0
17520,2019-05-04,519,0,519,41,560,560,0,0
17521,2019-05-04,462,0,462,28,490,490,0,0
17522,2019-05-05,825,0,825,65,890,890,0,0
17523,2019-05-05,1815,0,1815,145,1960,1960,0,0
17524,2019-05-05,908,0,908,72,980,980,0,0
17525,2019-05-05,908,0,908,72,980,980,0,0
17526,2019-05-05,1047,0,1047,83,1130,1130,0,0
17527,2019-05-05,1621,0,1621,129,1750,1750,0,0
17528,2019-05-05,1334,0,1334,106,1440,1440,0,0
17529,2019-05-05,3630,0,3630,290,3920,3920,0,0
17530,2019-05-05,908,0,908,72,980,980,0,0
17531,2019-05-05,1815,0,1815,145,1960,0,1960,0
17532,2019-05-05,1639,0,1639,131,1770,1770,0,0
17533,2019-05-05,482,0,482,38,520,520,0,0
17534,2019-05-05,1501,0,1501,119,1620,0,1620,0
17535,2019-05-05,1010,0,1010,80,1090,1090,0,0
17536,2019-05-05,584,0,584,46,630,630,0,0
17537,2019-05-05,362,0,362,28,390,390,0,0
17538,2019-05-05,260,0,260,20,280,280,0,0
17539,2019-05-05,575,0,575,45,620,620,0,0
17540,2019-05-05,612,0,612,48,660,660,0,0
17541,2019-05-05,760,0,760,60,820,820,0,0
17542,2019-05-05,343,0,343,27,370,370,0,0
17543,2019-05-05,482,0,482,38,520,520,0,0
17544,2019-05-05,269,0,269,21,290,290,0,0
17545,2019-05-05,1815,0,1815,145,1960,1960,0,0
17546,2019-05-05,204,0,204,16,220,220,0,0
17547,2019-05-05,399,0,399,31,430,430,0,0
17548,2019-05-05,380,0,380,30,410,410,0,0
17549,2019-05-05,908,0,908,72,980,980,0,0
17550,2019-05-05,676,0,676,54,730,730,0,0
17551,2019-05-05,2723,0,2723,217,2940,2940,0,0
17552,2019-05-05,1556,0,1556,124,1680,1680,0,0
17553,2019-05-05,445,0,445,35,480,480,0,0
17554,2019-05-05,723,0,723,57,780,780,0,0
17555,2019-05-05,954,0,954,76,1030,1030,0,0
17556,2019-05-05,463,0,463,37,500,500,0,0
17557,2019-05-05,686,0,686,54,740,740,0,0
17558,2019-05-05,269,0,269,21,290,290,0,0
17559,2019-05-05,1019,0,1019,81,1100,1100,0,0
17560,2019-05-05,278,0,278,22,300,300,0,0
17561,2019-05-05,602,0,602,48,650,650,0,0
17562,2019-05-05,352,0,352,28,380,380,0,0
17563,2019-05-05,1547,0,1547,123,1670,1670,0,0
17564,2019-05-05,1232,0,1232,98,1330,1330,0,0
17565,2019-05-05,482,0,482,38,520,520,0,0
17566,2019-05-05,1306,0,1306,104,1410,1410,0,0
17567,2019-05-05,649,0,649,51,700,700,0,0
17568,2019-05-05,2723,0,2723,217,2940,2940,0,0
17569,2019-05-05,908,0,908,72,980,980,0,0
17570,2019-05-05,749,0,749,51,800,800,0,0
17571,2019-05-05,396,-84,312,24,336,336,0,0
17572,2019-05-05,1038,0,1038,82,1120,1120,0,0
17573,2019-05-05,3649,0,3649,291,3940,3940,0,0
17574,2019-05-05,260,0,260,20,280,280,0,0
17575,2019-05-05,1028,0,1028,82,1110,1110,0,0
17576,2019-05-05,1241,0,1241,99,1340,1340,0,0
17577,2019-05-05,1862,0,1862,148,2010,2010,0,0
17578,2019-05-05,398,0,398,22,420,420,0,0
17579,2019-05-05,1621,0,1621,129,1750,1750,0,0
17580,2019-05-05,501,0,501,39,540,540,0,0
17581,2019-05-05,149,0,149,11,160,160,0,0
17582,2019-05-05,1251,0,1251,99,1350,1350,0,0
17583,2019-05-05,908,0,908,72,980,980,0,0
17584,2019-05-05,1269,0,1269,101,1370,1370,0,0
17585,2019-05-05,1269,0,1269,101,1370,1370,0,0
17586,2019-05-05,1815,0,1815,145,1960,0,1960,0
17587,2019-05-05,288,0,288,22,310,310,0,0
17588,2019-05-05,288,0,288,22,310,0,310,0
17589,2019-05-05,388,0,388,22,410,0,410,0
17590,2019-05-05,1352,0,1352,108,1460,1460,0,0
17591,2019-05-05,260,0,260,20,280,280,0,0
17592,2019-05-05,732,0,732,58,790,790,0,0
17593,2019-05-05,778,0,778,62,840,840,0,0
17594,2019-05-05,463,0,463,37,500,0,500,0
17595,2019-05-05,778,0,778,62,840,840,0,0
17596,2019-05-05,362,0,362,28,390,390,0,0
17597,2019-05-05,3362,0,3362,268,3630,3630,0,0
17598,2019-05-05,908,0,908,72,980,0,980,0
17599,2019-05-05,499,0,499,31,530,530,0,0
17600,2019-05-05,510,0,510,40,550,550,0,0
17601,2019-05-05,593,0,593,47,640,640,0,0
17602,2019-05-05,741,0,741,59,800,800,0,0
17603,2019-05-05,871,0,871,69,940,0,940,0
17604,2019-05-05,899,0,899,71,970,970,0,0
17605,2019-05-05,297,0,297,23,320,320,0,0
17606,2019-05-05,436,0,436,34,470,470,0,0
17607,2019-05-05,1815,0,1815,145,1960,1960,0,0
17608,2019-05-05,741,0,741,59,800,800,0,0
17609,2019-05-05,1010,0,1010,80,1090,1090,0,0
17610,2019-05-05,695,0,695,55,750,750,0,0
17611,2019-05-05,4538,0,4538,362,4900,4900,0,0
17612,2019-05-05,834,0,834,66,900,900,0,0
17613,2019-05-05,1815,0,1815,145,1960,1960,0,0
17614,2019-05-05,1297,0,1297,103,1400,1400,0,0
17615,2019-05-05,1815,0,1815,145,1960,1960,0,0
17616,2019-05-05,250,0,250,20,270,270,0,0
17617,2019-05-05,1213,0,1213,97,1310,0,1310,0
17618,2019-05-05,1204,0,1204,96,1300,1300,0,0
17619,2019-05-05,1676,0,1676,134,1810,1810,0,0
17620,2019-05-05,612,0,612,48,660,660,0,0
17621,2019-05-05,297,0,297,23,320,320,0,0
17622,2019-05-05,1399,0,1399,111,1510,1510,0,0
17623,2019-05-05,1815,0,1815,145,1960,1960,0,0
17624,2019-05-05,621,0,621,49,670,670,0,0
17625,2019-05-05,417,0,417,33,450,450,0,0
17626,2019-05-05,139,0,139,11,150,150,0,0
17627,2019-05-05,908,0,908,72,980,980,0,0
17628,2019-05-05,1223,0,1223,97,1320,1320,0,0
17629,2019-05-05,908,0,908,72,980,980,0,0
17630,2019-05-05,102,0,102,8,110,110,0,0
17631,2019-05-05,509,0,509,31,540,540,0,0
17632,2019-05-05,112,0,112,8,120,120,0,0
17633,2019-05-05,260,0,260,20,280,280,0,0
17634,2019-05-05,889,0,889,71,960,960,0,0
17635,2019-05-05,649,0,649,51,700,700,0,0
17636,2019-05-05,176,0,176,14,190,190,0,0
17637,2019-05-05,778,0,778,62,840,840,0,0
17638,2019-05-05,436,0,436,34,470,470,0,0
17639,2019-05-05,399,0,399,31,430,430,0,0
17640,2019-05-05,463,0,463,37,500,500,0,0
17641,2019-05-05,491,0,491,39,530,530,0,0
17642,2019-05-05,260,0,260,20,280,280,0,0
17643,2019-05-05,556,0,556,44,600,600,0,0
17644,2019-05-05,1426,0,1426,114,1540,1540,0,0
17645,2019-05-05,510,0,510,40,550,550,0,0
17646,2019-05-05,297,0,297,23,320,320,0,0
17647,2019-05-05,491,0,491,39,530,530,0,0
17648,2019-05-05,584,0,584,46,630,630,0,0
17649,2019-05-05,334,0,334,26,360,360,0,0
17650,2019-05-05,334,0,334,26,360,360,0,0
17651,2019-05-05,538,0,538,42,580,580,0,0
17652,2019-05-05,454,0,454,36,490,490,0,0
17653,2019-05-05,3306,0,3306,264,3570,3570,0,0
17654,2019-05-05,621,0,621,49,670,670,0,0
17655,2019-05-05,454,0,454,36,490,490,0,0
17656,2019-05-05,288,0,288,22,310,310,0,0
17657,2019-05-05,389,0,389,31,420,420,0,0
17658,2019-05-05,149,0,149,11,160,160,0,0
17659,2019-05-05,130,0,130,10,140,140,0,0
17660,2019-05-05,2278,0,2278,182,2460,2460,0,0
17661,2019-05-05,815,0,815,65,880,880,0,0
17662,2019-05-05,102,0,102,8,110,110,0,0
17663,2019-05-05,556,0,556,44,600,600,0,0
17664,2019-05-05,786,0,786,54,840,840,0,0
17665,2019-05-05,788,0,788,62,850,850,0,0
17666,2019-05-05,1473,0,1473,117,1590,0,1590,0
17667,2019-05-05,371,0,371,29,400,0,400,0
17668,2019-05-05,1149,0,1149,91,1240,0,1240,0
17669,2019-05-05,676,0,676,54,730,730,0,0
17670,2019-05-05,1334,0,1334,106,1440,0,1440,0
17671,2019-05-05,352,0,352,28,380,380,0,0
17672,2019-05-05,315,0,315,25,340,0,340,0
17673,2019-05-05,223,0,223,17,240,240,0,0
17674,2019-05-05,445,0,445,35,480,480,0,0
17675,2019-05-05,260,0,260,20,280,280,0,0
17676,2019-05-05,1056,0,1056,84,1140,1140,0,0
17677,2019-05-05,852,0,852,68,920,920,0,0
17678,2019-05-05,2047,0,2047,163,2210,2210,0,0
17679,2019-05-05,797,0,797,63,860,860,0,0
17680,2019-05-05,519,0,519,41,560,560,0,0
17681,2019-05-05,1278,0,1278,102,1380,1380,0,0
17682,2019-05-05,954,0,954,76,1030,1030,0,0
17683,2019-05-05,297,0,297,23,320,320,0,0
17684,2019-05-05,399,0,399,31,430,0,430,0
17685,2019-05-05,1815,0,1815,145,1960,1960,0,0
17686,2019-05-05,1426,0,1426,114,1540,1540,0,0
17687,2019-05-05,815,0,815,65,880,880,0,0
17688,2019-05-05,1815,0,1815,145,1960,1960,0,0
17689,2019-05-05,2056,0,2056,164,2220,2220,0,0
17690,2019-05-05,862,0,862,68,930,930,0,0
17691,2019-05-05,362,0,362,28,390,390,0,0
17692,2019-05-05,399,0,399,31,430,430,0,0
17693,2019-05-05,973,0,973,77,1050,1050,0,0
17694,2019-05-05,815,0,815,65,880,880,0,0
17695,2019-05-05,241,0,241,19,260,260,0,0
17696,2019-05-05,546,0,546,34,580,580,0,0
17697,2019-05-05,575,0,575,45,620,620,0,0
17698,2019-05-05,249,0,249,11,260,260,0,0
17699,2019-05-05,1658,0,1658,132,1790,1790,0,0
17700,2019-05-05,814,0,814,56,870,870,0,0
17701,2019-05-05,2723,0,2723,217,2940,2940,0,0
17702,2019-05-05,908,0,908,72,980,980,0,0
17703,2019-05-05,713,0,713,57,770,770,0,0
17704,2019-05-05,908,0,908,72,980,980,0,0
17705,2019-05-05,908,0,908,72,980,980,0,0
17706,2019-05-05,149,0,149,11,160,160,0,0
17707,2019-05-05,463,0,463,37,500,500,0,0
17708,2019-05-05,908,0,908,72,980,0,980,0
17709,2019-05-05,343,0,343,27,370,370,0,0
17710,2019-05-05,1713,0,1713,137,1850,1850,0,0
17711,2019-05-05,473,0,473,37,510,510,0,0
17712,2019-05-05,2093,0,2093,167,2260,2260,0,0
17713,2019-05-05,158,0,158,12,170,170,0,0
17714,2019-05-05,47,0,47,3,50,50,0,0
17715,2019-05-05,269,0,269,21,290,290,0,0
17716,2019-05-05,278,0,278,22,300,300,0,0
17717,2019-05-05,936,0,936,74,1010,1010,0,0
17718,2019-05-05,667,0,667,53,720,720,0,0
17719,2019-05-05,167,0,167,13,180,180,0,0
17720,2019-05-05,639,0,639,51,690,690,0,0
17721,2019-05-05,1908,0,1908,152,2060,0,2060,0
17722,2019-05-05,389,0,389,31,420,420,0,0
17723,2019-05-05,297,0,297,23,320,320,0,0
17724,2019-05-05,1815,0,1815,145,1960,1960,0,0
17725,2019-05-05,2639,0,2639,211,2850,2850,0,0
17726,2019-05-05,741,0,741,59,800,800,0,0
17727,2019-05-05,1657,0,1657,123,1780,0,1780,0
17728,2019-05-05,3334,0,3334,266,3600,3600,0,0
17729,2019-05-05,463,0,463,37,500,500,0,0
17730,2019-05-05,843,0,843,67,910,910,0,0
17731,2019-05-05,1815,0,1815,145,1960,1960,0,0
17732,2019-05-05,-908,0,-908,-72,-980,-980,0,0
17733,2019-05-05,639,0,639,51,690,690,0,0
17734,2019-05-05,1010,0,1010,80,1090,1090,0,0
17735,2019-05-06,1676,0,1676,134,1810,1810,0,0
17736,2019-05-06,491,0,491,39,530,530,0,0
17737,2019-05-06,1288,0,1288,102,1390,1390,0,0
17738,2019-05-06,186,0,186,14,200,200,0,0
17739,2019-05-06,547,0,547,43,590,590,0,0
17740,2019-05-06,334,0,334,26,360,360,0,0
17741,2019-05-06,908,0,908,72,980,0,980,0
17742,2019-05-06,908,0,908,72,980,0,980,0
17743,2019-05-06,704,0,704,56,760,0,760,0
17744,2019-05-06,1815,0,1815,145,1960,1960,0,0
17745,2019-05-06,269,0,269,21,290,290,0,0
17746,2019-05-06,334,0,334,26,360,360,0,0
17747,2019-05-06,649,0,649,51,700,700,0,0
17748,2019-05-06,788,0,788,62,850,850,0,0
17749,2019-05-06,306,0,306,24,330,330,0,0
17750,2019-05-06,1288,0,1288,102,1390,1390,0,0
17751,2019-05-06,1194,0,1194,86,1280,0,1280,0
17752,2019-05-06,528,0,528,42,570,570,0,0
17753,2019-05-06,1334,0,1334,106,1440,1440,0,0
17754,2019-05-06,667,0,667,53,720,720,0,0
17755,2019-05-06,204,0,204,16,220,220,0,0
17756,2019-05-06,593,0,593,47,640,640,0,0
17757,2019-05-06,713,0,713,57,770,770,0,0
17758,2019-05-06,732,0,732,58,790,790,0,0
17759,2019-05-06,954,0,954,76,1030,1030,0,0
17760,2019-05-06,311,-66,245,19,264,264,0,0
17761,2019-05-06,334,0,334,26,360,360,0,0
17762,2019-05-06,908,0,908,72,980,980,0,0
17763,2019-05-06,2379,0,2379,181,2560,2560,0,0
17764,2019-05-06,426,0,426,34,460,460,0,0
17765,2019-05-06,1038,0,1038,82,1120,1120,0,0
17766,2019-05-06,278,0,278,22,300,300,0,0
17767,2019-05-06,1213,0,1213,97,1310,1310,0,0
17768,2019-05-06,186,0,186,14,200,200,0,0
17769,2019-05-06,371,0,371,29,400,400,0,0
17770,2019-05-06,102,0,102,8,110,110,0,0
17771,2019-05-06,334,0,334,26,360,360,0,0
17772,2019-05-06,306,0,306,24,330,330,0,0
17773,2019-05-06,269,0,269,21,290,290,0,0
17774,2019-05-06,454,0,454,36,490,490,0,0
17775,2019-05-06,1528,0,1528,122,1650,1650,0,0
17776,2019-05-06,334,0,334,26,360,360,0,0
17777,2019-05-06,908,0,908,72,980,980,0,0
17778,2019-05-06,908,0,908,72,980,980,0,0
17779,2019-05-06,232,0,232,18,250,250,0,0
17780,2019-05-06,741,0,741,59,800,0,800,0
17781,2019-05-06,908,0,908,72,980,980,0,0
17782,2019-05-06,1352,0,1352,108,1460,1460,0,0
17783,2019-05-06,519,0,519,41,560,560,0,0
17784,2019-05-06,667,0,667,53,720,720,0,0
17785,2019-05-06,1473,0,1473,117,1590,1590,0,0
17786,2019-05-06,852,0,852,68,920,920,0,0
17787,2019-05-06,528,0,528,42,570,570,0,0
17788,2019-05-06,1166,0,1166,84,1250,1250,0,0
17789,2019-05-06,260,0,260,20,280,280,0,0
17790,2019-05-06,491,0,491,39,530,530,0,0
17791,2019-05-06,769,0,769,61,830,830,0,0
17792,2019-05-06,806,0,806,64,870,870,0,0
17793,2019-05-06,1232,0,1232,98,1330,1330,0,0
17794,2019-05-06,445,0,445,35,480,480,0,0
17795,2019-05-06,-1084,0,-1084,-86,-1170,-1170,0,0
17796,2019-05-06,379,0,379,21,400,400,0,0
17797,2019-05-06,1084,0,1084,86,1170,1170,0,0
17798,2019-05-06,167,0,167,13,180,180,0,0
17799,2019-05-06,1101,0,1101,79,1180,1180,0,0
17800,2019-05-06,936,0,936,74,1010,1010,0,0
17801,2019-05-06,880,0,880,70,950,950,0,0
17802,2019-05-06,454,0,454,36,490,490,0,0
17803,2019-05-06,1028,0,1028,82,1110,1110,0,0
17804,2019-05-06,612,0,612,48,660,660,0,0
17805,2019-05-06,-370,0,-370,-30,-400,-400,0,0
17806,2019-05-06,1232,0,1232,98,1330,1330,0,0
17807,2019-05-06,463,0,463,37,500,500,0,0
17808,2019-05-06,445,0,445,35,480,480,0,0
17809,2019-05-06,602,0,602,48,650,650,0,0
17810,2019-05-06,871,0,871,69,940,940,0,0
17811,2019-05-06,491,0,491,39,530,530,0,0
17812,2019-05-06,399,0,399,31,430,430,0,0
17813,2019-05-06,1112,0,1112,88,1200,1200,0,0
17814,2019-05-06,575,0,575,45,620,620,0,0
17815,2019-05-06,1584,0,1584,126,1710,1710,0,0
17816,2019-05-06,982,0,982,78,1060,1060,0,0
17817,2019-05-06,842,0,842,58,900,900,0,0
17818,2019-05-06,602,0,602,48,650,650,0,0
17819,2019-05-06,547,0,547,43,590,590,0,0
17820,2019-05-06,519,0,519,41,560,560,0,0
17821,2019-05-06,473,0,473,37,510,510,0,0
17822,2019-05-06,315,0,315,25,340,340,0,0
17823,2019-05-06,612,0,612,48,660,660,0,0
17824,2019-05-06,167,0,167,13,180,180,0,0
17825,2019-05-06,1084,0,1084,86,1170,1170,0,0
17826,2019-05-06,1251,0,1251,99,1350,1350,0,0
17827,2019-05-06,223,0,223,17,240,240,0,0
17828,2019-05-06,371,0,371,29,400,400,0,0
17829,2019-05-06,1417,0,1417,113,1530,1530,0,0
17830,2019-05-06,788,0,788,62,850,850,0,0
17831,2019-05-06,741,0,741,59,800,0,800,0
17832,2019-05-06,788,0,788,62,850,850,0,0
17833,2019-05-06,-352,0,-352,-28,-380,-380,0,0
17834,2019-05-06,269,0,269,21,290,290,0,0
17835,2019-05-06,760,0,760,60,820,820,0,0
17836,2019-05-06,1260,0,1260,100,1360,1360,0,0
17837,2019-05-06,352,0,352,28,380,380,0,0
17838,2019-05-06,2130,0,2130,170,2300,2300,0,0
17839,2019-05-06,1575,0,1575,125,1700,1700,0,0
17840,2019-05-06,1575,0,1575,125,1700,1700,0,0
17841,2019-05-06,788,0,788,62,850,850,0,0
17842,2019-05-06,121,0,121,9,130,130,0,0
17843,2019-05-06,93,0,93,7,100,100,0,0
17844,2019-05-06,334,0,334,26,360,360,0,0
17845,2019-05-06,815,0,815,65,880,880,0,0
17846,2019-05-06,482,0,482,38,520,520,0,0
17847,2019-05-06,1112,0,1112,88,1200,1200,0,0
17848,2019-05-06,806,0,806,64,870,870,0,0
17849,2019-05-06,788,0,788,62,850,850,0,0
17850,2019-05-06,556,0,556,44,600,600,0,0
17851,2019-05-06,167,0,167,13,180,180,0,0
17852,2019-05-06,1658,0,1658,132,1790,1790,0,0
17853,2019-05-06,93,0,93,7,100,100,0,0
17854,2019-05-06,667,0,667,53,720,720,0,0
17855,2019-05-06,1019,0,1019,81,1100,1100,0,0
17856,2019-05-06,621,0,621,49,670,670,0,0
17857,2019-05-06,538,0,538,42,580,580,0,0
17858,2019-05-06,167,0,167,13,180,180,0,0
17859,2019-05-07,491,0,491,39,530,530,0,0
17860,2019-05-07,973,0,973,77,1050,1050,0,0
17861,2019-05-07,269,0,269,21,290,290,0,0
17862,2019-05-07,1001,0,1001,79,1080,1080,0,0
17863,2019-05-07,963,0,963,77,1040,1040,0,0
17864,2019-05-07,649,0,649,51,700,700,0,0
17865,2019-05-07,825,0,825,65,890,890,0,0
17866,2019-05-07,629,0,629,41,670,670,0,0
17867,2019-05-07,732,0,732,58,790,790,0,0
17868,2019-05-07,260,0,260,20,280,280,0,0
17869,2019-05-07,760,0,760,60,820,820,0,0
17870,2019-05-07,686,0,686,54,740,740,0,0
17871,2019-05-07,1183,0,1183,94,1277,1277,0,0
17872,2019-05-07,167,0,167,13,180,180,0,0
17873,2019-05-07,454,0,454,36,490,490,0,0
17874,2019-05-07,1241,0,1241,99,1340,1340,0,0
17875,2019-05-07,3880,0,3880,310,4190,0,4190,0
17876,2019-05-07,371,0,371,29,400,400,0,0
17877,2019-05-07,1158,-246,912,72,984,984,0,0
17878,2019-05-07,695,0,695,55,750,750,0,0
17879,2019-05-07,232,0,232,18,250,250,0,0
17880,2019-05-07,149,0,149,11,160,160,0,0
17881,2019-05-07,371,0,371,29,400,400,0,0
17882,2019-05-07,3019,0,3019,241,3260,3260,0,0
17883,2019-05-07,547,0,547,43,590,590,0,0
17884,2019-05-07,936,0,936,74,1010,1010,0,0
17885,2019-05-07,389,0,389,31,420,420,0,0
17886,2019-05-07,538,0,538,42,580,580,0,0
17887,2019-05-07,241,0,241,19,260,260,0,0
17888,2019-05-07,102,0,102,8,110,110,0,0
17889,2019-05-07,352,0,352,28,380,380,0,0
17890,2019-05-07,362,0,362,28,390,390,0,0
17891,2019-05-07,269,0,269,21,290,290,0,0
17892,2019-05-07,1149,0,1149,91,1240,1240,0,0
17893,2019-05-07,297,0,297,23,320,320,0,0
17894,2019-05-07,982,0,982,78,1060,1060,0,0
17895,2019-05-07,130,0,130,10,140,140,0,0
17896,2019-05-07,454,0,454,36,490,490,0,0
17897,2019-05-07,269,0,269,21,290,290,0,0
17898,2019-05-08,852,0,852,68,920,920,0,0
17899,2019-05-08,278,0,278,22,300,300,0,0
17900,2019-05-08,278,0,278,22,300,300,0,0
17901,2019-05-08,362,0,362,28,390,390,0,0
17902,2019-05-08,445,0,445,35,480,480,0,0
17903,2019-05-08,408,0,408,32,440,440,0,0
17904,2019-05-08,445,0,445,35,480,480,0,0
17905,2019-05-08,972,0,972,68,1040,1040,0,0
17906,2019-05-08,686,0,686,54,740,740,0,0
17907,2019-05-08,260,0,260,20,280,280,0,0
17908,2019-05-08,278,0,278,22,300,300,0,0
17909,2019-05-08,963,0,963,77,1040,1040,0,0
17910,2019-05-08,908,0,908,72,980,980,0,0
17911,2019-05-08,2723,0,2723,217,2940,2940,0,0
17912,2019-05-08,1213,0,1213,97,1310,1310,0,0
17913,2019-05-08,1223,0,1223,97,1320,1320,0,0
17914,2019-05-08,908,0,908,72,980,980,0,0
17915,2019-05-08,399,0,399,31,430,0,430,0
17916,2019-05-08,908,0,908,72,980,980,0,0
17917,2019-05-08,167,0,167,13,180,180,0,0
17918,2019-05-08,426,0,426,34,460,460,0,0
17919,2019-05-08,852,0,852,68,920,920,0,0
17920,2019-05-08,630,0,630,50,680,680,0,0
17921,2019-05-08,908,0,908,72,980,980,0,0
17922,2019-05-08,445,0,445,35,480,480,0,0
17923,2019-05-08,463,0,463,37,500,500,0,0
17924,2019-05-08,815,0,815,65,880,880,0,0
17925,2019-05-08,667,0,667,53,720,720,0,0
17926,2019-05-08,139,0,139,11,150,150,0,0
17927,2019-05-08,519,0,519,41,560,560,0,0
17928,2019-05-08,232,0,232,18,250,250,0,0
17929,2019-05-08,195,0,195,15,210,210,0,0
17930,2019-05-08,167,0,167,13,180,180,0,0
17931,2019-05-08,741,0,741,59,800,800,0,0
17932,2019-05-08,306,0,306,24,330,330,0,0
17933,2019-05-08,889,0,889,71,960,960,0,0
17934,2019-05-08,445,0,445,35,480,480,0,0
17935,2019-05-08,491,0,491,39,530,530,0,0
17936,2019-05-08,436,0,436,34,470,470,0,0
17937,2019-05-08,250,0,250,20,270,270,0,0
17938,2019-05-08,778,0,778,62,840,840,0,0
17939,2019-05-08,1834,0,1834,146,1980,1980,0,0
17940,2019-05-08,1019,0,1019,81,1100,1100,0,0
17941,2019-05-08,871,0,871,69,940,940,0,0
17942,2019-05-08,649,0,649,51,700,700,0,0
17943,2019-05-08,509,0,509,31,540,540,0,0
17944,2019-05-08,584,0,584,46,630,630,0,0
17945,2019-05-08,249,0,249,11,260,260,0,0
17946,2019-05-08,445,0,445,35,480,480,0,0
17947,2019-05-08,788,0,788,62,850,850,0,0
17948,2019-05-08,547,0,547,43,590,590,0,0
17949,2019-05-08,621,0,621,49,670,670,0,0
17950,2019-05-08,991,0,991,79,1070,1070,0,0
17951,2019-05-08,371,0,371,29,400,400,0,0
17952,2019-05-08,1130,0,1130,90,1220,1220,0,0
17953,2019-05-08,889,0,889,71,960,960,0,0
17954,2019-05-08,695,0,695,55,750,750,0,0
17955,2019-05-08,1332,0,1332,88,1420,1420,0,0
17956,2019-05-08,760,0,760,60,820,820,0,0
17957,2019-05-08,788,0,788,62,850,850,0,0
17958,2019-05-08,963,0,963,77,1040,1040,0,0
17959,2019-05-08,1056,0,1056,84,1140,1140,0,0
17960,2019-05-08,1204,0,1204,96,1300,1300,0,0
17961,2019-05-08,1945,0,1945,155,2100,2100,0,0
17962,2019-05-08,584,0,584,46,630,630,0,0
17963,2019-05-08,815,0,815,65,880,880,0,0
17964,2019-05-08,425,0,425,25,450,450,0,0
17965,2019-05-08,676,0,676,54,730,730,0,0
17966,2019-05-08,593,0,593,47,640,640,0,0
17967,2019-05-08,473,0,473,37,510,510,0,0
17968,2019-05-08,1436,0,1436,114,1550,1550,0,0
17969,2019-05-08,362,0,362,28,390,390,0,0
17970,2019-05-08,538,0,538,42,580,580,0,0
17971,2019-05-08,1093,0,1093,87,1180,1180,0,0
17972,2019-05-08,908,0,908,72,980,980,0,0
17973,2019-05-08,1463,0,1463,117,1580,1580,0,0
17974,2019-05-08,778,0,778,62,840,840,0,0
17975,2019-05-08,767,0,767,43,810,810,0,0
17976,2019-05-08,686,0,686,54,740,740,0,0
17977,2019-05-08,584,0,584,46,630,630,0,0
17978,2019-05-08,2019,0,2019,161,2180,2180,0,0
17979,2019-05-08,251,0,251,19,270,270,0,0
17980,2019-05-08,908,0,908,72,980,980,0,0
17981,2019-05-09,473,0,473,37,510,510,0,0
17982,2019-05-09,1815,0,1815,145,1960,1960,0,0
17983,2019-05-09,538,0,538,42,580,580,0,0
17984,2019-05-09,473,0,473,37,510,510,0,0
17985,2019-05-09,788,0,788,62,850,850,0,0
17986,2019-05-09,204,0,204,16,220,220,0,0
17987,2019-05-09,204,0,204,16,220,220,0,0
17988,2019-05-09,528,0,528,42,570,570,0,0
17989,2019-05-09,139,0,139,11,150,150,0,0
17990,2019-05-09,676,0,676,54,730,730,0,0
17991,2019-05-09,510,0,510,40,550,550,0,0
17992,2019-05-09,908,0,908,72,980,980,0,0
17993,2019-05-09,676,0,676,54,730,730,0,0
17994,2019-05-09,454,0,454,36,490,490,0,0
17995,2019-05-09,658,0,658,52,710,710,0,0
17996,2019-05-09,112,0,112,8,120,120,0,0
17997,2019-05-09,556,0,556,44,600,600,0,0
17998,2019-05-09,306,0,306,24,330,330,0,0
17999,2019-05-09,389,0,389,31,420,420,0,0
18000,2019-05-09,1417,0,1417,113,1530,1530,0,0
18001,2019-05-09,139,0,139,11,150,150,0,0
18002,2019-05-09,1815,0,1815,145,1960,1960,0,0
18003,2019-05-09,982,0,982,78,1060,1060,0,0
18004,2019-05-09,481,0,481,29,510,510,0,0
18005,2019-05-09,278,0,278,22,300,300,0,0
18006,2019-05-09,251,0,251,19,270,270,0,0
18007,2019-05-09,315,0,315,25,340,340,0,0
18008,2019-05-09,112,0,112,8,120,120,0,0
18009,2019-05-09,426,0,426,34,460,460,0,0
18010,2019-05-09,463,0,463,37,500,500,0,0
18011,2019-05-09,584,0,584,46,630,630,0,0
18012,2019-05-09,269,0,269,21,290,290,0,0
18013,2019-05-09,278,0,278,22,300,300,0,0
18014,2019-05-09,806,0,806,64,870,870,0,0
18015,2019-05-09,288,0,288,22,310,310,0,0
18016,2019-05-09,426,0,426,34,460,460,0,0
18017,2019-05-09,658,0,658,52,710,710,0,0
18018,2019-05-09,491,0,491,39,530,530,0,0
18019,2019-05-09,408,0,408,32,440,440,0,0
18020,2019-05-09,222,0,222,8,230,230,0,0
18021,2019-05-09,834,0,834,66,900,900,0,0
18022,2019-05-09,584,0,584,46,630,630,0,0
18023,2019-05-09,713,0,713,57,770,770,0,0
18024,2019-05-09,1019,0,1019,81,1100,1100,0,0
18025,2019-05-09,908,0,908,72,980,980,0,0
18026,2019-05-09,315,0,315,25,340,340,0,0
18027,2019-05-09,445,0,445,35,480,480,0,0
18028,2019-05-09,1815,0,1815,145,1960,1960,0,0
18029,2019-05-09,352,0,352,28,380,380,0,0
18030,2019-05-09,778,0,778,62,840,840,0,0
18031,2019-05-09,463,0,463,37,500,500,0,0
18032,2019-05-09,389,0,389,31,420,420,0,0
18033,2019-05-09,547,0,547,43,590,590,0,0
18034,2019-05-09,288,0,288,22,310,310,0,0
18035,2019-05-09,110,0,110,0,110,110,0,0
18036,2019-05-09,751,0,751,59,810,810,0,0
18037,2019-05-09,621,0,621,49,670,670,0,0
18038,2019-05-09,371,0,371,29,400,400,0,0
18039,2019-05-09,110,0,110,0,110,110,0,0
18040,2019-05-09,602,0,602,48,650,650,0,0
18041,2019-05-09,167,0,167,13,180,180,0,0
18042,2019-05-09,47,0,47,3,50,50,0,0
18043,2019-05-09,110,0,110,0,110,110,0,0
18044,2019-05-09,482,0,482,38,520,520,0,0
18045,2019-05-09,167,0,167,13,180,180,0,0
18046,2019-05-09,278,0,278,22,300,300,0,0
18047,2019-05-09,444,0,444,26,470,470,0,0
18048,2019-05-09,417,0,417,33,450,450,0,0
18049,2019-05-09,250,0,250,20,270,270,0,0
18050,2019-05-09,703,0,703,47,750,750,0,0
18051,2019-05-09,778,0,778,62,840,840,0,0
18052,2019-05-09,575,0,575,45,620,620,0,0
18053,2019-05-09,399,0,399,31,430,430,0,0
18054,2019-05-09,473,0,473,37,510,510,0,0
18055,2019-05-09,1565,0,1565,125,1690,1690,0,0
18056,2019-05-09,408,0,408,32,440,440,0,0
18057,2019-05-09,649,0,649,51,700,700,0,0
18058,2019-05-09,362,0,362,28,390,390,0,0
18059,2019-05-09,93,0,93,7,100,100,0,0
18060,2019-05-09,1112,0,1112,88,1200,1200,0,0
18061,2019-05-09,463,0,463,37,500,500,0,0
18062,2019-05-09,638,0,638,42,680,680,0,0
18063,2019-05-09,269,0,269,21,290,290,0,0
18064,2019-05-09,602,0,602,48,650,650,0,0
18065,2019-05-09,519,0,519,41,560,560,0,0
18066,2019-05-09,349,-74,275,21,296,296,0,0
18067,2019-05-09,306,0,306,24,330,330,0,0
18068,2019-05-09,334,0,334,26,360,360,0,0
18069,2019-05-09,408,0,408,32,440,440,0,0
18070,2019-05-09,121,0,121,9,130,130,0,0
18071,2019-05-09,825,0,825,65,890,890,0,0
18072,2019-05-09,788,0,788,62,850,850,0,0
18073,2019-05-09,788,0,788,62,850,850,0,0
18074,2019-05-09,269,0,269,21,290,290,0,0
18075,2019-05-09,871,0,871,69,940,940,0,0
18076,2019-05-09,288,0,288,22,310,0,310,0
18077,2019-05-09,306,0,306,24,330,330,0,0
18078,2019-05-09,713,0,713,57,770,770,0,0
18079,2019-05-09,527,0,527,33,560,560,0,0
18080,2019-05-09,584,0,584,46,630,630,0,0
18081,2019-05-09,399,0,399,31,430,430,0,0
18082,2019-05-09,889,0,889,71,960,960,0,0
18083,2019-05-09,1047,0,1047,83,1130,1130,0,0
18084,2019-05-09,1176,0,1176,94,1270,1270,0,0
18085,2019-05-09,195,0,195,15,210,210,0,0
18086,2019-05-09,1519,0,1519,121,1640,1640,0,0
18087,2019-05-09,167,0,167,13,180,180,0,0
18088,2019-05-09,167,0,167,13,180,180,0,0
18089,2019-05-09,343,0,343,27,370,370,0,0
18090,2019-05-09,260,0,260,20,280,280,0,0
18091,2019-05-09,630,0,630,50,680,680,0,0
18092,2019-05-09,806,0,806,64,870,870,0,0
18093,2019-05-09,378,0,378,30,408,408,0,0
18094,2019-05-09,500,0,500,40,540,540,0,0
18095,2019-05-09,1602,0,1602,128,1730,1730,0,0
18096,2019-05-09,723,0,723,57,780,780,0,0
18097,2019-05-09,797,0,797,63,860,860,0,0
18098,2019-05-09,1195,0,1195,95,1290,1290,0,0
18099,2019-05-09,834,0,834,66,900,900,0,0
18100,2019-05-09,806,0,806,64,870,870,0,0
18101,2019-05-09,269,0,269,21,290,290,0,0
18102,2019-05-09,1102,0,1102,88,1190,1190,0,0
18103,2019-05-09,954,0,954,76,1030,1030,0,0
18104,2019-05-09,704,0,704,56,760,760,0,0
18105,2019-05-09,908,0,908,72,980,0,980,0
18106,2019-05-09,1306,0,1306,104,1410,1410,0,0
18107,2019-05-09,584,0,584,46,630,630,0,0
18108,2019-05-09,436,0,436,34,470,470,0,0
18109,2019-05-09,843,0,843,67,910,0,910,0
18110,2019-05-09,565,0,565,45,610,610,0,0
18111,2019-05-09,917,0,917,73,990,990,0,0
18112,2019-05-09,788,0,788,62,850,850,0,0
18113,2019-05-09,1806,0,1806,144,1950,1950,0,0
18114,2019-05-09,408,0,408,32,440,440,0,0
18115,2019-05-09,1213,0,1213,97,1310,1310,0,0
18116,2019-05-09,112,0,112,8,120,120,0,0
18117,2019-05-09,825,0,825,65,890,890,0,0
18118,2019-05-09,1065,0,1065,85,1150,1150,0,0
18119,2019-05-09,547,0,547,43,590,590,0,0
18120,2019-05-09,584,0,584,46,630,630,0,0
18121,2019-05-09,788,0,788,62,850,850,0,0
18122,2019-05-09,1065,0,1065,85,1150,1150,0,0
18123,2019-05-09,2288,0,2288,182,2470,2470,0,0
18124,2019-05-09,639,0,639,51,690,690,0,0
18125,2019-05-09,1102,0,1102,88,1190,1190,0,0
18126,2019-05-09,269,0,269,21,290,290,0,0
18127,2019-05-09,788,0,788,62,850,850,0,0
18128,2019-05-09,112,0,112,8,120,120,0,0
18129,2019-05-09,278,0,278,22,300,300,0,0
18130,2019-05-09,1843,0,1843,147,1990,1990,0,0
18131,2019-05-09,297,0,297,23,320,320,0,0
18132,2019-05-09,139,0,139,11,150,150,0,0
18133,2019-05-09,510,0,510,40,550,550,0,0
18134,2019-05-10,973,0,973,77,1050,1050,0,0
18135,2019-05-10,1815,0,1815,145,1960,1960,0,0
18136,2019-05-10,1815,0,1815,145,1960,1960,0,0
18137,2019-05-10,260,0,260,20,280,280,0,0
18138,2019-05-10,676,0,676,54,730,730,0,0
18139,2019-05-10,269,0,269,21,290,290,0,0
18140,2019-05-10,482,0,482,38,520,520,0,0
18141,2019-05-10,389,0,389,31,420,420,0,0
18142,2019-05-10,408,0,408,32,440,440,0,0
18143,2019-05-10,575,0,575,45,620,620,0,0
18144,2019-05-10,1936,0,1936,154,2090,2090,0,0
18145,2019-05-10,297,0,297,23,320,320,0,0
18146,2019-05-10,2723,0,2723,217,2940,2940,0,0
18147,2019-05-10,1047,0,1047,83,1130,1130,0,0
18148,2019-05-10,389,0,389,31,420,420,0,0
18149,2019-05-10,195,0,195,15,210,0,210,0
18150,2019-05-10,-556,0,-556,-44,-600,-600,0,0
18151,2019-05-10,556,0,556,44,600,600,0,0
18152,2019-05-10,1583,0,1583,117,1700,1700,0,0
18153,2019-05-10,250,0,250,20,270,270,0,0
18154,2019-05-10,1528,0,1528,122,1650,1650,0,0
18155,2019-05-10,306,0,306,24,330,330,0,0
18156,2019-05-10,556,0,556,44,600,600,0,0
18157,2019-05-10,649,0,649,51,700,700,0,0
18158,2019-05-10,538,0,538,42,580,580,0,0
18159,2019-05-10,630,0,630,50,680,680,0,0
18160,2019-05-10,565,0,565,45,610,610,0,0
18161,2019-05-10,973,0,973,77,1050,1050,0,0
18162,2019-05-10,908,0,908,72,980,980,0,0
18163,2019-05-10,686,0,686,54,740,740,0,0
18164,2019-05-10,908,0,908,72,980,980,0,0
18165,2019-05-10,519,0,519,41,560,560,0,0
18166,2019-05-10,1815,0,1815,145,1960,1960,0,0
18167,2019-05-10,1269,0,1269,101,1370,1370,0,0
18168,2019-05-10,871,0,871,69,940,940,0,0
18169,2019-05-10,732,0,732,58,790,790,0,0
18170,2019-05-10,565,0,565,45,610,610,0,0
18171,2019-05-10,251,0,251,19,270,270,0,0
18172,2019-05-10,889,0,889,71,960,960,0,0
18173,2019-05-10,1000,0,1000,80,1080,1080,0,0
18174,2019-05-10,954,0,954,76,1030,1030,0,0
18175,2019-05-10,908,0,908,72,980,980,0,0
18176,2019-05-10,501,0,501,39,540,540,0,0
18177,2019-05-10,3130,0,3130,250,3380,3380,0,0
18178,2019-05-10,649,0,649,51,700,700,0,0
18179,2019-05-10,880,0,880,70,950,950,0,0
18180,2019-05-10,1510,0,1510,120,1630,1630,0,0
18181,2019-05-10,1815,0,1815,145,1960,1960,0,0
18182,2019-05-10,630,0,630,50,680,680,0,0
18183,2019-05-10,1815,0,1815,145,1960,1960,0,0
18184,2019-05-10,686,0,686,54,740,740,0,0
18185,2019-05-10,1815,0,1815,145,1960,1960,0,0
18186,2019-05-10,278,0,278,22,300,300,0,0
18187,2019-05-10,2723,0,2723,217,2940,2940,0,0
18188,2019-05-10,639,0,639,51,690,690,0,0
18189,2019-05-10,1899,0,1899,151,2050,0,2050,0
18190,2019-05-10,686,0,686,54,740,740,0,0
18191,2019-05-10,584,0,584,46,630,630,0,0
18192,2019-05-10,565,0,565,45,610,610,0,0
18193,2019-05-10,1251,0,1251,99,1350,1350,0,0
18194,2019-05-10,352,0,352,28,380,380,0,0
18195,2019-05-10,232,0,232,18,250,250,0,0
18196,2019-05-10,538,0,538,42,580,580,0,0
18197,2019-05-10,778,0,778,62,840,840,0,0
18198,2019-05-10,389,0,389,31,420,420,0,0
18199,2019-05-10,593,0,593,47,640,640,0,0
18200,2019-05-10,899,0,899,71,970,970,0,0
18201,2019-05-10,371,0,371,29,400,400,0,0
18202,2019-05-10,973,0,973,77,1050,1050,0,0
18203,2019-05-10,501,0,501,39,540,540,0,0
18204,2019-05-10,2389,0,2389,191,2580,2580,0,0
18205,2019-05-10,213,0,213,17,230,230,0,0
18206,2019-05-10,325,0,325,25,350,350,0,0
18207,2019-05-10,713,0,713,57,770,770,0,0
18208,2019-05-10,112,0,112,8,120,120,0,0
18209,2019-05-10,862,0,862,68,930,930,0,0
18210,2019-05-10,1463,0,1463,117,1580,1580,0,0
18211,2019-05-10,260,0,260,20,280,280,0,0
18212,2019-05-10,278,0,278,22,300,300,0,0
18213,2019-05-10,519,0,519,41,560,560,0,0
18214,2019-05-10,389,0,389,31,420,420,0,0
18215,2019-05-10,371,0,371,29,400,400,0,0
18216,2019-05-10,389,0,389,31,420,420,0,0
18217,2019-05-10,288,0,288,22,310,310,0,0
18218,2019-05-10,778,0,778,62,840,840,0,0
18219,2019-05-10,445,0,445,35,480,480,0,0
18220,2019-05-10,306,0,306,24,330,330,0,0
18221,2019-05-10,1525,-324,1201,95,1296,1296,0,0
18222,2019-05-10,443,0,443,17,460,460,0,0
18223,2019-05-10,251,0,251,19,270,270,0,0
18224,2019-05-10,584,0,584,46,630,630,0,0
18225,2019-05-10,1038,0,1038,82,1120,1120,0,0
18226,2019-05-10,362,0,362,28,390,390,0,0
18227,2019-05-10,565,0,565,45,610,610,0,0
18228,2019-05-10,334,0,334,26,360,360,0,0
18229,2019-05-10,1593,0,1593,127,1720,1720,0,0
18230,2019-05-10,695,0,695,55,750,750,0,0
18231,2019-05-10,260,0,260,20,280,280,0,0
18232,2019-05-10,1019,0,1019,81,1100,1100,0,0
18233,2019-05-10,195,0,195,15,210,210,0,0
18234,2019-05-10,306,0,306,24,330,330,0,0
18235,2019-05-10,269,0,269,21,290,290,0,0
18236,2019-05-10,1167,0,1167,93,1260,1260,0,0
18237,2019-05-10,1084,0,1084,86,1170,1170,0,0
18238,2019-05-10,686,0,686,54,740,740,0,0
18239,2019-05-10,334,0,334,26,360,360,0,0
18240,2019-05-10,778,0,778,62,840,840,0,0
18241,2019-05-10,769,0,769,61,830,830,0,0
18242,2019-05-10,491,0,491,39,530,530,0,0
18243,2019-05-10,801,-85,716,49,765,765,0,0
18244,2019-05-10,1240,0,1240,90,1330,1330,0,0
18245,2019-05-10,695,0,695,55,750,750,0,0
18246,2019-05-10,1501,0,1501,119,1620,1620,0,0
18247,2019-05-10,667,0,667,53,720,720,0,0
18248,2019-05-10,788,0,788,62,850,850,0,0
18249,2019-05-10,1575,0,1575,125,1700,1700,0,0
18250,2019-05-10,584,0,584,46,630,630,0,0
18251,2019-05-10,232,0,232,18,250,250,0,0
18252,2019-05-10,1575,0,1575,125,1700,1700,0,0
18253,2019-05-10,1315,0,1315,105,1420,1420,0,0
18254,2019-05-10,889,0,889,71,960,960,0,0
18255,2019-05-10,769,0,769,61,830,830,0,0
18256,2019-05-10,325,0,325,25,350,350,0,0
18257,2019-05-10,269,0,269,21,290,290,0,0
18258,2019-05-10,1444,0,1444,106,1550,1550,0,0
18259,2019-05-10,1056,0,1056,84,1140,1140,0,0
18260,2019-05-10,223,0,223,17,240,240,0,0
18261,2019-05-10,371,0,371,29,400,400,0,0
18262,2019-05-10,788,0,788,62,850,850,0,0
18263,2019-05-10,788,0,788,62,850,850,0,0
18264,2019-05-10,362,0,362,28,390,390,0,0
18265,2019-05-10,954,0,954,76,1030,1030,0,0
18266,2019-05-10,139,0,139,11,150,150,0,0
18267,2019-05-11,1621,0,1621,129,1750,1750,0,0
18268,2019-05-11,797,0,797,63,860,860,0,0
18269,2019-05-11,1815,0,1815,145,1960,1960,0,0
18270,2019-05-11,110,0,110,0,110,110,0,0
18271,2019-05-11,223,0,223,17,240,240,0,0
18272,2019-05-11,1445,0,1445,115,1560,1560,0,0
18273,2019-05-11,501,0,501,39,540,540,0,0
18274,2019-05-11,112,0,112,8,120,120,0,0
18275,2019-05-11,2056,0,2056,164,2220,2220,0,0
18276,2019-05-11,426,0,426,34,460,460,0,0
18277,2019-05-11,315,0,315,25,340,340,0,0
18278,2019-05-11,176,0,176,14,190,190,0,0
18279,2019-05-11,760,0,760,60,820,820,0,0
18280,2019-05-11,704,0,704,56,760,760,0,0
18281,2019-05-11,778,0,778,62,840,840,0,0
18282,2019-05-11,1251,0,1251,99,1350,1350,0,0
18283,2019-05-11,139,0,139,11,150,150,0,0
18284,2019-05-11,880,0,880,70,950,950,0,0
18285,2019-05-11,278,0,278,22,300,300,0,0
18286,2019-05-11,1093,0,1093,87,1180,1180,0,0
18287,2019-05-11,463,0,463,37,500,500,0,0
18288,2019-05-11,1842,0,1842,138,1980,1980,0,0
18289,2019-05-11,399,0,399,31,430,430,0,0
18290,2019-05-11,1695,0,1695,135,1830,1830,0,0
18291,2019-05-11,325,0,325,25,350,350,0,0
18292,2019-05-11,1463,0,1463,117,1580,1580,0,0
18293,2019-05-11,1112,0,1112,88,1200,0,1200,0
18294,2019-05-11,658,0,658,52,710,710,0,0
18295,2019-05-11,602,0,602,48,650,650,0,0
18296,2019-05-11,667,0,667,53,720,720,0,0
18297,2019-05-11,639,0,639,51,690,690,0,0
18298,2019-05-11,528,0,528,42,570,570,0,0
18299,2019-05-11,732,0,732,58,790,790,0,0
18300,2019-05-11,1102,0,1102,88,1190,1190,0,0
18301,2019-05-11,963,0,963,77,1040,1040,0,0
18302,2019-05-11,639,0,639,51,690,690,0,0
18303,2019-05-11,788,0,788,62,850,850,0,0
18304,2019-05-11,426,0,426,34,460,460,0,0
18305,2019-05-11,973,0,973,77,1050,1050,0,0
18306,2019-05-11,306,0,306,24,330,330,0,0
18307,2019-05-11,612,0,612,48,660,660,0,0
18308,2019-05-11,426,0,426,34,460,460,0,0
18309,2019-05-11,426,0,426,34,460,460,0,0
18310,2019-05-11,723,0,723,57,780,780,0,0
18311,2019-05-11,352,0,352,28,380,380,0,0
18312,2019-05-11,1195,0,1195,95,1290,1290,0,0
18313,2019-05-11,2723,0,2723,217,2940,2940,0,0
18314,2019-05-11,862,0,862,68,930,930,0,0
18315,2019-05-11,1278,0,1278,102,1380,1380,0,0
18316,2019-05-11,2223,0,2223,177,2400,2400,0,0
18317,2019-05-11,1815,0,1815,145,1960,1960,0,0
18318,2019-05-11,463,0,463,37,500,500,0,0
18319,2019-05-11,288,0,288,22,310,310,0,0
18320,2019-05-11,732,0,732,58,790,790,0,0
18321,2019-05-11,260,0,260,20,280,280,0,0
18322,2019-05-11,667,0,667,53,720,720,0,0
18323,2019-05-11,399,0,399,31,430,430,0,0
18324,2019-05-11,575,0,575,45,620,620,0,0
18325,2019-05-11,982,0,982,78,1060,1060,0,0
18326,2019-05-11,362,0,362,28,390,390,0,0
18327,2019-05-11,630,0,630,50,680,680,0,0
18328,2019-05-11,889,0,889,71,960,960,0,0
18329,2019-05-11,840,0,840,67,907,907,0,0
18330,2019-05-11,102,0,102,8,110,110,0,0
18331,2019-05-11,343,0,343,27,370,370,0,0
18332,2019-05-11,973,0,973,77,1050,1050,0,0
18333,2019-05-11,269,0,269,21,290,290,0,0
18334,2019-05-11,538,0,538,42,580,580,0,0
18335,2019-05-11,778,0,778,62,840,840,0,0
18336,2019-05-11,269,0,269,21,290,290,0,0
18337,2019-05-11,2306,0,2306,184,2490,2490,0,0
18338,2019-05-11,695,0,695,55,750,750,0,0
18339,2019-05-11,2723,0,2723,217,2940,2940,0,0
18340,2019-05-11,676,0,676,54,730,730,0,0
18341,2019-05-11,954,0,954,76,1030,1030,0,0
18342,2019-05-11,1260,0,1260,100,1360,1360,0,0
18343,2019-05-11,325,0,325,25,350,350,0,0
18344,2019-05-11,584,0,584,46,630,630,0,0
18345,2019-05-11,667,0,667,53,720,720,0,0
18346,2019-05-11,664,0,664,26,690,690,0,0
18347,2019-05-11,741,0,741,59,800,800,0,0
18348,2019-05-11,4538,0,4538,362,4900,0,4900,0
18349,2019-05-11,426,0,426,34,460,460,0,0
18350,2019-05-11,2010,0,2010,160,2170,2170,0,0
18351,2019-05-11,2038,0,2038,162,2200,2200,0,0
18352,2019-05-11,251,0,251,19,270,270,0,0
18353,2019-05-11,426,0,426,34,460,460,0,0
18354,2019-05-11,408,0,408,32,440,440,0,0
18355,2019-05-11,306,0,306,24,330,330,0,0
18356,2019-05-11,704,0,704,56,760,760,0,0
18357,2019-05-11,426,0,426,34,460,460,0,0
18358,2019-05-11,1186,0,1186,94,1280,1280,0,0
18359,2019-05-11,602,0,602,48,650,650,0,0
18360,2019-05-11,315,0,315,25,340,340,0,0
18361,2019-05-11,695,0,695,55,750,750,0,0
18362,2019-05-11,1815,0,1815,145,1960,1960,0,0
18363,2019-05-11,278,0,278,22,300,300,0,0
18364,2019-05-11,788,0,788,62,850,850,0,0
18365,2019-05-11,1575,0,1575,125,1700,1700,0,0
18366,2019-05-11,788,0,788,62,850,850,0,0
18367,2019-05-11,510,0,510,40,550,550,0,0
18368,2019-05-11,315,0,315,25,340,340,0,0
18369,2019-05-11,593,0,593,47,640,640,0,0
18370,2019-05-11,399,0,399,31,430,430,0,0
18371,2019-05-11,362,0,362,28,390,390,0,0
18372,2019-05-11,601,0,601,39,640,640,0,0
18373,2019-05-11,528,0,528,42,570,570,0,0
18374,2019-05-11,584,0,584,46,630,630,0,0
18375,2019-05-11,473,0,473,37,510,510,0,0
18376,2019-05-11,1167,0,1167,93,1260,1260,0,0
18377,2019-05-11,444,0,444,26,470,470,0,0
18378,2019-05-11,269,0,269,21,290,290,0,0
18379,2019-05-11,260,0,260,20,280,280,0,0
18380,2019-05-11,649,0,649,51,700,700,0,0
18381,2019-05-11,889,0,889,71,960,960,0,0
18382,2019-05-11,686,0,686,54,740,740,0,0
18383,2019-05-11,371,0,371,29,400,400,0,0
18384,2019-05-11,667,0,667,53,720,720,0,0
18385,2019-05-11,482,0,482,38,520,520,0,0
18386,2019-05-11,121,0,121,9,130,130,0,0
18387,2019-05-11,112,0,112,8,120,120,0,0
18388,2019-05-11,741,0,741,59,800,800,0,0
18389,2019-05-11,436,0,436,34,470,470,0,0
18390,2019-05-11,704,0,704,56,760,760,0,0
18391,2019-05-11,812,-87,725,58,783,783,0,0
18392,2019-05-11,556,0,556,44,600,600,0,0
18393,2019-05-11,334,0,334,26,360,360,0,0
18394,2019-05-11,482,0,482,38,520,520,0,0
18395,2019-05-11,834,0,834,66,900,900,0,0
18396,2019-05-11,760,0,760,60,820,820,0,0
18397,2019-05-11,686,0,686,54,740,740,0,0
18398,2019-05-11,260,0,260,20,280,280,0,0
18399,2019-05-11,575,0,575,45,620,620,0,0
18400,2019-05-11,362,0,362,28,390,390,0,0
18401,2019-05-11,334,0,334,26,360,360,0,0
18402,2019-05-11,426,0,426,34,460,460,0,0
18403,2019-05-11,778,0,778,62,840,840,0,0
18404,2019-05-11,1093,0,1093,87,1180,1180,0,0
18405,2019-05-11,232,0,232,18,250,250,0,0
18406,2019-05-11,2852,0,2852,228,3080,3080,0,0
18407,2019-05-11,649,0,649,51,700,700,0,0
18408,2019-05-11,1371,0,1371,109,1480,1480,0,0
18409,2019-05-11,269,0,269,21,290,290,0,0
18410,2019-05-11,797,0,797,63,860,860,0,0
18411,2019-05-11,167,0,167,13,180,180,0,0
18412,2019-05-11,695,0,695,55,750,0,750,0
18413,2019-05-11,399,0,399,31,430,430,0,0
18414,2019-05-11,621,0,621,49,670,670,0,0
18415,2019-05-11,649,0,649,51,700,700,0,0
18416,2019-05-11,269,0,269,21,290,290,0,0
18417,2019-05-11,251,0,251,19,270,270,0,0
18418,2019-05-11,1575,0,1575,125,1700,1700,0,0
18419,2019-05-11,788,0,788,62,850,850,0,0
18420,2019-05-11,1575,0,1575,125,1700,1700,0,0
18421,2019-05-11,389,0,389,31,420,420,0,0
18422,2019-05-11,538,0,538,42,580,580,0,0
18423,2019-05-11,297,0,297,23,320,320,0,0
18424,2019-05-11,351,0,351,19,370,370,0,0
18425,2019-05-11,741,0,741,59,800,800,0,0
18426,2019-05-11,917,0,917,73,990,990,0,0
18427,2019-05-11,1630,0,1630,130,1760,0,1760,0
18428,2019-05-11,2056,0,2056,164,2220,2220,0,0
18429,2019-05-11,1528,0,1528,122,1650,1650,0,0
18430,2019-05-11,2389,0,2389,191,2580,2580,0,0
18431,2019-05-11,1204,0,1204,96,1300,1300,0,0
18432,2019-05-11,612,0,612,48,660,660,0,0
18433,2019-05-11,1001,0,1001,79,1080,1080,0,0
18434,2019-05-11,149,0,149,11,160,160,0,0
18435,2019-05-11,1575,0,1575,125,1700,0,1700,0
18436,2019-05-11,788,0,788,62,850,850,0,0
18437,2019-05-11,861,0,861,59,920,920,0,0
18438,2019-05-11,1093,0,1093,87,1180,1180,0,0
18439,2019-05-11,1306,0,1306,104,1410,1410,0,0
18440,2019-05-11,362,0,362,28,390,390,0,0
18441,2019-05-11,278,0,278,22,300,300,0,0
18442,2019-05-11,260,0,260,20,280,280,0,0
18443,2019-05-11,556,0,556,44,600,600,0,0
18444,2019-05-11,306,0,306,24,330,330,0,0
18445,2019-05-11,315,0,315,25,340,340,0,0
18446,2019-05-11,399,0,399,31,430,430,0,0
18447,2019-05-11,288,0,288,22,310,310,0,0
18448,2019-05-11,667,0,667,53,720,720,0,0
18449,2019-05-11,371,0,371,29,400,400,0,0
18450,2019-05-11,181,0,181,14,195,195,0,0
18451,2019-05-11,788,0,788,62,850,850,0,0
18452,2019-05-11,695,0,695,55,750,750,0,0
18453,2019-05-11,463,0,463,37,500,500,0,0
18454,2019-05-11,1575,0,1575,125,1700,1700,0,0
18455,2019-05-11,788,0,788,62,850,850,0,0
18456,2019-05-11,2416,0,2416,184,2600,2600,0,0
18457,2019-05-11,1112,0,1112,88,1200,1200,0,0
18458,2019-05-11,1593,0,1593,127,1720,1720,0,0
18459,2019-05-11,-1111,0,-1111,-89,-1200,-1200,0,0
18460,2019-05-11,2473,0,2473,197,2670,2670,0,0
18461,2019-05-11,3195,0,3195,255,3450,0,3450,0
18462,2019-05-11,1315,0,1315,105,1420,1420,0,0
18463,2019-05-11,1575,0,1575,125,1700,1700,0,0
18464,2019-05-12,815,0,815,65,880,880,0,0
18465,2019-05-12,908,0,908,72,980,980,0,0
18466,2019-05-12,639,0,639,51,690,690,0,0
18467,2019-05-12,546,0,546,34,580,580,0,0
18468,2019-05-12,751,0,751,59,810,810,0,0
18469,2019-05-12,389,0,389,31,420,420,0,0
18470,2019-05-12,454,0,454,36,490,490,0,0
18471,2019-05-12,908,0,908,72,980,980,0,0
18472,2019-05-12,908,0,908,72,980,980,0,0
18473,2019-05-12,1463,0,1463,117,1580,1580,0,0
18474,2019-05-12,678,-144,534,42,576,576,0,0
18475,2019-05-12,343,0,343,27,370,370,0,0
18476,2019-05-12,741,0,741,59,800,800,0,0
18477,2019-05-12,713,0,713,57,770,770,0,0
18478,2019-05-12,260,0,260,20,280,280,0,0
18479,2019-05-12,648,0,648,42,690,690,0,0
18480,2019-05-12,1019,0,1019,81,1100,1100,0,0
18481,2019-05-12,510,0,510,40,550,550,0,0
18482,2019-05-12,2038,0,2038,162,2200,2200,0,0
18483,2019-05-12,426,0,426,34,460,460,0,0
18484,2019-05-12,445,0,445,35,480,480,0,0
18485,2019-05-12,732,0,732,58,790,790,0,0
18486,2019-05-12,1241,0,1241,99,1340,1340,0,0
18487,2019-05-12,334,0,334,26,360,360,0,0
18488,2019-05-12,1306,0,1306,104,1410,1410,0,0
18489,2019-05-12,399,0,399,31,430,430,0,0
18490,2019-05-12,501,0,501,39,540,540,0,0
18491,2019-05-12,519,0,519,41,560,560,0,0
18492,2019-05-12,325,0,325,25,350,350,0,0
18493,2019-05-12,704,0,704,56,760,760,0,0
18494,2019-05-12,630,0,630,50,680,680,0,0
18495,2019-05-12,612,0,612,48,660,660,0,0
18496,2019-05-12,556,0,556,44,600,600,0,0
18497,2019-05-12,1815,0,1815,145,1960,1960,0,0
18498,2019-05-12,575,0,575,45,620,620,0,0
18499,2019-05-12,325,0,325,25,350,350,0,0
18500,2019-05-12,713,0,713,57,770,770,0,0
18501,2019-05-12,1232,0,1232,98,1330,1330,0,0
18502,2019-05-12,612,0,612,48,660,660,0,0
18503,2019-05-12,482,0,482,38,520,520,0,0
18504,2019-05-12,1815,0,1815,145,1960,1960,0,0
18505,2019-05-12,649,0,649,51,700,0,700,0
18506,2019-05-12,1550,0,1550,123,1673,1673,0,0
18507,2019-05-12,973,0,973,77,1050,1050,0,0
18508,2019-05-12,112,0,112,8,120,120,0,0
18509,2019-05-12,380,0,380,30,410,410,0,0
18510,2019-05-12,371,0,371,29,400,400,0,0
18511,2019-05-12,380,0,380,30,410,410,0,0
18512,2019-05-12,426,0,426,34,460,460,0,0
18513,2019-05-12,908,0,908,72,980,980,0,0
18514,2019-05-12,556,0,556,44,600,600,0,0
18515,2019-05-12,1815,0,1815,145,1960,1960,0,0
18516,2019-05-12,778,0,778,62,840,840,0,0
18517,2019-05-12,436,0,436,34,470,470,0,0
18518,2019-05-12,908,0,908,72,980,980,0,0
18519,2019-05-12,362,0,362,28,390,390,0,0
18520,2019-05-12,1195,0,1195,95,1290,1290,0,0
18521,2019-05-12,612,0,612,48,660,660,0,0
18522,2019-05-12,1528,0,1528,122,1650,1650,0,0
18523,2019-05-12,1028,0,1028,82,1110,1110,0,0
18524,2019-05-12,306,0,306,24,330,330,0,0
18525,2019-05-12,528,0,528,42,570,570,0,0
18526,2019-05-12,362,0,362,28,390,390,0,0
18527,2019-05-12,649,0,649,51,700,700,0,0
18528,2019-05-12,297,0,297,23,320,320,0,0
18529,2019-05-12,408,0,408,32,440,440,0,0
18530,2019-05-12,686,0,686,54,740,740,0,0
18531,2019-05-12,917,0,917,73,990,990,0,0
18532,2019-05-12,334,0,334,26,360,360,0,0
18533,2019-05-12,179,-38,141,11,152,152,0,0
18534,2019-05-12,1251,0,1251,99,1350,1350,0,0
18535,2019-05-12,473,0,473,37,510,510,0,0
18536,2019-05-12,1213,0,1213,97,1310,1310,0,0
18537,2019-05-12,1667,0,1667,133,1800,1800,0,0
18538,2019-05-12,954,0,954,76,1030,1030,0,0
18539,2019-05-12,463,0,463,37,500,500,0,0
18540,2019-05-12,306,0,306,24,330,330,0,0
18541,2019-05-12,269,0,269,21,290,290,0,0
18542,2019-05-12,1260,0,1260,100,1360,1360,0,0
18543,2019-05-12,269,0,269,21,290,290,0,0
18544,2019-05-12,1815,0,1815,145,1960,1960,0,0
18545,2019-05-12,602,0,602,48,650,650,0,0
18546,2019-05-12,139,0,139,11,150,150,0,0
18547,2019-05-12,778,0,778,62,840,0,840,0
18548,2019-05-12,1288,0,1288,102,1390,1390,0,0
18549,2019-05-12,482,0,482,38,520,520,0,0
18550,2019-05-12,547,0,547,43,590,590,0,0
18551,2019-05-12,297,0,297,23,320,320,0,0
18552,2019-05-12,436,0,436,34,470,470,0,0
18553,2019-05-12,167,0,167,13,180,180,0,0
18554,2019-05-12,565,0,565,45,610,610,0,0
18555,2019-05-12,538,0,538,42,580,580,0,0
18556,2019-05-12,1399,0,1399,111,1510,1510,0,0
18557,2019-05-12,473,0,473,37,510,510,0,0
18558,2019-05-12,306,0,306,24,330,330,0,0
18559,2019-05-12,232,0,232,18,250,250,0,0
18560,2019-05-12,1109,0,1109,71,1180,1180,0,0
18561,2019-05-12,519,0,519,41,560,560,0,0
18562,2019-05-12,1121,0,1121,89,1210,1210,0,0
18563,2019-05-12,497,0,497,13,510,510,0,0
18564,2019-05-12,1389,0,1389,111,1500,1500,0,0
18565,2019-05-12,1223,0,1223,97,1320,1320,0,0
18566,2019-05-12,1093,0,1093,87,1180,1180,0,0
18567,2019-05-12,510,0,510,40,550,550,0,0
18568,2019-05-12,556,0,556,44,600,600,0,0
18569,2019-05-12,843,0,843,67,910,910,0,0
18570,2019-05-12,593,0,593,47,640,640,0,0
18571,2019-05-12,269,0,269,21,290,290,0,0
18572,2019-05-12,658,0,658,52,710,710,0,0
18573,2019-05-12,1575,0,1575,125,1700,1700,0,0
18574,2019-05-12,528,0,528,42,570,570,0,0
18575,2019-05-12,389,0,389,31,420,420,0,0
18576,2019-05-12,380,0,380,30,410,410,0,0
18577,2019-05-12,93,0,93,7,100,100,0,0
18578,2019-05-12,1695,0,1695,135,1830,0,1830,0
18579,2019-05-12,473,0,473,37,510,510,0,0
18580,2019-05-12,1325,0,1325,105,1430,1430,0,0
18581,2019-05-12,602,0,602,48,650,650,0,0
18582,2019-05-12,1575,0,1575,125,1700,0,1700,0
18583,2019-05-12,2130,0,2130,170,2300,2300,0,0
18584,2019-05-12,278,0,278,22,300,300,0,0
18585,2019-05-12,695,0,695,55,750,750,0,0
18586,2019-05-12,1815,0,1815,145,1960,1960,0,0
18587,2019-05-12,2288,0,2288,182,2470,2470,0,0
18588,2019-05-12,778,0,778,62,840,840,0,0
18589,2019-05-12,519,0,519,41,560,560,0,0
18590,2019-05-13,602,0,602,48,650,650,0,0
18591,2019-05-13,584,0,584,46,630,630,0,0
18592,2019-05-13,686,0,686,54,740,740,0,0
18593,2019-05-13,1556,0,1556,124,1680,1680,0,0
18594,2019-05-13,519,0,519,41,560,560,0,0
18595,2019-05-13,1815,0,1815,145,1960,1960,0,0
18596,2019-05-13,723,0,723,57,780,780,0,0
18597,2019-05-13,741,0,741,59,800,800,0,0
18598,2019-05-13,908,0,908,72,980,980,0,0
18599,2019-05-13,565,0,565,45,610,610,0,0
18600,2019-05-13,398,0,398,22,420,420,0,0
18601,2019-05-13,1815,0,1815,145,1960,1960,0,0
18602,2019-05-13,1343,0,1343,107,1450,1450,0,0
18603,2019-05-13,463,0,463,37,500,500,0,0
18604,2019-05-13,519,0,519,41,560,560,0,0
18605,2019-05-13,723,0,723,57,780,780,0,0
18606,2019-05-13,269,0,269,21,290,290,0,0
18607,2019-05-13,1139,0,1139,91,1230,1230,0,0
18608,2019-05-13,908,0,908,72,980,980,0,0
18609,2019-05-13,741,0,741,59,800,800,0,0
18610,2019-05-13,825,0,825,65,890,890,0,0
18611,2019-05-13,454,0,454,36,490,490,0,0
18612,2019-05-13,269,0,269,21,290,290,0,0
18613,2019-05-13,110,0,110,0,110,110,0,0
18614,2019-05-13,769,0,769,61,830,830,0,0
18615,2019-05-13,778,0,778,62,840,840,0,0
18616,2019-05-13,362,0,362,28,390,390,0,0
18617,2019-05-13,1028,0,1028,82,1110,1110,0,0
18618,2019-05-13,362,0,362,28,390,390,0,0
18619,2019-05-13,908,0,908,72,980,980,0,0
18620,2019-05-13,528,0,528,42,570,570,0,0
18621,2019-05-13,112,0,112,8,120,120,0,0
18622,2019-05-13,704,0,704,56,760,760,0,0
18623,2019-05-13,602,0,602,48,650,650,0,0
18624,2019-05-13,389,0,389,31,420,420,0,0
18625,2019-05-13,519,0,519,41,560,560,0,0
18626,2019-05-13,315,0,315,25,340,340,0,0
18627,2019-05-13,1075,0,1075,85,1160,1160,0,0
18628,2019-05-13,468,0,468,37,505,505,0,0
18629,2019-05-13,352,0,352,28,380,380,0,0
18630,2019-05-13,908,0,908,72,980,980,0,0
18631,2019-05-13,435,0,435,25,460,0,460,0
18632,2019-05-13,519,0,519,41,560,560,0,0
18633,2019-05-13,436,0,436,34,470,470,0,0
18634,2019-05-13,362,0,362,28,390,390,0,0
18635,2019-05-13,278,0,278,22,300,300,0,0
18636,2019-05-13,278,0,278,22,300,300,0,0
18637,2019-05-13,649,0,649,51,700,700,0,0
18638,2019-05-13,962,0,962,68,1030,1030,0,0
18639,2019-05-13,1501,0,1501,119,1620,1620,0,0
18640,2019-05-13,1334,0,1334,106,1440,1440,0,0
18641,2019-05-13,751,0,751,59,810,810,0,0
18642,2019-05-13,1565,0,1565,125,1690,0,1690,0
18643,2019-05-13,510,0,510,40,550,550,0,0
18644,2019-05-13,908,0,908,72,980,980,0,0
18645,2019-05-13,908,0,908,72,980,980,0,0
18646,2019-05-13,1778,0,1778,142,1920,1920,0,0
18647,2019-05-13,1538,0,1538,122,1660,1660,0,0
18648,2019-05-13,908,0,908,72,980,0,980,0
18649,2019-05-13,267,0,267,3,270,270,0,0
18650,2019-05-13,1019,0,1019,81,1100,1100,0,0
18651,2019-05-13,-185,0,-185,-15,-200,-200,0,0
18652,2019-05-13,852,0,852,68,920,920,0,0
18653,2019-05-13,454,0,454,36,490,490,0,0
18654,2019-05-13,852,0,852,68,920,920,0,0
18655,2019-05-13,723,0,723,57,780,780,0,0
18656,2019-05-13,269,0,269,21,290,290,0,0
18657,2019-05-13,811,0,811,64,875,875,0,0
18658,2019-05-13,445,0,445,35,480,480,0,0
18659,2019-05-13,362,0,362,28,390,390,0,0
18660,2019-05-13,186,0,186,14,200,200,0,0
18661,2019-05-13,1528,0,1528,122,1650,1650,0,0
18662,2019-05-13,379,0,379,21,400,400,0,0
18663,2019-05-13,788,0,788,62,850,850,0,0
18664,2019-05-13,834,0,834,66,900,900,0,0
18665,2019-05-13,278,0,278,22,300,300,0,0
18666,2019-05-13,1297,0,1297,103,1400,1400,0,0
18667,2019-05-13,306,0,306,24,330,330,0,0
18668,2019-05-13,389,0,389,31,420,420,0,0
18669,2019-05-13,408,0,408,32,440,440,0,0
18670,2019-05-13,260,0,260,20,280,280,0,0
18671,2019-05-13,47,0,47,3,50,50,0,0
18672,2019-05-13,630,0,630,50,680,680,0,0
18673,2019-05-13,1426,0,1426,114,1540,1540,0,0
18674,2019-05-13,1825,0,1825,145,1970,1970,0,0
18675,2019-05-13,575,0,575,45,620,620,0,0
18676,2019-05-13,389,0,389,31,420,420,0,0
18677,2019-05-13,389,0,389,31,420,420,0,0
18678,2019-05-13,389,0,389,31,420,420,0,0
18679,2019-05-13,232,0,232,18,250,250,0,0
18680,2019-05-13,834,0,834,66,900,900,0,0
18681,2019-05-13,1556,0,1556,124,1680,1680,0,0
18682,2019-05-13,454,0,454,36,490,490,0,0
18683,2019-05-13,852,0,852,68,920,920,0,0
18684,2019-05-13,139,0,139,11,150,150,0,0
18685,2019-05-13,936,0,936,74,1010,1010,0,0
18686,2019-05-13,389,0,389,31,420,420,0,0
18687,2019-05-13,1575,0,1575,125,1700,1700,0,0
18688,2019-05-13,1575,0,1575,125,1700,1700,0,0
18689,2019-05-13,584,0,584,46,630,630,0,0
18690,2019-05-13,473,0,473,37,510,510,0,0
18691,2019-05-13,982,0,982,78,1060,1060,0,0
18692,2019-05-13,778,0,778,62,840,840,0,0
18693,2019-05-13,936,0,936,74,1010,1010,0,0
18694,2019-05-13,232,0,232,18,250,250,0,0
18695,2019-05-13,1788,0,1788,142,1930,1930,0,0
18696,2019-05-13,704,0,704,56,760,760,0,0
18697,2019-05-13,630,0,630,50,680,680,0,0
18698,2019-05-13,1251,0,1251,99,1350,1350,0,0
18699,2019-05-13,806,0,806,64,870,870,0,0
18700,2019-05-13,139,0,139,11,150,150,0,0
18701,2019-05-13,491,0,491,39,530,530,0,0
18702,2019-05-13,445,0,445,35,480,480,0,0
18703,2019-05-13,945,0,945,75,1020,1020,0,0
18704,2019-05-13,-1296,0,-1296,-94,-1390,-1390,0,0
18705,2019-05-13,575,0,575,45,620,620,0,0
18706,2019-05-13,592,0,592,38,630,630,0,0
18707,2019-05-13,843,0,843,67,910,910,0,0
18708,2019-05-13,788,0,788,62,850,850,0,0
18709,2019-05-13,788,0,788,62,850,850,0,0
18710,2019-05-13,788,0,788,62,850,850,0,0
18711,2019-05-13,658,0,658,52,710,710,0,0
18712,2019-05-13,1575,0,1575,125,1700,1700,0,0
18713,2019-05-13,1575,0,1575,125,1700,1700,0,0
18714,2019-05-13,1083,0,1083,77,1160,1160,0,0
18715,2019-05-13,825,0,825,65,890,890,0,0
18716,2019-05-13,1296,0,1296,94,1390,1390,0,0
18717,2019-05-13,1296,0,1296,94,1390,0,1390,0
18718,2019-05-13,880,0,880,70,950,950,0,0
18719,2019-05-14,620,0,620,40,660,660,0,0
18720,2019-05-14,639,0,639,51,690,690,0,0
18721,2019-05-14,426,0,426,34,460,460,0,0
18722,2019-05-14,1001,0,1001,79,1080,1080,0,0
18723,2019-05-14,704,0,704,56,760,760,0,0
18724,2019-05-14,1084,0,1084,86,1170,1170,0,0
18725,2019-05-14,1251,0,1251,99,1350,0,1350,0
18726,2019-05-14,1473,0,1473,117,1590,1590,0,0
18727,2019-05-14,760,0,760,60,820,820,0,0
18728,2019-05-14,519,0,519,41,560,560,0,0
18729,2019-05-14,639,0,639,51,690,690,0,0
18730,2019-05-14,445,0,445,35,480,0,480,0
18731,2019-05-14,0,0,0,0,0,0,0,0
18732,2019-05-14,334,0,334,26,360,360,0,0
18733,2019-05-14,1704,0,1704,136,1840,1840,0,0
18734,2019-05-14,462,0,462,28,490,490,0,0
18735,2019-05-14,538,0,538,42,580,580,0,0
18736,2019-05-14,1167,0,1167,93,1260,0,1260,0
18737,2019-05-14,491,0,491,39,530,530,0,0
18738,2019-05-14,547,0,547,43,590,590,0,0
18739,2019-05-14,760,0,760,60,820,820,0,0
18740,2019-05-14,593,0,593,47,640,640,0,0
18741,2019-05-14,334,0,334,26,360,360,0,0
18742,2019-05-14,491,0,491,39,530,530,0,0
18743,2019-05-14,1510,0,1510,120,1630,1630,0,0
18744,2019-05-14,732,0,732,58,790,790,0,0
18745,2019-05-14,1417,0,1417,113,1530,1530,0,0
18746,2019-05-14,871,0,871,69,940,940,0,0
18747,2019-05-14,352,0,352,28,380,380,0,0
18748,2019-05-14,1232,0,1232,98,1330,1330,0,0
18749,2019-05-14,2176,0,2176,174,2350,2350,0,0
18750,2019-05-14,3158,0,3158,252,3410,3410,0,0
18751,2019-05-14,362,0,362,28,390,390,0,0
18752,2019-05-15,417,0,417,33,450,450,0,0
18753,2019-05-15,519,0,519,41,560,560,0,0
18754,2019-05-15,112,0,112,8,120,120,0,0
18755,2019-05-15,445,0,445,35,480,480,0,0
18756,2019-05-15,738,-79,659,52,711,711,0,0
18757,2019-05-15,908,0,908,72,980,0,980,0
18758,2019-05-15,602,0,602,48,650,650,0,0
18759,2019-05-15,565,0,565,45,610,610,0,0
18760,2019-05-15,213,0,213,17,230,230,0,0
18761,2019-05-15,547,0,547,43,590,590,0,0
18762,2019-05-15,463,0,463,37,500,500,0,0
18763,2019-05-15,908,0,908,72,980,980,0,0
18764,2019-05-15,176,0,176,14,190,190,0,0
18765,2019-05-15,908,0,908,72,980,980,0,0
18766,2019-05-15,1471,0,1471,99,1570,1570,0,0
18767,2019-05-15,908,0,908,72,980,980,0,0
18768,2019-05-15,1686,0,1686,134,1820,1820,0,0
18769,2019-05-15,602,0,602,48,650,650,0,0
18770,2019-05-15,723,0,723,57,780,780,0,0
18771,2019-05-15,269,0,269,21,290,290,0,0
18772,2019-05-15,788,0,788,62,850,850,0,0
18773,2019-05-15,519,0,519,41,560,560,0,0
18774,2019-05-15,741,0,741,59,800,800,0,0
18775,2019-05-15,260,0,260,20,280,280,0,0
18776,2019-05-15,908,0,908,72,980,980,0,0
18777,2019-05-15,491,0,491,39,530,530,0,0
18778,2019-05-15,1815,0,1815,145,1960,1960,0,0
18779,2019-05-15,362,0,362,28,390,390,0,0
18780,2019-05-15,908,0,908,72,980,980,0,0
18781,2019-05-15,1177,-126,1051,83,1134,1134,0,0
18782,2019-05-15,1362,0,1362,108,1470,1470,0,0
18783,2019-05-15,593,0,593,47,640,640,0,0
18784,2019-05-15,1084,0,1084,86,1170,1170,0,0
18785,2019-05-15,491,0,491,39,530,530,0,0
18786,2019-05-15,806,0,806,64,870,870,0,0
18787,2019-05-15,1047,0,1047,83,1130,1130,0,0
18788,2019-05-15,926,0,926,74,1000,1000,0,0
18789,2019-05-15,260,0,260,20,280,280,0,0
18790,2019-05-15,593,0,593,47,640,640,0,0
18791,2019-05-15,491,0,491,39,530,530,0,0
18792,2019-05-15,482,0,482,38,520,520,0,0
18793,2019-05-15,834,0,834,66,900,900,0,0
18794,2019-05-15,371,0,371,29,400,400,0,0
18795,2019-05-15,417,0,417,33,450,450,0,0
18796,2019-05-15,371,0,371,29,400,400,0,0
18797,2019-05-15,991,0,991,79,1070,1070,0,0
18798,2019-05-15,788,0,788,62,850,850,0,0
18799,2019-05-15,2806,0,2806,224,3030,0,3030,0
18800,2019-05-15,1335,-143,1192,95,1287,1287,0,0
18801,2019-05-15,1213,0,1213,97,1310,1310,0,0
18802,2019-05-15,1204,0,1204,96,1300,0,1300,0
18803,2019-05-15,1973,0,1973,157,2130,2130,0,0
18804,2019-05-15,593,0,593,47,640,640,0,0
18805,2019-05-15,269,0,269,21,290,290,0,0
18806,2019-05-15,325,0,325,25,350,350,0,0
18807,2019-05-15,1899,0,1899,151,2050,2050,0,0
18808,2019-05-15,445,0,445,35,480,480,0,0
18809,2019-05-15,788,0,788,62,850,850,0,0
18810,2019-05-15,788,0,788,62,850,850,0,0
18811,2019-05-15,732,0,732,58,790,790,0,0
18812,2019-05-15,232,0,232,18,250,250,0,0
18813,2019-05-15,667,0,667,53,720,720,0,0
18814,2019-05-15,723,0,723,57,780,780,0,0
18815,2019-05-15,297,0,297,23,320,320,0,0
18816,2019-05-15,343,0,343,27,370,0,370,0
18817,2019-05-15,667,0,667,53,720,720,0,0
18818,2019-05-15,334,0,334,26,360,360,0,0
18819,2019-05-15,3630,0,3630,290,3920,3920,0,0
18820,2019-05-15,389,0,389,31,420,420,0,0
18821,2019-05-15,908,0,908,72,980,980,0,0
18822,2019-05-15,278,0,278,22,300,300,0,0
18823,2019-05-15,704,0,704,56,760,760,0,0
18824,2019-05-15,1575,0,1575,125,1700,1700,0,0
18825,2019-05-15,334,0,334,26,360,360,0,0
18826,2019-05-15,908,0,908,72,980,980,0,0
18827,2019-05-15,741,0,741,59,800,800,0,0
18828,2019-05-15,664,0,664,26,690,690,0,0
18829,2019-05-15,149,0,149,11,160,160,0,0
18830,2019-05-15,167,0,167,13,180,180,0,0
18831,2019-05-15,260,0,260,20,280,280,0,0
18832,2019-05-15,334,0,334,26,360,360,0,0
18833,2019-05-15,1380,0,1380,110,1490,1490,0,0
18834,2019-05-15,723,0,723,57,780,780,0,0
18835,2019-05-16,908,0,908,72,980,980,0,0
18836,2019-05-16,908,0,908,72,980,980,0,0
18837,2019-05-16,371,0,371,29,400,400,0,0
18838,2019-05-16,223,0,223,17,240,0,240,0
18839,2019-05-16,1538,0,1538,122,1660,1660,0,0
18840,2019-05-16,973,0,973,77,1050,1050,0,0
18841,2019-05-16,167,0,167,13,180,180,0,0
18842,2019-05-16,251,0,251,19,270,0,270,0
18843,2019-05-16,630,0,630,50,680,680,0,0
18844,2019-05-16,575,0,575,45,620,620,0,0
18845,2019-05-16,306,0,306,24,330,330,0,0
18846,2019-05-16,575,0,575,45,620,620,0,0
18847,2019-05-16,362,0,362,28,390,390,0,0
18848,2019-05-16,1904,-204,1700,136,1836,1836,0,0
18849,2019-05-16,380,0,380,30,410,410,0,0
18850,2019-05-16,491,0,491,39,530,530,0,0
18851,2019-05-16,343,0,343,27,370,370,0,0
18852,2019-05-16,234,-25,209,16,225,225,0,0
18853,2019-05-16,908,0,908,72,980,980,0,0
18854,2019-05-16,908,0,908,72,980,980,0,0
18855,2019-05-16,1204,0,1204,96,1300,1300,0,0
18856,2019-05-16,334,0,334,26,360,360,0,0
18857,2019-05-16,1648,0,1648,122,1770,1770,0,0
18858,2019-05-16,713,0,713,57,770,770,0,0
18859,2019-05-16,926,0,926,74,1000,1000,0,0
18860,2019-05-16,788,0,788,62,850,850,0,0
18861,2019-05-16,1815,0,1815,145,1960,1960,0,0
18862,2019-05-16,676,0,676,54,730,730,0,0
18863,2019-05-16,732,0,732,58,790,790,0,0
18864,2019-05-16,1792,-192,1600,128,1728,1728,0,0
18865,2019-05-16,1334,0,1334,106,1440,1440,0,0
18866,2019-05-16,663,-71,592,47,639,639,0,0
18867,2019-05-16,444,0,444,26,470,470,0,0
18868,2019-05-16,1686,0,1686,134,1820,1820,0,0
18869,2019-05-16,908,0,908,72,980,980,0,0
18870,2019-05-16,602,0,602,48,650,650,0,0
18871,2019-05-16,501,0,501,39,540,540,0,0
18872,2019-05-16,908,0,908,72,980,980,0,0
18873,2019-05-16,908,0,908,72,980,980,0,0
18874,2019-05-16,491,0,491,39,530,530,0,0
18875,2019-05-16,607,-65,542,43,585,585,0,0
18876,2019-05-16,954,0,954,76,1030,1030,0,0
18877,2019-05-16,908,0,908,72,980,980,0,0
18878,2019-05-16,547,0,547,43,590,590,0,0
18879,2019-05-16,666,0,666,44,710,710,0,0
18880,2019-05-16,519,0,519,41,560,560,0,0
18881,2019-05-16,260,0,260,20,280,280,0,0
18882,2019-05-16,1815,0,1815,145,1960,1960,0,0
18883,2019-05-16,1112,0,1112,88,1200,1200,0,0
18884,2019-05-16,973,0,973,77,1050,1050,0,0
18885,2019-05-16,473,0,473,37,510,510,0,0
18886,2019-05-16,1251,0,1251,99,1350,1350,0,0
18887,2019-05-16,908,0,908,72,980,980,0,0
18888,2019-05-16,612,0,612,48,660,660,0,0
18889,2019-05-16,501,0,501,39,540,540,0,0
18890,2019-05-16,2379,0,2379,181,2560,2560,0,0
18891,2019-05-16,731,0,731,49,780,780,0,0
18892,2019-05-16,1093,0,1093,87,1180,1180,0,0
18893,2019-05-16,713,0,713,57,770,770,0,0
18894,2019-05-16,288,0,288,22,310,310,0,0
18895,2019-05-16,936,0,936,74,1010,1010,0,0
18896,2019-05-16,621,0,621,49,670,0,670,0
18897,2019-05-16,1037,-111,926,73,999,999,0,0
18898,2019-05-16,1195,0,1195,95,1290,1290,0,0
18899,2019-05-16,538,0,538,42,580,0,580,0
18900,2019-05-16,538,0,538,42,580,580,0,0
18901,2019-05-16,528,0,528,42,570,570,0,0
18902,2019-05-16,695,0,695,55,750,750,0,0
18903,2019-05-16,362,0,362,28,390,390,0,0
18904,2019-05-16,380,0,380,30,410,410,0,0
18905,2019-05-16,436,0,436,34,470,470,0,0
18906,2019-05-16,1510,0,1510,120,1630,1630,0,0
18907,2019-05-16,408,0,408,32,440,440,0,0
18908,2019-05-16,695,0,695,55,750,750,0,0
18909,2019-05-16,801,0,801,63,864,864,0,0
18910,2019-05-16,612,0,612,48,660,660,0,0
18911,2019-05-16,260,0,260,20,280,280,0,0
18912,2019-05-16,213,0,213,17,230,230,0,0
18913,2019-05-16,519,0,519,41,560,560,0,0
18914,2019-05-16,731,0,731,49,780,780,0,0
18915,2019-05-16,167,0,167,13,180,180,0,0
18916,2019-05-16,459,0,459,36,495,495,0,0
18917,2019-05-16,1575,0,1575,125,1700,1700,0,0
18918,2019-05-16,926,0,926,74,1000,1000,0,0
18919,2019-05-16,1575,0,1575,125,1700,1700,0,0
18920,2019-05-16,788,0,788,62,850,850,0,0
18921,2019-05-16,232,0,232,18,250,250,0,0
18922,2019-05-16,288,0,288,22,310,310,0,0
18923,2019-05-16,565,0,565,45,610,610,0,0
18924,2019-05-16,2473,0,2473,197,2670,0,2670,0
18925,2019-05-16,908,0,908,72,980,980,0,0
18926,2019-05-16,306,0,306,24,330,330,0,0
18927,2019-05-16,260,0,260,20,280,280,0,0
18928,2019-05-16,982,0,982,78,1060,0,1060,0
18929,2019-05-16,751,0,751,59,810,810,0,0
18930,2019-05-16,260,0,260,20,280,280,0,0
18931,2019-05-16,945,0,945,75,1020,1020,0,0
18932,2019-05-16,417,0,417,33,450,450,0,0
18933,2019-05-16,278,0,278,22,300,300,0,0
18934,2019-05-16,704,0,704,56,760,760,0,0
18935,2019-05-16,584,0,584,46,630,630,0,0
18936,2019-05-16,371,0,371,29,400,400,0,0
18937,2019-05-16,1667,0,1667,133,1800,1800,0,0
18938,2019-05-16,880,0,880,70,950,950,0,0
18939,2019-05-16,204,0,204,16,220,220,0,0
18940,2019-05-16,982,0,982,78,1060,1060,0,0
18941,2019-05-16,788,0,788,62,850,850,0,0
18942,2019-05-16,389,0,389,31,420,420,0,0
18943,2019-05-16,788,0,788,62,850,850,0,0
18944,2019-05-16,204,0,204,16,220,220,0,0
18945,2019-05-16,1575,0,1575,125,1700,1700,0,0
18946,2019-05-16,417,0,417,33,450,450,0,0
18947,2019-05-16,963,0,963,77,1040,1040,0,0
18948,2019-05-16,1463,0,1463,117,1580,1580,0,0
18949,2019-05-16,575,0,575,45,620,620,0,0
18950,2019-05-16,649,0,649,51,700,700,0,0
18951,2019-05-16,556,0,556,44,600,600,0,0
18952,2019-05-16,102,0,102,8,110,110,0,0
18953,2019-05-16,784,-84,700,56,756,756,0,0
18954,2019-05-16,232,0,232,18,250,250,0,0
18955,2019-05-16,612,0,612,48,660,660,0,0
18956,2019-05-16,1575,0,1575,125,1700,1700,0,0
18957,2019-05-16,723,0,723,57,780,780,0,0
18958,2019-05-16,1038,0,1038,82,1120,1120,0,0
18959,2019-05-16,778,0,778,62,840,840,0,0
18960,2019-05-16,1325,0,1325,105,1430,1430,0,0
18961,2019-05-16,1288,0,1288,102,1390,1390,0,0
18962,2019-05-16,788,0,788,62,850,850,0,0
18963,2019-05-16,777,0,777,53,830,830,0,0
18964,2019-05-16,371,0,371,29,400,400,0,0
18965,2019-05-16,278,0,278,22,300,300,0,0
18966,2019-05-16,1036,0,1036,74,1110,1110,0,0
18967,2019-05-16,1575,0,1575,125,1700,1700,0,0
18968,2019-05-16,732,0,732,58,790,790,0,0
18969,2019-05-16,584,0,584,46,630,630,0,0
18970,2019-05-16,417,0,417,33,450,450,0,0
18971,2019-05-16,-371,0,-371,-29,-400,-400,0,0
18972,2019-05-16,538,0,538,42,580,580,0,0
18973,2019-05-16,519,0,519,41,560,560,0,0
18974,2019-05-16,1602,0,1602,128,1730,1730,0,0
18975,2019-05-16,426,0,426,34,460,460,0,0
18976,2019-05-16,271,-29,242,19,261,261,0,0
18977,2019-05-16,371,0,371,29,400,400,0,0
18978,2019-05-17,260,0,260,20,280,280,0,0
18979,2019-05-17,630,0,630,50,680,680,0,0
18980,2019-05-17,649,0,649,51,700,700,0,0
18981,2019-05-17,945,0,945,75,1020,1020,0,0
18982,2019-05-17,851,0,851,59,910,910,0,0
18983,2019-05-17,463,0,463,37,500,500,0,0
18984,2019-05-17,371,0,371,29,400,400,0,0
18985,2019-05-17,554,0,554,26,580,580,0,0
18986,2019-05-17,1084,0,1084,86,1170,1170,0,0
18987,2019-05-17,1815,0,1815,145,1960,1960,0,0
18988,2019-05-17,852,0,852,68,920,920,0,0
18989,2019-05-17,1407,0,1407,103,1510,1510,0,0
18990,2019-05-17,1815,0,1815,145,1960,1960,0,0
18991,2019-05-17,722,0,722,48,770,770,0,0
18992,2019-05-17,713,0,713,57,770,770,0,0
18993,2019-05-17,758,0,758,42,800,800,0,0
18994,2019-05-17,852,0,852,68,920,920,0,0
18995,2019-05-17,889,0,889,71,960,960,0,0
18996,2019-05-17,3306,0,3306,264,3570,3570,0,0
18997,2019-05-17,908,0,908,72,980,980,0,0
18998,2019-05-17,1083,0,1083,77,1160,1160,0,0
18999,2019-05-17,630,0,630,50,680,680,0,0
19000,2019-05-17,908,0,908,72,980,980,0,0
19001,2019-05-17,908,0,908,72,980,980,0,0
19002,2019-05-17,1056,0,1056,84,1140,1140,0,0
19003,2019-05-17,908,0,908,72,980,980,0,0
19004,2019-05-17,908,0,908,72,980,980,0,0
19005,2019-05-17,1278,0,1278,102,1380,1380,0,0
19006,2019-05-17,908,0,908,72,980,980,0,0
19007,2019-05-17,510,0,510,40,550,550,0,0
19008,2019-05-17,547,0,547,43,590,590,0,0
19009,2019-05-17,815,0,815,65,880,880,0,0
19010,2019-05-17,1670,0,1670,133,1803,1803,0,0
19011,2019-05-17,321,0,321,25,346,346,0,0
19012,2019-05-17,491,0,491,39,530,530,0,0
19013,2019-05-17,260,0,260,20,280,280,0,0
19014,2019-05-17,945,0,945,75,1020,1020,0,0
19015,2019-05-17,973,0,973,77,1050,1050,0,0
19016,2019-05-17,575,0,575,45,620,620,0,0
19017,2019-05-17,871,0,871,69,940,940,0,0
19018,2019-05-17,454,0,454,36,490,490,0,0
19019,2019-05-17,732,0,732,58,790,790,0,0
19020,2019-05-17,667,0,667,53,720,720,0,0
19021,2019-05-17,426,0,426,34,460,460,0,0
19022,2019-05-17,1232,0,1232,98,1330,1330,0,0
19023,2019-05-17,371,0,371,29,400,400,0,0
19024,2019-05-17,213,0,213,17,230,230,0,0
19025,2019-05-17,1028,0,1028,82,1110,1110,0,0
19026,2019-05-17,889,0,889,71,960,960,0,0
19027,2019-05-17,612,0,612,48,660,660,0,0
19028,2019-05-17,1815,0,1815,145,1960,1960,0,0
19029,2019-05-17,463,0,463,37,500,500,0,0
19030,2019-05-17,260,0,260,20,280,280,0,0
19031,2019-05-17,389,0,389,31,420,420,0,0
19032,2019-05-17,1815,0,1815,145,1960,1960,0,0
19033,2019-05-17,713,0,713,57,770,770,0,0
19034,2019-05-17,1630,0,1630,130,1760,1760,0,0
19035,2019-05-17,621,0,621,49,670,670,0,0
19036,2019-05-17,1815,0,1815,145,1960,1960,0,0
19037,2019-05-17,843,0,843,67,910,910,0,0
19038,2019-05-17,1408,0,1408,112,1520,1520,0,0
19039,2019-05-17,945,0,945,75,1020,1020,0,0
19040,2019-05-17,1204,0,1204,96,1300,1300,0,0
19041,2019-05-17,436,0,436,34,470,470,0,0
19042,2019-05-17,167,0,167,13,180,180,0,0
19043,2019-05-17,1010,0,1010,80,1090,1090,0,0
19044,2019-05-17,1223,0,1223,97,1320,1320,0,0
19045,2019-05-17,723,0,723,57,780,780,0,0
19046,2019-05-17,1639,0,1639,131,1770,1770,0,0
19047,2019-05-17,686,0,686,54,740,740,0,0
19048,2019-05-17,399,0,399,31,430,430,0,0
19049,2019-05-17,102,0,102,8,110,110,0,0
19050,2019-05-17,1295,0,1295,85,1380,1380,0,0
19051,2019-05-17,1028,0,1028,82,1110,1110,0,0
19052,2019-05-17,306,0,306,24,330,330,0,0
19053,2019-05-17,2362,0,2362,188,2550,2550,0,0
19054,2019-05-17,417,0,417,33,450,450,0,0
19055,2019-05-17,982,0,982,78,1060,1060,0,0
19056,2019-05-17,417,0,417,33,450,450,0,0
19057,2019-05-17,1315,0,1315,105,1420,1420,0,0
19058,2019-05-17,306,0,306,24,330,330,0,0
19059,2019-05-17,491,0,491,39,530,530,0,0
19060,2019-05-17,269,0,269,21,290,290,0,0
19061,2019-05-17,278,0,278,22,300,300,0,0
19062,2019-05-17,334,0,334,26,360,360,0,0
19063,2019-05-17,56,0,56,4,60,60,0,0
19064,2019-05-17,453,0,453,27,480,480,0,0
19065,2019-05-17,1028,0,1028,82,1110,1110,0,0
19066,2019-05-17,362,0,362,28,390,390,0,0
19067,2019-05-17,2417,0,2417,193,2610,2610,0,0
19068,2019-05-17,139,0,139,11,150,150,0,0
19069,2019-05-17,769,0,769,61,830,830,0,0
19070,2019-05-17,788,0,788,62,850,850,0,0
19071,2019-05-17,639,0,639,51,690,690,0,0
19072,2019-05-17,510,0,510,40,550,550,0,0
19073,2019-05-17,509,0,509,31,540,540,0,0
19074,2019-05-17,769,0,769,61,830,830,0,0
19075,2019-05-17,121,0,121,9,130,130,0,0
19076,2019-05-17,426,0,426,34,460,460,0,0
19077,2019-05-17,139,0,139,11,150,150,0,0
19078,2019-05-17,719,-77,642,51,693,693,0,0
19079,2019-05-17,991,0,991,79,1070,1070,0,0
19080,2019-05-17,945,0,945,75,1020,1020,0,0
19081,2019-05-17,954,0,954,76,1030,1030,0,0
19082,2019-05-17,834,0,834,66,900,900,0,0
19083,2019-05-17,528,0,528,42,570,570,0,0
19084,2019-05-17,1788,0,1788,142,1930,1930,0,0
19085,2019-05-17,528,0,528,42,570,570,0,0
19086,2019-05-17,1195,0,1195,95,1290,1290,0,0
19087,2019-05-17,778,0,778,62,840,840,0,0
19088,2019-05-17,2528,0,2528,202,2730,2730,0,0
19089,2019-05-17,334,0,334,26,360,360,0,0
19090,2019-05-17,723,0,723,57,780,780,0,0
19091,2019-05-17,195,0,195,15,210,210,0,0
19092,2019-05-17,1102,0,1102,88,1190,1190,0,0
19093,2019-05-17,1139,0,1139,91,1230,1230,0,0
19094,2019-05-17,1213,0,1213,97,1310,1310,0,0
19095,2019-05-17,1575,0,1575,125,1700,1700,0,0
19096,2019-05-17,538,0,538,42,580,580,0,0
19097,2019-05-17,510,0,510,40,550,550,0,0
19098,2019-05-17,1491,0,1491,119,1610,1610,0,0
19099,2019-05-17,213,0,213,17,230,230,0,0
19100,2019-05-17,362,0,362,28,390,390,0,0
19101,2019-05-17,1575,0,1575,125,1700,1700,0,0
19102,2019-05-17,788,0,788,62,850,850,0,0
19103,2019-05-17,788,0,788,62,850,850,0,0
19104,2019-05-17,645,-69,576,45,621,0,621,0
19105,2019-05-17,445,0,445,35,480,480,0,0
19106,2019-05-17,1575,0,1575,125,1700,1700,0,0
19107,2019-05-17,667,0,667,53,720,720,0,0
19108,2019-05-17,1092,0,1092,78,1170,1170,0,0
19109,2019-05-17,797,0,797,63,860,860,0,0
19110,2019-05-17,220,0,220,0,220,220,0,0
19111,2019-05-17,436,0,436,34,470,470,0,0
19112,2019-05-17,788,0,788,62,850,850,0,0
19113,2019-05-17,788,0,788,62,850,850,0,0
19114,2019-05-17,834,0,834,66,900,900,0,0
19115,2019-05-17,788,0,788,62,850,850,0,0
19116,2019-05-17,1333,0,1333,97,1430,1430,0,0
19117,2019-05-17,398,0,398,22,420,420,0,0
19118,2019-05-17,862,0,862,68,930,930,0,0
19119,2019-05-17,1334,0,1334,106,1440,1440,0,0
19120,2019-05-17,917,0,917,73,990,990,0,0
19121,2019-05-17,436,0,436,34,470,470,0,0
19122,2019-05-17,862,0,862,68,930,930,0,0
19123,2019-05-17,417,0,417,33,450,450,0,0
19124,2019-05-17,371,0,371,29,400,400,0,0
19125,2019-05-17,1917,0,1917,153,2070,2070,0,0
19126,2019-05-17,806,0,806,64,870,870,0,0
19127,2019-05-18,1815,0,1815,145,1960,1960,0,0
19128,2019-05-18,1815,0,1815,145,1960,0,1960,0
19129,2019-05-18,538,0,538,42,580,580,0,0
19130,2019-05-18,602,0,602,48,650,650,0,0
19131,2019-05-18,899,0,899,71,970,970,0,0
19132,2019-05-18,982,0,982,78,1060,1060,0,0
19133,2019-05-18,463,0,463,37,500,500,0,0
19134,2019-05-18,1917,0,1917,153,2070,2070,0,0
19135,2019-05-18,732,0,732,58,790,790,0,0
19136,2019-05-18,908,0,908,72,980,980,0,0
19137,2019-05-18,1223,0,1223,97,1320,1320,0,0
19138,2019-05-18,1815,0,1815,145,1960,1960,0,0
19139,2019-05-18,3019,0,3019,241,3260,0,3260,0
19140,2019-05-18,556,0,556,44,600,600,0,0
19141,2019-05-18,1047,0,1047,83,1130,1130,0,0
19142,2019-05-18,788,0,788,62,850,850,0,0
19143,2019-05-18,2325,0,2325,185,2510,2510,0,0
19144,2019-05-18,1815,0,1815,145,1960,1960,0,0
19145,2019-05-18,389,0,389,31,420,420,0,0
19146,2019-05-18,2389,0,2389,191,2580,2580,0,0
19147,2019-05-18,1038,0,1038,82,1120,1120,0,0
19148,2019-05-18,843,0,843,67,910,910,0,0
19149,2019-05-18,575,0,575,45,620,620,0,0
19150,2019-05-18,1815,0,1815,145,1960,1960,0,0
19151,2019-05-18,880,0,880,70,950,950,0,0
19152,2019-05-18,482,0,482,38,520,520,0,0
19153,2019-05-18,1315,0,1315,105,1420,1420,0,0
19154,2019-05-18,630,0,630,50,680,680,0,0
19155,2019-05-18,399,0,399,31,430,0,430,0
19156,2019-05-18,1575,0,1575,125,1700,0,1700,0
19157,2019-05-18,695,0,695,55,750,750,0,0
19158,2019-05-18,454,0,454,36,490,490,0,0
19159,2019-05-18,1760,0,1760,140,1900,1900,0,0
19160,2019-05-18,732,0,732,58,790,790,0,0
19161,2019-05-18,519,0,519,41,560,560,0,0
19162,2019-05-18,732,0,732,58,790,790,0,0
19163,2019-05-18,1575,0,1575,125,1700,1700,0,0
19164,2019-05-18,907,0,907,63,970,970,0,0
19165,2019-05-18,2834,0,2834,226,3060,3060,0,0
19166,2019-05-18,1575,0,1575,125,1700,1700,0,0
19167,2019-05-18,1251,0,1251,99,1350,1350,0,0
19168,2019-05-18,602,0,602,48,650,650,0,0
19169,2019-05-18,1362,0,1362,108,1470,1470,0,0
19170,2019-05-18,788,0,788,62,850,850,0,0
19171,2019-05-18,269,0,269,21,290,290,0,0
19172,2019-05-18,788,0,788,62,850,850,0,0
19173,2019-05-18,491,0,491,39,530,530,0,0
19174,2019-05-18,306,0,306,24,330,330,0,0
19175,2019-05-18,1815,0,1815,145,1960,1960,0,0
19176,2019-05-18,556,0,556,44,600,600,0,0
19177,2019-05-18,1945,0,1945,155,2100,2100,0,0
19178,2019-05-18,778,0,778,62,840,840,0,0
19179,2019-05-18,306,0,306,24,330,330,0,0
19180,2019-05-18,1830,-196,1634,130,1764,1764,0,0
19181,2019-05-18,695,0,695,55,750,750,0,0
19182,2019-05-18,1028,0,1028,82,1110,1110,0,0
19183,2019-05-18,759,0,759,51,810,810,0,0
19184,2019-05-18,630,0,630,50,680,680,0,0
19185,2019-05-18,1130,0,1130,90,1220,1220,0,0
19186,2019-05-18,575,0,575,45,620,620,0,0
19187,2019-05-18,232,0,232,18,250,250,0,0
19188,2019-05-18,843,0,843,67,910,910,0,0
19189,2019-05-18,1028,0,1028,82,1110,1110,0,0
19190,2019-05-18,621,0,621,49,670,670,0,0
19191,2019-05-18,1325,0,1325,105,1430,1430,0,0
19192,2019-05-18,1241,0,1241,99,1340,1340,0,0
19193,2019-05-18,788,0,788,62,850,0,850,0
19194,2019-05-18,491,0,491,39,530,0,530,0
19195,2019-05-18,463,0,463,37,500,500,0,0
19196,2019-05-18,417,0,417,33,450,450,0,0
19197,2019-05-18,658,0,658,52,710,710,0,0
19198,2019-05-18,389,0,389,31,420,420,0,0
19199,2019-05-18,2556,0,2556,204,2760,2760,0,0
19200,2019-05-18,149,0,149,11,160,160,0,0
19201,2019-05-18,1297,0,1297,103,1400,1400,0,0
19202,2019-05-18,417,0,417,33,450,450,0,0
19203,2019-05-18,482,0,482,38,520,520,0,0
19204,2019-05-18,1565,0,1565,125,1690,1690,0,0
19205,2019-05-18,2038,0,2038,162,2200,2200,0,0
19206,2019-05-18,269,0,269,21,290,290,0,0
19207,2019-05-18,945,0,945,75,1020,1020,0,0
19208,2019-05-18,269,0,269,21,290,290,0,0
19209,2019-05-18,538,0,538,42,580,580,0,0
19210,2019-05-18,250,0,250,20,270,270,0,0
19211,2019-05-18,463,0,463,37,500,500,0,0
19212,2019-05-18,2158,0,2158,172,2330,2330,0,0
19213,2019-05-18,1815,0,1815,145,1960,1960,0,0
19214,2019-05-18,334,0,334,26,360,360,0,0
19215,2019-05-18,1815,0,1815,145,1960,1960,0,0
19216,2019-05-18,2097,-223,1874,133,2007,2007,0,0
19217,2019-05-18,1512,-162,1350,108,1458,1458,0,0
19218,2019-05-18,1408,0,1408,112,1520,1520,0,0
19219,2019-05-18,399,0,399,31,430,430,0,0
19220,2019-05-18,2195,0,2195,175,2370,2370,0,0
19221,2019-05-18,834,0,834,66,900,900,0,0
19222,2019-05-18,852,0,852,68,920,920,0,0
19223,2019-05-18,926,0,926,74,1000,1000,0,0
19224,2019-05-18,1101,0,1101,79,1180,1180,0,0
19225,2019-05-18,463,0,463,37,500,500,0,0
19226,2019-05-18,723,0,723,57,780,780,0,0
19227,2019-05-18,917,0,917,73,990,990,0,0
19228,2019-05-18,501,0,501,39,540,540,0,0
19229,2019-05-18,547,0,547,43,590,590,0,0
19230,2019-05-18,908,0,908,72,980,980,0,0
19231,2019-05-18,1047,0,1047,83,1130,1130,0,0
19232,2019-05-18,2047,0,2047,163,2210,2210,0,0
19233,2019-05-18,297,0,297,23,320,320,0,0
19234,2019-05-18,1463,0,1463,117,1580,1580,0,0
19235,2019-05-18,1232,0,1232,98,1330,1330,0,0
19236,2019-05-18,473,0,473,37,510,510,0,0
19237,2019-05-18,602,0,602,48,650,650,0,0
19238,2019-05-18,269,0,269,21,290,290,0,0
19239,2019-05-18,1093,0,1093,87,1180,1180,0,0
19240,2019-05-18,501,0,501,39,540,540,0,0
19241,2019-05-18,2001,0,2001,159,2160,2160,0,0
19242,2019-05-18,565,0,565,45,610,610,0,0
19243,2019-05-18,834,0,834,66,900,900,0,0
19244,2019-05-18,565,0,565,45,610,610,0,0
19245,2019-05-18,556,0,556,44,600,600,0,0
19246,2019-05-18,195,0,195,15,210,210,0,0
19247,2019-05-18,1028,0,1028,82,1110,1110,0,0
19248,2019-05-18,1195,0,1195,95,1290,1290,0,0
19249,2019-05-18,862,0,862,68,930,930,0,0
19250,2019-05-18,1297,0,1297,103,1400,1400,0,0
19251,2019-05-18,399,0,399,31,430,430,0,0
19252,2019-05-18,204,0,204,16,220,220,0,0
19253,2019-05-18,371,0,371,29,400,400,0,0
19254,2019-05-18,1908,0,1908,152,2060,2060,0,0
19255,2019-05-18,288,0,288,22,310,310,0,0
19256,2019-05-18,954,0,954,76,1030,1030,0,0
19257,2019-05-18,538,0,538,42,580,580,0,0
19258,2019-05-18,741,0,741,59,800,800,0,0
19259,2019-05-18,963,0,963,77,1040,1040,0,0
19260,2019-05-18,926,0,926,74,1000,1000,0,0
19261,2019-05-18,1343,0,1343,107,1450,1450,0,0
19262,2019-05-18,172,0,172,13,185,185,0,0
19263,2019-05-18,973,0,973,77,1050,1050,0,0
19264,2019-05-18,269,0,269,21,290,290,0,0
19265,2019-05-18,352,0,352,28,380,380,0,0
19266,2019-05-18,2001,0,2001,159,2160,2160,0,0
19267,2019-05-18,1575,0,1575,125,1700,1700,0,0
19268,2019-05-18,260,0,260,20,280,280,0,0
19269,2019-05-18,1555,0,1555,115,1670,1670,0,0
19270,2019-05-18,501,0,501,39,540,540,0,0
19271,2019-05-18,880,0,880,70,950,950,0,0
19272,2019-05-18,491,0,491,39,530,530,0,0
19273,2019-05-18,491,0,491,39,530,530,0,0
19274,2019-05-18,509,0,509,31,540,540,0,0
19275,2019-05-18,564,0,564,36,600,600,0,0
19276,2019-05-18,426,0,426,34,460,460,0,0
19277,2019-05-18,1167,0,1167,93,1260,1260,0,0
19278,2019-05-18,908,0,908,72,980,980,0,0
19279,2019-05-18,1528,0,1528,122,1650,1650,0,0
19280,2019-05-18,167,0,167,13,180,180,0,0
19281,2019-05-18,288,0,288,22,310,310,0,0
19282,2019-05-18,1445,0,1445,115,1560,1560,0,0
19283,2019-05-18,1649,0,1649,131,1780,0,1780,0
19284,2019-05-18,334,0,334,26,360,360,0,0
19285,2019-05-18,371,0,371,29,400,400,0,0
19286,2019-05-18,510,0,510,40,550,550,0,0
19287,2019-05-18,380,0,380,30,410,410,0,0
19288,2019-05-18,371,0,371,29,400,400,0,0
19289,2019-05-18,334,0,334,26,360,360,0,0
19290,2019-05-18,1084,0,1084,86,1170,1170,0,0
19291,2019-05-18,288,0,288,22,310,310,0,0
19292,2019-05-18,1260,0,1260,100,1360,1360,0,0
19293,2019-05-18,630,0,630,50,680,680,0,0
19294,2019-05-18,278,0,278,22,300,300,0,0
19295,2019-05-18,445,0,445,35,480,480,0,0
19296,2019-05-18,593,0,593,47,640,640,0,0
19297,2019-05-18,195,0,195,15,210,210,0,0
19298,2019-05-18,788,0,788,62,850,850,0,0
19299,2019-05-18,3704,0,3704,296,4000,4000,0,0
19300,2019-05-18,176,0,176,14,190,190,0,0
19301,2019-05-18,278,0,278,22,300,300,0,0
19302,2019-05-18,602,0,602,48,650,650,0,0
19303,2019-05-18,788,0,788,62,850,850,0,0
19304,2019-05-18,788,0,788,62,850,850,0,0
19305,2019-05-18,788,0,788,62,850,850,0,0
19306,2019-05-18,788,0,788,62,850,850,0,0
19307,2019-05-18,788,0,788,62,850,850,0,0
19308,2019-05-18,788,0,788,62,850,850,0,0
19309,2019-05-18,1130,0,1130,90,1220,1220,0,0
19310,2019-05-18,1038,0,1038,82,1120,1120,0,0
19311,2019-05-18,1195,0,1195,95,1290,1290,0,0
19312,2019-05-18,788,0,788,62,850,850,0,0
19313,2019-05-18,1038,0,1038,82,1120,1120,0,0
19314,2019-05-18,760,0,760,60,820,820,0,0
19315,2019-05-18,426,0,426,34,460,460,0,0
19316,2019-05-18,667,0,667,53,720,720,0,0
19317,2019-05-18,1001,0,1001,79,1080,1080,0,0
19318,2019-05-18,649,0,649,51,700,700,0,0
19319,2019-05-18,1593,0,1593,127,1720,1720,0,0
19320,2019-05-18,788,0,788,62,850,850,0,0
19321,2019-05-18,788,0,788,62,850,850,0,0
19322,2019-05-18,518,0,518,32,550,550,0,0
19323,2019-05-18,1010,0,1010,80,1090,1090,0,0
19324,2019-05-18,1575,0,1575,125,1700,1700,0,0
19325,2019-05-18,482,0,482,38,520,520,0,0
19326,2019-05-18,2639,0,2639,211,2850,0,2850,0
19327,2019-05-18,315,0,315,25,340,340,0,0
19328,2019-05-18,769,0,769,61,830,830,0,0
19329,2019-05-18,788,0,788,62,850,850,0,0
19330,2019-05-18,788,0,788,62,850,0,850,0
19331,2019-05-18,1575,0,1575,125,1700,0,1700,0
19332,2019-05-18,751,0,751,59,810,810,0,0
19333,2019-05-18,3482,0,3482,278,3760,3760,0,0
19334,2019-05-18,389,0,389,31,420,420,0,0
19335,2019-05-18,751,0,751,59,810,810,0,0
19336,2019-05-18,788,0,788,62,850,850,0,0
19337,2019-05-18,788,0,788,62,850,850,0,0
19338,2019-05-18,788,0,788,62,850,850,0,0
19339,2019-05-18,945,0,945,75,1020,1020,0,0
19340,2019-05-18,102,0,102,8,110,110,0,0
19341,2019-05-18,-5649,0,-5649,-451,-6100,-6100,0,0
19342,2019-05-18,694,0,694,46,740,740,0,0
19343,2019-05-18,788,0,788,62,850,850,0,0
19344,2019-05-18,1852,0,1852,148,2000,2000,0,0
19345,2019-05-18,1575,0,1575,125,1700,1700,0,0
19346,2019-05-18,649,0,649,51,700,700,0,0
19347,2019-05-18,5649,0,5649,451,6100,6100,0,0
19348,2019-05-18,5649,0,5649,451,6100,0,6100,0
19349,2019-05-18,371,0,371,29,400,400,0,0
19350,2019-05-18,334,0,334,26,360,360,0,0
19351,2019-05-18,713,0,713,57,770,770,0,0
19352,2019-05-18,788,0,788,62,850,850,0,0
19353,2019-05-19,704,0,704,56,760,760,0,0
19354,2019-05-19,1010,0,1010,80,1090,1090,0,0
19355,2019-05-19,639,0,639,51,690,690,0,0
19356,2019-05-19,649,0,649,51,700,700,0,0
19357,2019-05-19,926,0,926,74,1000,1000,0,0
19358,2019-05-19,1445,0,1445,115,1560,1560,0,0
19359,2019-05-19,288,0,288,22,310,310,0,0
19360,2019-05-19,204,0,204,16,220,220,0,0
19361,2019-05-19,1815,0,1815,145,1960,1960,0,0
19362,2019-05-19,343,0,343,27,370,370,0,0
19363,2019-05-19,1001,0,1001,79,1080,1080,0,0
19364,2019-05-19,167,0,167,13,180,180,0,0
19365,2019-05-19,1593,0,1593,127,1720,1720,0,0
19366,2019-05-19,1769,0,1769,141,1910,1910,0,0
19367,2019-05-19,732,0,732,58,790,790,0,0
19368,2019-05-19,325,0,325,25,350,350,0,0
19369,2019-05-19,834,0,834,66,900,900,0,0
19370,2019-05-19,473,0,473,37,510,510,0,0
19371,2019-05-19,1815,0,1815,145,1960,1960,0,0
19372,2019-05-19,1065,0,1065,85,1150,1150,0,0
19373,2019-05-19,306,0,306,24,330,330,0,0
19374,2019-05-19,343,0,343,27,370,370,0,0
19375,2019-05-19,519,0,519,41,560,560,0,0
19376,2019-05-19,1186,0,1186,94,1280,1280,0,0
19377,2019-05-19,982,0,982,78,1060,1060,0,0
19378,2019-05-19,1380,0,1380,110,1490,1490,0,0
19379,2019-05-19,1112,0,1112,88,1200,1200,0,0
19380,2019-05-19,260,0,260,20,280,280,0,0
19381,2019-05-19,269,0,269,21,290,290,0,0
19382,2019-05-19,936,0,936,74,1010,1010,0,0
19383,2019-05-19,908,0,908,72,980,980,0,0
19384,2019-05-19,1289,-138,1151,91,1242,1242,0,0
19385,2019-05-19,547,0,547,43,590,590,0,0
19386,2019-05-19,1815,0,1815,145,1960,1960,0,0
19387,2019-05-19,278,0,278,22,300,300,0,0
19388,2019-05-19,630,0,630,50,680,680,0,0
19389,2019-05-19,315,0,315,25,340,340,0,0
19390,2019-05-19,443,0,443,17,460,460,0,0
19391,2019-05-19,547,0,547,43,590,590,0,0
19392,2019-05-19,519,0,519,41,560,560,0,0
19393,2019-05-19,676,0,676,54,730,730,0,0
19394,2019-05-19,167,0,167,13,180,180,0,0
19395,2019-05-19,399,0,399,31,430,430,0,0
19396,2019-05-19,954,0,954,76,1030,1030,0,0
19397,2019-05-19,195,0,195,15,210,210,0,0
19398,2019-05-19,297,0,297,23,320,320,0,0
19399,2019-05-19,1038,0,1038,82,1120,1120,0,0
19400,2019-05-19,1334,0,1334,106,1440,1440,0,0
19401,2019-05-19,547,0,547,43,590,590,0,0
19402,2019-05-19,786,0,786,54,840,840,0,0
19403,2019-05-19,538,0,538,42,580,580,0,0
19404,2019-05-19,1815,0,1815,145,1960,1960,0,0
19405,2019-05-19,1695,0,1695,135,1830,1830,0,0
19406,2019-05-19,260,0,260,20,280,280,0,0
19407,2019-05-19,306,0,306,24,330,330,0,0
19408,2019-05-19,945,0,945,75,1020,1020,0,0
19409,2019-05-19,1056,0,1056,84,1140,1140,0,0
19410,2019-05-19,426,0,426,34,460,460,0,0
19411,2019-05-19,704,0,704,56,760,760,0,0
19412,2019-05-19,1084,0,1084,86,1170,1170,0,0
19413,2019-05-19,908,0,908,72,980,980,0,0
19414,2019-05-19,908,0,908,72,980,980,0,0
19415,2019-05-19,1732,0,1732,138,1870,1870,0,0
19416,2019-05-19,862,0,862,68,930,930,0,0
19417,2019-05-19,204,0,204,16,220,220,0,0
19418,2019-05-19,1195,0,1195,95,1290,1290,0,0
19419,2019-05-19,908,0,908,72,980,980,0,0
19420,2019-05-19,556,0,556,44,600,600,0,0
19421,2019-05-19,473,0,473,37,510,510,0,0
19422,2019-05-19,297,0,297,23,320,320,0,0
19423,2019-05-19,445,0,445,35,480,480,0,0
19424,2019-05-19,2075,0,2075,165,2240,2240,0,0
19425,2019-05-19,277,0,277,13,290,290,0,0
19426,2019-05-19,220,0,220,0,220,220,0,0
19427,2019-05-19,277,0,277,13,290,290,0,0
19428,2019-05-19,667,0,667,53,720,720,0,0
19429,2019-05-19,288,0,288,22,310,310,0,0
19430,2019-05-19,306,0,306,24,330,330,0,0
19431,2019-05-19,473,0,473,37,510,510,0,0
19432,2019-05-19,334,0,334,26,360,360,0,0
19433,2019-05-19,1899,0,1899,151,2050,2050,0,0
19434,2019-05-19,260,0,260,20,280,280,0,0
19435,2019-05-19,232,0,232,18,250,250,0,0
19436,2019-05-19,565,0,565,45,610,610,0,0
19437,2019-05-19,538,0,538,42,580,580,0,0
19438,2019-05-19,389,0,389,31,420,420,0,0
19439,2019-05-19,797,0,797,63,860,0,860,0
19440,2019-05-19,371,0,371,29,400,400,0,0
19441,2019-05-19,232,0,232,18,250,250,0,0
19442,2019-05-19,1667,0,1667,133,1800,1800,0,0
19443,2019-05-19,760,0,760,60,820,820,0,0
19444,2019-05-19,538,0,538,42,580,580,0,0
19445,2019-05-19,889,0,889,71,960,960,0,0
19446,2019-05-19,167,0,167,13,180,180,0,0
19447,2019-05-19,834,0,834,66,900,900,0,0
19448,2019-05-19,1100,-117,983,70,1053,1053,0,0
19449,2019-05-19,1278,0,1278,102,1380,1380,0,0
19450,2019-05-19,1093,0,1093,87,1180,1180,0,0
19451,2019-05-19,1195,0,1195,95,1290,1290,0,0
19452,2019-05-19,426,0,426,34,460,460,0,0
19453,2019-05-19,703,0,703,47,750,750,0,0
19454,2019-05-19,1602,0,1602,128,1730,1730,0,0
19455,2019-05-19,871,0,871,69,940,940,0,0
19456,2019-05-19,371,0,371,29,400,400,0,0
19457,2019-05-19,149,0,149,11,160,160,0,0
19458,2019-05-19,1343,0,1343,107,1450,1450,0,0
19459,2019-05-19,676,0,676,54,730,730,0,0
19460,2019-05-19,306,0,306,24,330,330,0,0
19461,2019-05-19,602,0,602,48,650,650,0,0
19462,2019-05-19,1462,0,1462,108,1570,1570,0,0
19463,2019-05-19,593,0,593,47,640,640,0,0
19464,2019-05-19,315,0,315,25,340,340,0,0
19465,2019-05-19,501,0,501,39,540,540,0,0
19466,2019-05-19,269,0,269,21,290,290,0,0
19467,2019-05-19,880,0,880,70,950,950,0,0
19468,2019-05-19,343,0,343,27,370,370,0,0
19469,2019-05-19,760,0,760,60,820,820,0,0
19470,2019-05-19,1047,0,1047,83,1130,0,1130,0
19471,2019-05-19,658,0,658,52,710,710,0,0
19472,2019-05-19,1001,0,1001,79,1080,1080,0,0
19473,2019-05-19,167,0,167,13,180,180,0,0
19474,2019-05-19,1575,0,1575,125,1700,1700,0,0
19475,2019-05-19,1695,0,1695,135,1830,1830,0,0
19476,2019-05-19,399,0,399,31,430,0,430,0
19477,2019-05-19,1575,0,1575,125,1700,1700,0,0
19478,2019-05-19,269,0,269,21,290,290,0,0
19479,2019-05-19,399,0,399,31,430,430,0,0
19480,2019-05-19,945,0,945,75,1020,1020,0,0
19481,2019-05-19,797,0,797,63,860,860,0,0
19482,2019-05-19,871,0,871,69,940,940,0,0
19483,2019-05-19,1213,0,1213,97,1310,1310,0,0
19484,2019-05-19,167,0,167,13,180,180,0,0
19485,2019-05-19,510,0,510,40,550,550,0,0
19486,2019-05-19,630,0,630,50,680,680,0,0
19487,2019-05-19,788,0,788,62,850,850,0,0
19488,2019-05-19,121,0,121,9,130,130,0,0
19489,2019-05-19,232,0,232,18,250,250,0,0
19490,2019-05-20,241,0,241,19,260,260,0,0
19491,2019-05-20,454,0,454,36,490,490,0,0
19492,2019-05-20,1815,0,1815,145,1960,1960,0,0
19493,2019-05-20,1954,0,1954,156,2110,2110,0,0
19494,2019-05-20,908,0,908,72,980,980,0,0
19495,2019-05-20,1760,0,1760,140,1900,1900,0,0
19496,2019-05-20,658,0,658,52,710,710,0,0
19497,2019-05-20,926,0,926,74,1000,1000,0,0
19498,2019-05-20,278,0,278,22,300,300,0,0
19499,2019-05-20,593,0,593,47,640,640,0,0
19500,2019-05-20,482,0,482,38,520,520,0,0
19501,2019-05-20,871,0,871,69,940,940,0,0
19502,2019-05-20,2139,0,2139,171,2310,2310,0,0
19503,2019-05-20,1278,0,1278,102,1380,1380,0,0
19504,2019-05-20,843,0,843,67,910,910,0,0
19505,2019-05-20,454,0,454,36,490,490,0,0
19506,2019-05-20,751,0,751,59,810,810,0,0
19507,2019-05-20,547,0,547,43,590,590,0,0
19508,2019-05-20,1732,0,1732,138,1870,1870,0,0
19509,2019-05-20,908,0,908,72,980,980,0,0
19510,2019-05-20,269,0,269,21,290,290,0,0
19511,2019-05-20,362,0,362,28,390,390,0,0
19512,2019-05-20,908,0,908,72,980,980,0,0
19513,2019-05-20,1815,0,1815,145,1960,1960,0,0
19514,2019-05-20,362,0,362,28,390,0,390,0
19515,2019-05-20,167,0,167,13,180,180,0,0
19516,2019-05-20,1056,0,1056,84,1140,1140,0,0
19517,2019-05-20,251,0,251,19,270,270,0,0
19518,2019-05-20,547,0,547,43,590,590,0,0
19519,2019-05-20,639,0,639,51,690,690,0,0
19520,2019-05-20,715,-152,563,45,608,608,0,0
19521,2019-05-20,649,0,649,51,700,700,0,0
19522,2019-05-20,871,0,871,69,940,940,0,0
19523,2019-05-20,1482,0,1482,118,1600,1600,0,0
19524,2019-05-20,454,0,454,36,490,490,0,0
19525,2019-05-20,1279,-137,1142,91,1233,1233,0,0
19526,2019-05-20,167,0,167,13,180,180,0,0
19527,2019-05-20,695,0,695,55,750,750,0,0
19528,2019-05-20,491,0,491,39,530,530,0,0
19529,2019-05-20,1102,0,1102,88,1190,1190,0,0
19530,2019-05-20,908,0,908,72,980,980,0,0
19531,2019-05-20,204,0,204,16,220,220,0,0
19532,2019-05-20,602,0,602,48,650,650,0,0
19533,2019-05-20,575,0,575,45,620,620,0,0
19534,2019-05-20,908,0,908,72,980,980,0,0
19535,2019-05-20,612,0,612,48,660,660,0,0
19536,2019-05-20,570,-61,509,40,549,549,0,0
19537,2019-05-20,667,0,667,53,720,720,0,0
19538,2019-05-20,658,0,658,52,710,710,0,0
19539,2019-05-20,1112,0,1112,88,1200,1200,0,0
19540,2019-05-20,593,0,593,47,640,640,0,0
19541,2019-05-20,945,0,945,75,1020,1020,0,0
19542,2019-05-20,732,0,732,58,790,790,0,0
19543,2019-05-20,269,0,269,21,290,290,0,0
19544,2019-05-20,334,0,334,26,360,360,0,0
19545,2019-05-20,1288,0,1288,102,1390,1390,0,0
19546,2019-05-20,38,0,38,2,40,40,0,0
19547,2019-05-20,889,0,889,71,960,960,0,0
19548,2019-05-20,269,0,269,21,290,290,0,0
19549,2019-05-20,297,0,297,23,320,320,0,0
19550,2019-05-20,167,0,167,13,180,180,0,0
19551,2019-05-20,760,0,760,60,820,820,0,0
19552,2019-05-20,851,0,851,59,910,910,0,0
19553,2019-05-20,213,0,213,17,230,230,0,0
19554,2019-05-20,176,0,176,14,190,190,0,0
19555,2019-05-20,500,0,500,40,540,540,0,0
19556,2019-05-20,463,0,463,37,500,500,0,0
19557,2019-05-20,482,0,482,38,520,520,0,0
19558,2019-05-20,380,0,380,30,410,410,0,0
19559,2019-05-20,149,0,149,11,160,160,0,0
19560,2019-05-20,204,0,204,16,220,220,0,0
19561,2019-05-20,917,0,917,73,990,990,0,0
19562,2019-05-20,297,0,297,23,320,320,0,0
19563,2019-05-20,139,0,139,11,150,150,0,0
19564,2019-05-20,445,0,445,35,480,480,0,0
19565,2019-05-20,612,0,612,48,660,660,0,0
19566,2019-05-20,352,0,352,28,380,380,0,0
19567,2019-05-20,139,0,139,11,150,150,0,0
19568,2019-05-20,1038,0,1038,82,1120,1120,0,0
19569,2019-05-20,399,0,399,31,430,0,0,430
19570,2019-05-20,1251,0,1251,99,1350,1350,0,0
19571,2019-05-20,436,0,436,34,470,470,0,0
19572,2019-05-20,788,0,788,62,850,850,0,0
19573,2019-05-20,232,0,232,18,250,250,0,0
19574,2019-05-20,982,0,982,78,1060,1060,0,0
19575,2019-05-20,639,0,639,51,690,690,0,0
19576,2019-05-20,1232,0,1232,98,1330,1330,0,0
19577,2019-05-20,1380,0,1380,110,1490,0,1490,0
19578,2019-05-20,1575,0,1575,125,1700,1700,0,0
19579,2019-05-20,686,0,686,54,740,740,0,0
19580,2019-05-20,788,0,788,62,850,850,0,0
19581,2019-05-20,788,0,788,62,850,850,0,0
19582,2019-05-20,362,0,362,28,390,390,0,0
19583,2019-05-20,2223,0,2223,177,2400,2400,0,0
19584,2019-05-20,1389,0,1389,111,1500,1500,0,0
19585,2019-05-20,352,0,352,28,380,380,0,0
19586,2019-05-20,260,0,260,20,280,280,0,0
19587,2019-05-20,195,0,195,15,210,210,0,0
19588,2019-05-20,788,0,788,62,850,850,0,0
19589,2019-05-20,-399,0,-399,-31,-430,0,0,-430
19590,2019-05-20,278,0,278,22,300,300,0,0
19591,2019-05-20,482,0,482,38,520,520,0,0
19592,2019-05-20,1223,0,1223,97,1320,1320,0,0
19593,2019-05-20,149,0,149,11,160,160,0,0
19594,2019-05-20,167,0,167,13,180,180,0,0
19595,2019-05-21,982,0,982,78,1060,1060,0,0
19596,2019-05-21,850,-91,759,60,819,819,0,0
19597,2019-05-21,1056,0,1056,84,1140,1140,0,0
19598,2019-05-21,1380,0,1380,110,1490,1490,0,0
19599,2019-05-21,416,0,416,24,440,440,0,0
19600,2019-05-21,362,0,362,28,390,390,0,0
19601,2019-05-21,482,0,482,38,520,520,0,0
19602,2019-05-21,93,0,93,7,100,100,0,0
19603,2019-05-21,417,0,417,33,450,450,0,0
19604,2019-05-21,556,0,556,44,600,600,0,0
19605,2019-05-21,602,0,602,48,650,650,0,0
19606,2019-05-21,815,0,815,65,880,880,0,0
19607,2019-05-21,954,0,954,76,1030,1030,0,0
19608,2019-05-21,806,0,806,64,870,870,0,0
19609,2019-05-21,417,0,417,33,450,450,0,0
19610,2019-05-21,519,0,519,41,560,560,0,0
19611,2019-05-21,751,0,751,59,810,810,0,0
19612,2019-05-21,112,0,112,8,120,120,0,0
19613,2019-05-21,426,0,426,34,460,460,0,0
19614,2019-05-21,553,0,553,17,570,570,0,0
19615,2019-05-21,1277,0,1277,93,1370,1370,0,0
19616,2019-05-21,1028,0,1028,82,1110,1110,0,0
19617,2019-05-21,519,0,519,41,560,560,0,0
19618,2019-05-21,751,0,751,59,810,810,0,0
19619,2019-05-21,519,0,519,41,560,560,0,0
19620,2019-05-21,139,0,139,11,150,150,0,0
19621,2019-05-21,389,0,389,31,420,420,0,0
19622,2019-05-21,908,0,908,72,980,980,0,0
19623,2019-05-21,362,0,362,28,390,390,0,0
19624,2019-05-21,602,0,602,48,650,650,0,0
19625,2019-05-21,815,0,815,65,880,880,0,0
19626,2019-05-21,1092,0,1092,78,1170,1170,0,0
19627,2019-05-21,1231,0,1231,89,1320,0,1320,0
19628,2019-05-21,769,0,769,61,830,830,0,0
19629,2019-05-21,797,0,797,63,860,860,0,0
19630,2019-05-21,362,0,362,28,390,390,0,0
19631,2019-05-21,426,0,426,34,460,460,0,0
19632,2019-05-21,333,0,333,17,350,350,0,0
19633,2019-05-21,1630,0,1630,130,1760,1760,0,0
19634,2019-05-22,463,0,463,37,500,500,0,0
19635,2019-05-22,538,0,538,42,580,580,0,0
19636,2019-05-22,232,0,232,18,250,250,0,0
19637,2019-05-22,362,0,362,28,390,390,0,0
19638,2019-05-22,982,0,982,78,1060,1060,0,0
19639,2019-05-22,362,0,362,28,390,390,0,0
19640,2019-05-22,315,0,315,25,340,340,0,0
19641,2019-05-22,630,0,630,50,680,680,0,0
19642,2019-05-22,695,0,695,55,750,750,0,0
19643,2019-05-22,251,0,251,19,270,270,0,0
19644,2019-05-22,362,0,362,28,390,390,0,0
19645,2019-05-22,1815,0,1815,145,1960,1960,0,0
19646,2019-05-22,732,0,732,58,790,790,0,0
19647,2019-05-22,1815,0,1815,145,1960,1960,0,0
19648,2019-05-22,426,0,426,34,460,460,0,0
19649,2019-05-22,241,0,241,19,260,260,0,0
19650,2019-05-22,102,0,102,8,110,110,0,0
19651,2019-05-22,408,0,408,32,440,440,0,0
19652,2019-05-22,1584,0,1584,126,1710,1710,0,0
19653,2019-05-22,1112,0,1112,88,1200,1200,0,0
19654,2019-05-22,482,0,482,38,520,520,0,0
19655,2019-05-22,1038,0,1038,82,1120,1120,0,0
19656,2019-05-22,278,0,278,22,300,300,0,0
19657,2019-05-22,1463,0,1463,117,1580,1580,0,0
19658,2019-05-22,2176,0,2176,174,2350,2350,0,0
19659,2019-05-22,297,0,297,23,320,320,0,0
19660,2019-05-22,250,0,250,20,270,270,0,0
19661,2019-05-22,908,0,908,72,980,980,0,0
19662,2019-05-22,278,0,278,22,300,300,0,0
19663,2019-05-22,2084,0,2084,166,2250,2250,0,0
19664,2019-05-22,501,0,501,39,540,540,0,0
19665,2019-05-22,482,0,482,38,520,520,0,0
19666,2019-05-22,139,0,139,11,150,150,0,0
19667,2019-05-22,630,0,630,50,680,680,0,0
19668,2019-05-22,343,0,343,27,370,370,0,0
19669,2019-05-22,612,0,612,48,660,660,0,0
19670,2019-05-22,788,0,788,62,850,850,0,0
19671,2019-05-22,1945,0,1945,155,2100,2100,0,0
19672,2019-05-22,630,0,630,50,680,680,0,0
19673,2019-05-22,1815,0,1815,145,1960,1960,0,0
19674,2019-05-22,445,0,445,35,480,480,0,0
19675,2019-05-22,473,0,473,37,510,510,0,0
19676,2019-05-22,297,0,297,23,320,320,0,0
19677,2019-05-22,926,0,926,74,1000,1000,0,0
19678,2019-05-22,899,0,899,71,970,970,0,0
19679,2019-05-22,334,0,334,26,360,360,0,0
19680,2019-05-22,612,0,612,48,660,660,0,0
19681,2019-05-22,760,0,760,60,820,820,0,0
19682,2019-05-22,741,0,741,59,800,800,0,0
19683,2019-05-22,491,0,491,39,530,530,0,0
19684,2019-05-22,788,0,788,62,850,0,850,0
19685,2019-05-22,788,0,788,62,850,850,0,0
19686,2019-05-22,1575,0,1575,125,1700,1700,0,0
19687,2019-05-22,278,0,278,22,300,300,0,0
19688,2019-05-22,1899,0,1899,151,2050,2050,0,0
19689,2019-05-22,2149,0,2149,171,2320,2320,0,0
19690,2019-05-22,1852,0,1852,148,2000,2000,0,0
19691,2019-05-22,843,0,843,67,910,910,0,0
19692,2019-05-22,1139,0,1139,91,1230,1230,0,0
19693,2019-05-22,343,0,343,27,370,370,0,0
19694,2019-05-22,797,0,797,63,860,860,0,0
19695,2019-05-22,1325,0,1325,105,1430,1430,0,0
19696,2019-05-22,1815,0,1815,145,1960,1960,0,0
19697,2019-05-22,815,0,815,65,880,880,0,0
19698,2019-05-22,519,0,519,41,560,560,0,0
19699,2019-05-22,473,0,473,37,510,510,0,0
19700,2019-05-22,538,0,538,42,580,580,0,0
19701,2019-05-22,945,0,945,75,1020,1020,0,0
19702,2019-05-22,926,0,926,74,1000,1000,0,0
19703,2019-05-22,834,0,834,66,900,900,0,0
19704,2019-05-22,1815,0,1815,145,1960,1960,0,0
19705,2019-05-22,565,0,565,45,610,610,0,0
19706,2019-05-22,334,0,334,26,360,360,0,0
19707,2019-05-22,1889,0,1889,151,2040,2040,0,0
19708,2019-05-22,417,0,417,33,450,450,0,0
19709,2019-05-22,510,0,510,40,550,550,0,0
19710,2019-05-22,1075,0,1075,85,1160,1160,0,0
19711,2019-05-22,635,-68,567,45,612,612,0,0
19712,2019-05-23,260,0,260,20,280,280,0,0
19713,2019-05-23,620,0,620,40,660,660,0,0
19714,2019-05-23,547,0,547,43,590,590,0,0
19715,2019-05-23,908,0,908,72,980,980,0,0
19716,2019-05-23,167,0,167,13,180,180,0,0
19717,2019-05-23,649,0,649,51,700,700,0,0
19718,2019-05-23,306,0,306,24,330,330,0,0
19719,2019-05-23,612,0,612,48,660,660,0,0
19720,2019-05-23,288,0,288,22,310,310,0,0
19721,2019-05-23,501,0,501,39,540,540,0,0
19722,2019-05-23,463,0,463,37,500,500,0,0
19723,2019-05-23,834,0,834,66,900,900,0,0
19724,2019-05-23,501,0,501,39,540,540,0,0
19725,2019-05-23,491,0,491,39,530,530,0,0
19726,2019-05-23,1064,-114,950,76,1026,1026,0,0
19727,2019-05-23,389,0,389,31,420,420,0,0
19728,2019-05-23,732,0,732,58,790,790,0,0
19729,2019-05-23,491,0,491,39,530,530,0,0
19730,2019-05-23,593,0,593,47,640,640,0,0
19731,2019-05-23,825,0,825,65,890,890,0,0
19732,2019-05-23,112,0,112,8,120,120,0,0
19733,2019-05-23,769,0,769,61,830,830,0,0
19734,2019-05-23,704,0,704,56,760,760,0,0
19735,2019-05-23,630,0,630,50,680,680,0,0
19736,2019-05-23,232,0,232,18,250,250,0,0
19737,2019-05-23,834,0,834,66,900,900,0,0
19738,2019-05-23,306,0,306,24,330,330,0,0
19739,2019-05-23,814,0,814,56,870,870,0,0
19740,2019-05-23,251,0,251,19,270,270,0,0
19741,2019-05-23,658,0,658,52,710,710,0,0
19742,2019-05-23,621,0,621,49,670,670,0,0
19743,2019-05-23,667,0,667,53,720,720,0,0
19744,2019-05-23,713,0,713,57,770,770,0,0
19745,2019-05-23,704,0,704,56,760,760,0,0
19746,2019-05-23,491,0,491,39,530,530,0,0
19747,2019-05-23,908,0,908,72,980,980,0,0
19748,2019-05-23,658,0,658,52,710,710,0,0
19749,2019-05-23,783,0,783,62,845,845,0,0
19750,2019-05-23,389,0,389,31,420,420,0,0
19751,2019-05-23,862,0,862,68,930,930,0,0
19752,2019-05-23,908,0,908,72,980,980,0,0
19753,2019-05-23,982,0,982,78,1060,1060,0,0
19754,2019-05-23,149,0,149,11,160,160,0,0
19755,2019-05-23,538,0,538,42,580,580,0,0
19756,2019-05-23,1732,0,1732,138,1870,1870,0,0
19757,2019-05-23,501,0,501,39,540,540,0,0
19758,2019-05-23,334,0,334,26,360,360,0,0
19759,2019-05-23,334,0,334,26,360,360,0,0
19760,2019-05-23,139,0,139,11,150,150,0,0
19761,2019-05-23,1482,0,1482,118,1600,1600,0,0
19762,2019-05-23,1815,0,1815,145,1960,0,1960,0
19763,2019-05-23,954,0,954,76,1030,1030,0,0
19764,2019-05-23,1223,0,1223,97,1320,1320,0,0
19765,2019-05-23,445,0,445,35,480,480,0,0
19766,2019-05-23,1251,0,1251,99,1350,1350,0,0
19767,2019-05-23,926,0,926,74,1000,0,1000,0
19768,2019-05-23,1602,0,1602,128,1730,1730,0,0
19769,2019-05-23,1741,0,1741,139,1880,1880,0,0
19770,2019-05-23,352,0,352,28,380,380,0,0
19771,2019-05-23,501,0,501,39,540,540,0,0
19772,2019-05-23,723,0,723,57,780,780,0,0
19773,2019-05-23,389,0,389,31,420,420,0,0
19774,2019-05-23,769,0,769,61,830,830,0,0
19775,2019-05-23,510,0,510,40,550,550,0,0
19776,2019-05-23,608,0,608,22,630,630,0,0
19777,2019-05-23,510,0,510,40,550,550,0,0
19778,2019-05-23,357,0,357,28,385,385,0,0
19779,2019-05-23,1251,0,1251,99,1350,1350,0,0
19780,2019-05-23,2083,0,2083,157,2240,2240,0,0
19781,2019-05-23,260,0,260,20,280,280,0,0
19782,2019-05-23,232,0,232,18,250,250,0,0
19783,2019-05-23,695,0,695,55,750,750,0,0
19784,2019-05-23,630,0,630,50,680,680,0,0
19785,2019-05-23,387,0,387,13,400,400,0,0
19786,2019-05-23,482,0,482,38,520,520,0,0
19787,2019-05-23,649,0,649,51,700,700,0,0
19788,2019-05-23,926,0,926,74,1000,1000,0,0
19789,2019-05-23,260,0,260,20,280,280,0,0
19790,2019-05-23,362,0,362,28,390,390,0,0
19791,2019-05-23,862,0,862,68,930,930,0,0
19792,2019-05-23,135,0,135,10,145,145,0,0
19793,2019-05-23,362,0,362,28,390,390,0,0
19794,2019-05-23,723,0,723,57,780,780,0,0
19795,2019-05-23,528,0,528,42,570,570,0,0
19796,2019-05-23,593,0,593,47,640,640,0,0
19797,2019-05-23,547,0,547,43,590,590,0,0
19798,2019-05-23,778,0,778,62,840,840,0,0
19799,2019-05-23,299,-32,267,21,288,288,0,0
19800,2019-05-23,889,0,889,71,960,960,0,0
19801,2019-05-23,565,0,565,45,610,610,0,0
19802,2019-05-23,547,0,547,43,590,590,0,0
19803,2019-05-23,806,0,806,64,870,870,0,0
19804,2019-05-23,260,0,260,20,280,280,0,0
19805,2019-05-23,501,0,501,39,540,540,0,0
19806,2019-05-23,260,0,260,20,280,280,0,0
19807,2019-05-23,926,0,926,74,1000,1000,0,0
19808,2019-05-23,176,0,176,14,190,190,0,0
19809,2019-05-23,1297,0,1297,103,1400,1400,0,0
19810,2019-05-23,1352,0,1352,108,1460,1460,0,0
19811,2019-05-23,269,0,269,21,290,290,0,0
19812,2019-05-23,713,0,713,57,770,770,0,0
19813,2019-05-23,538,0,538,42,580,580,0,0
19814,2019-05-23,751,0,751,59,810,810,0,0
19815,2019-05-23,454,0,454,36,490,490,0,0
19816,2019-05-23,815,0,815,65,880,880,0,0
19817,2019-05-23,371,0,371,29,400,400,0,0
19818,2019-05-23,908,0,908,72,980,980,0,0
19819,2019-05-23,908,0,908,72,980,980,0,0
19820,2019-05-23,908,0,908,72,980,980,0,0
19821,2019-05-23,139,0,139,11,150,150,0,0
19822,2019-05-23,943,-101,842,67,909,909,0,0
19823,2019-05-23,649,0,649,51,700,700,0,0
19824,2019-05-23,9856,0,9856,744,10600,10600,0,0
19825,2019-05-23,2362,0,2362,188,2550,2550,0,0
19826,2019-05-23,528,0,528,42,570,570,0,0
19827,2019-05-23,1575,0,1575,125,1700,1700,0,0
19828,2019-05-23,778,0,778,62,840,840,0,0
19829,2019-05-23,825,0,825,65,890,890,0,0
19830,2019-05-23,286,0,286,14,300,300,0,0
19831,2019-05-23,1611,0,1611,119,1730,1730,0,0
19832,2019-05-23,991,0,991,79,1070,1070,0,0
19833,2019-05-23,704,0,704,56,760,760,0,0
19834,2019-05-23,788,0,788,62,850,850,0,0
19835,2019-05-23,593,0,593,47,640,640,0,0
19836,2019-05-23,788,0,788,62,850,850,0,0
19837,2019-05-23,251,0,251,19,270,270,0,0
19838,2019-05-23,788,0,788,62,850,850,0,0
19839,2019-05-23,2047,0,2047,163,2210,0,2210,0
19840,2019-05-23,788,0,788,62,850,850,0,0
19841,2019-05-23,1102,0,1102,88,1190,1190,0,0
19842,2019-05-23,751,0,751,59,810,810,0,0
19843,2019-05-23,241,0,241,19,260,260,0,0
19844,2019-05-23,1797,0,1797,143,1940,1940,0,0
19845,2019-05-23,1454,0,1454,116,1570,1570,0,0
19846,2019-05-23,1463,0,1463,117,1580,1580,0,0
19847,2019-05-24,1815,0,1815,145,1960,1960,0,0
19848,2019-05-24,954,0,954,76,1030,1030,0,0
19849,2019-05-24,491,0,491,39,530,530,0,0
19850,2019-05-24,1815,0,1815,145,1960,1960,0,0
19851,2019-05-24,2510,0,2510,200,2710,0,2710,0
19852,2019-05-24,1686,0,1686,134,1820,1820,0,0
19853,2019-05-24,1815,0,1815,145,1960,1960,0,0
19854,2019-05-24,482,0,482,38,520,520,0,0
19855,2019-05-24,482,0,482,38,520,520,0,0
19856,2019-05-24,963,0,963,77,1040,1040,0,0
19857,2019-05-24,908,0,908,72,980,980,0,0
19858,2019-05-24,899,0,899,71,970,970,0,0
19859,2019-05-24,1815,0,1815,145,1960,1960,0,0
19860,2019-05-24,556,0,556,44,600,600,0,0
19861,2019-05-24,1815,0,1815,145,1960,1960,0,0
19862,2019-05-24,667,0,667,53,720,720,0,0
19863,2019-05-24,454,0,454,36,490,490,0,0
19864,2019-05-24,186,0,186,14,200,200,0,0
19865,2019-05-24,1815,0,1815,145,1960,1960,0,0
19866,2019-05-24,871,0,871,69,940,940,0,0
19867,2019-05-24,954,0,954,76,1030,1030,0,0
19868,2019-05-24,1575,0,1575,125,1700,1700,0,0
19869,2019-05-24,389,0,389,31,420,420,0,0
19870,2019-05-24,973,0,973,77,1050,1050,0,0
19871,2019-05-24,1195,0,1195,95,1290,1290,0,0
19872,2019-05-24,665,0,665,35,700,700,0,0
19873,2019-05-24,334,0,334,26,360,360,0,0
19874,2019-05-24,565,0,565,45,610,610,0,0
19875,2019-05-24,1408,0,1408,112,1520,0,1520,0
19876,2019-05-24,1667,0,1667,133,1800,1800,0,0
19877,2019-05-24,232,0,232,18,250,250,0,0
19878,2019-05-24,1195,0,1195,95,1290,1290,0,0
19879,2019-05-24,788,0,788,62,850,850,0,0
19880,2019-05-24,426,0,426,34,460,460,0,0
19881,2019-05-24,778,0,778,62,840,840,0,0
19882,2019-05-24,1815,0,1815,145,1960,1960,0,0
19883,2019-05-24,908,0,908,72,980,980,0,0
19884,2019-05-24,908,0,908,72,980,980,0,0
19885,2019-05-24,1510,0,1510,120,1630,1630,0,0
19886,2019-05-24,2417,0,2417,193,2610,0,2610,0
19887,2019-05-24,480,0,480,20,500,500,0,0
19888,2019-05-24,389,0,389,31,420,420,0,0
19889,2019-05-24,399,0,399,31,430,430,0,0
19890,2019-05-24,1158,0,1158,92,1250,1250,0,0
19891,2019-05-24,630,0,630,50,680,680,0,0
19892,2019-05-24,1815,0,1815,145,1960,1960,0,0
19893,2019-05-24,917,0,917,73,990,990,0,0
19894,2019-05-24,658,0,658,52,710,710,0,0
19895,2019-05-24,436,0,436,34,470,470,0,0
19896,2019-05-24,389,0,389,31,420,420,0,0
19897,2019-05-24,797,0,797,63,860,860,0,0
19898,2019-05-24,575,0,575,45,620,620,0,0
19899,2019-05-24,510,0,510,40,550,550,0,0
19900,2019-05-24,991,0,991,79,1070,1070,0,0
19901,2019-05-24,232,0,232,18,250,250,0,0
19902,2019-05-24,788,0,788,62,850,850,0,0
19903,2019-05-24,834,0,834,66,900,900,0,0
19904,2019-05-24,704,0,704,56,760,760,0,0
19905,2019-05-24,519,0,519,41,560,560,0,0
19906,2019-05-24,1371,0,1371,109,1480,1480,0,0
19907,2019-05-24,2723,0,2723,217,2940,2940,0,0
19908,2019-05-24,306,0,306,24,330,330,0,0
19909,2019-05-24,167,0,167,13,180,180,0,0
19910,2019-05-24,575,0,575,45,620,620,0,0
19911,2019-05-24,176,0,176,14,190,190,0,0
19912,2019-05-24,723,0,723,57,780,780,0,0
19913,2019-05-24,908,0,908,72,980,980,0,0
19914,2019-05-24,1501,0,1501,119,1620,1620,0,0
19915,2019-05-24,704,0,704,56,760,760,0,0
19916,2019-05-24,1501,0,1501,119,1620,0,1620,0
19917,2019-05-24,2010,0,2010,160,2170,2170,0,0
19918,2019-05-24,908,0,908,72,980,980,0,0
19919,2019-05-24,232,0,232,18,250,250,0,0
19920,2019-05-24,593,0,593,47,640,640,0,0
19921,2019-05-24,908,0,908,72,980,980,0,0
19922,2019-05-24,1231,0,1231,89,1320,1320,0,0
19923,2019-05-24,1102,0,1102,88,1190,1190,0,0
19924,2019-05-24,500,0,500,40,540,540,0,0
19925,2019-05-24,732,0,732,58,790,790,0,0
19926,2019-05-24,797,0,797,63,860,860,0,0
19927,2019-05-24,908,0,908,72,980,980,0,0
19928,2019-05-24,1056,0,1056,84,1140,1140,0,0
19929,2019-05-24,1509,0,1509,111,1620,1620,0,0
19930,2019-05-24,1277,0,1277,93,1370,1370,0,0
19931,2019-05-24,1278,0,1278,102,1380,1380,0,0
19932,2019-05-24,538,0,538,42,580,0,580,0
19933,2019-05-24,352,0,352,28,380,380,0,0
19934,2019-05-24,417,0,417,33,450,450,0,0
19935,2019-05-24,723,0,723,57,780,780,0,0
19936,2019-05-24,777,0,777,53,830,830,0,0
19937,2019-05-24,751,0,751,59,810,810,0,0
19938,2019-05-24,741,0,741,59,800,800,0,0
19939,2019-05-24,1019,0,1019,81,1100,1100,0,0
19940,2019-05-24,713,0,713,57,770,770,0,0
19941,2019-05-24,713,0,713,57,770,770,0,0
19942,2019-05-24,130,0,130,10,140,140,0,0
19943,2019-05-24,232,0,232,18,250,250,0,0
19944,2019-05-24,352,0,352,28,380,380,0,0
19945,2019-05-24,902,0,902,63,965,0,965,0
19946,2019-05-24,810,-172,638,50,688,688,0,0
19947,2019-05-24,788,0,788,62,850,850,0,0
19948,2019-05-24,1065,0,1065,85,1150,1150,0,0
19949,2019-05-24,788,0,788,62,850,850,0,0
19950,2019-05-24,788,0,788,62,850,850,0,0
19951,2019-05-24,1065,0,1065,85,1150,1150,0,0
19952,2019-05-24,788,0,788,62,850,0,850,0
19953,2019-05-24,788,0,788,62,850,0,850,0
19954,2019-05-24,1852,0,1852,148,2000,2000,0,0
19955,2019-05-24,936,0,936,74,1010,1010,0,0
19956,2019-05-24,1075,0,1075,85,1160,1160,0,0
19957,2019-05-24,1575,0,1575,125,1700,1700,0,0
19958,2019-05-24,547,0,547,43,590,590,0,0
19959,2019-05-24,760,0,760,60,820,820,0,0
19960,2019-05-24,944,0,944,66,1010,1010,0,0
19961,2019-05-24,426,0,426,34,460,460,0,0
19962,2019-05-24,741,0,741,59,800,800,0,0
19963,2019-05-24,260,0,260,20,280,280,0,0
19964,2019-05-24,1075,0,1075,85,1160,1160,0,0
19965,2019-05-24,482,0,482,38,520,520,0,0
19966,2019-05-24,510,0,510,40,550,550,0,0
19967,2019-05-24,547,0,547,43,590,590,0,0
19968,2019-05-24,232,0,232,18,250,250,0,0
19969,2019-05-24,908,0,908,72,980,980,0,0
19970,2019-05-24,880,0,880,70,950,950,0,0
19971,2019-05-24,880,0,880,70,950,950,0,0
19972,2019-05-24,1186,0,1186,94,1280,1280,0,0
19973,2019-05-24,334,0,334,26,360,360,0,0
19974,2019-05-24,788,0,788,62,850,850,0,0
19975,2019-05-24,889,0,889,71,960,960,0,0
19976,2019-05-24,797,0,797,63,860,860,0,0
19977,2019-05-24,739,0,739,41,780,780,0,0
19978,2019-05-24,102,0,102,8,110,110,0,0
19979,2019-05-24,352,0,352,28,380,380,0,0
19980,2019-05-24,139,0,139,11,150,150,0,0
19981,2019-05-24,815,0,815,65,880,880,0,0
19982,2019-05-24,1778,0,1778,142,1920,1920,0,0
19983,2019-05-24,538,0,538,42,580,580,0,0
19984,2019-05-24,788,0,788,62,850,850,0,0
19985,2019-05-24,1445,0,1445,115,1560,1560,0,0
19986,2019-05-24,889,0,889,71,960,960,0,0
19987,2019-05-24,1065,0,1065,85,1150,1150,0,0
19988,2019-05-24,1575,0,1575,125,1700,1700,0,0
19989,2019-05-24,463,0,463,37,500,0,500,0
19990,2019-05-24,612,0,612,48,660,660,0,0
19991,2019-05-24,1575,0,1575,125,1700,1700,0,0
19992,2019-05-24,463,0,463,37,500,500,0,0
19993,2019-05-24,1001,0,1001,79,1080,1080,0,0
19994,2019-05-24,269,0,269,21,290,290,0,0
19995,2019-05-24,500,0,500,40,540,540,0,0
19996,2019-05-24,112,0,112,8,120,120,0,0
19997,2019-05-24,547,0,547,43,590,590,0,0
19998,2019-05-24,491,0,491,39,530,530,0,0
19999,2019-05-24,704,0,704,56,760,760,0,0
20000,2019-05-24,538,0,538,42,580,580,0,0
20001,2019-05-24,334,0,334,26,360,360,0,0
20002,2019-05-24,436,0,436,34,470,470,0,0
20003,2019-05-24,861,0,861,59,920,920,0,0
20004,2019-05-24,584,0,584,46,630,630,0,0
20005,2019-05-24,584,0,584,46,630,630,0,0
20006,2019-05-24,1584,0,1584,126,1710,1710,0,0
20007,2019-05-24,788,0,788,62,850,850,0,0
20008,2019-05-24,1676,0,1676,134,1810,1810,0,0
20009,2019-05-24,1334,0,1334,106,1440,1440,0,0
20010,2019-05-24,1575,0,1575,125,1700,1700,0,0
20011,2019-05-24,2362,0,2362,188,2550,2550,0,0
20012,2019-05-24,2362,0,2362,188,2550,2550,0,0
20013,2019-05-24,788,0,788,62,850,850,0,0
20014,2019-05-24,769,0,769,61,830,830,0,0
20015,2019-05-24,788,0,788,62,850,850,0,0
20016,2019-05-24,2028,0,2028,162,2190,2190,0,0
20017,2019-05-24,2315,0,2315,185,2500,2500,0,0
20018,2019-05-24,547,0,547,43,590,590,0,0
20019,2019-05-24,269,0,269,21,290,290,0,0
20020,2019-05-24,788,0,788,62,850,850,0,0
20021,2019-05-24,556,0,556,44,600,600,0,0
20022,2019-05-24,1575,0,1575,125,1700,1700,0,0
20023,2019-05-24,1010,0,1010,80,1090,1090,0,0
20024,2019-05-24,362,0,362,28,390,390,0,0
20025,2019-05-24,695,0,695,55,750,750,0,0
20026,2019-05-24,399,0,399,31,430,430,0,0
20027,2019-05-24,936,0,936,74,1010,1010,0,0
20028,2019-05-25,1186,0,1186,94,1280,1280,0,0
20029,2019-05-25,723,0,723,57,780,780,0,0
20030,2019-05-25,379,0,379,21,400,400,0,0
20031,2019-05-25,556,0,556,44,600,600,0,0
20032,2019-05-25,703,0,703,47,750,750,0,0
20033,2019-05-25,1343,0,1343,107,1450,1450,0,0
20034,2019-05-25,297,0,297,23,320,320,0,0
20035,2019-05-25,760,0,760,60,820,820,0,0
20036,2019-05-25,1501,0,1501,119,1620,1620,0,0
20037,2019-05-25,325,0,325,25,350,350,0,0
20038,2019-05-25,1815,0,1815,145,1960,1960,0,0
20039,2019-05-25,612,0,612,48,660,660,0,0
20040,2019-05-25,936,0,936,74,1010,1010,0,0
20041,2019-05-25,1149,0,1149,91,1240,1240,0,0
20042,2019-05-25,1010,0,1010,80,1090,1090,0,0
20043,2019-05-25,556,0,556,44,600,600,0,0
20044,2019-05-25,612,0,612,48,660,660,0,0
20045,2019-05-25,501,0,501,39,540,540,0,0
20046,2019-05-25,723,0,723,57,780,780,0,0
20047,2019-05-25,2491,0,2491,199,2690,2690,0,0
20048,2019-05-25,1765,-189,1576,125,1701,1701,0,0
20049,2019-05-25,251,0,251,19,270,270,0,0
20050,2019-05-25,149,0,149,11,160,160,0,0
20051,2019-05-25,1815,0,1815,145,1960,1960,0,0
20052,2019-05-25,1112,0,1112,88,1200,1200,0,0
20053,2019-05-25,639,0,639,51,690,690,0,0
20054,2019-05-25,649,0,649,51,700,700,0,0
20055,2019-05-25,510,0,510,40,550,550,0,0
20056,2019-05-25,1815,0,1815,145,1960,1960,0,0
20057,2019-05-25,510,0,510,40,550,550,0,0
20058,2019-05-25,2056,0,2056,164,2220,2220,0,0
20059,2019-05-25,260,0,260,20,280,280,0,0
20060,2019-05-25,815,0,815,65,880,880,0,0
20061,2019-05-25,788,0,788,62,850,850,0,0
20062,2019-05-25,334,0,334,26,360,360,0,0
20063,2019-05-25,760,0,760,60,820,820,0,0
20064,2019-05-25,269,0,269,21,290,290,0,0
20065,2019-05-25,834,0,834,66,900,900,0,0
20066,2019-05-25,241,0,241,19,260,260,0,0
20067,2019-05-25,1575,0,1575,125,1700,1700,0,0
20068,2019-05-25,546,0,546,34,580,580,0,0
20069,2019-05-25,399,0,399,31,430,430,0,0
20070,2019-05-25,389,0,389,31,420,420,0,0
20071,2019-05-25,1788,0,1788,142,1930,1930,0,0
20072,2019-05-25,1973,0,1973,157,2130,2130,0,0
20073,2019-05-25,1388,0,1388,102,1490,0,1490,0
20074,2019-05-25,584,0,584,46,630,630,0,0
20075,2019-05-25,1084,0,1084,86,1170,1170,0,0
20076,2019-05-25,482,0,482,38,520,0,520,0
20077,2019-05-25,371,0,371,29,400,400,0,0
20078,2019-05-25,575,0,575,45,620,620,0,0
20079,2019-05-25,1575,0,1575,125,1700,1700,0,0
20080,2019-05-25,528,0,528,42,570,570,0,0
20081,2019-05-25,751,0,751,59,810,810,0,0
20082,2019-05-25,639,0,639,51,690,690,0,0
20083,2019-05-25,639,0,639,51,690,690,0,0
20084,2019-05-25,399,0,399,31,430,430,0,0
20085,2019-05-25,2379,0,2379,181,2560,2560,0,0
20086,2019-05-25,371,0,371,29,400,400,0,0
20087,2019-05-25,389,0,389,31,420,420,0,0
20088,2019-05-25,695,0,695,55,750,750,0,0
20089,2019-05-25,408,0,408,32,440,440,0,0
20090,2019-05-25,907,0,907,63,970,970,0,0
20091,2019-05-25,612,0,612,48,660,660,0,0
20092,2019-05-25,889,0,889,71,960,960,0,0
20093,2019-05-25,1815,0,1815,145,1960,0,1960,0
20094,2019-05-25,2834,0,2834,226,3060,3060,0,0
20095,2019-05-25,306,0,306,24,330,330,0,0
20096,2019-05-25,666,0,666,44,710,710,0,0
20097,2019-05-25,806,0,806,64,870,870,0,0
20098,2019-05-25,445,0,445,35,480,480,0,0
20099,2019-05-25,797,0,797,63,860,860,0,0
20100,2019-05-25,167,0,167,13,180,180,0,0
20101,2019-05-25,315,0,315,25,340,340,0,0
20102,2019-05-25,602,0,602,48,650,650,0,0
20103,2019-05-25,639,0,639,51,690,690,0,0
20104,2019-05-25,565,0,565,45,610,610,0,0
20105,2019-05-25,1852,0,1852,148,2000,2000,0,0
20106,2019-05-25,501,0,501,39,540,540,0,0
20107,2019-05-25,908,0,908,72,980,980,0,0
20108,2019-05-25,-2056,0,-2056,-164,-2220,-2220,0,0
20109,2019-05-25,399,0,399,31,430,430,0,0
20110,2019-05-25,241,0,241,19,260,260,0,0
20111,2019-05-25,510,0,510,40,550,550,0,0
20112,2019-05-25,491,0,491,39,530,530,0,0
20113,2019-05-25,1130,0,1130,90,1220,1220,0,0
20114,2019-05-25,1158,0,1158,92,1250,1250,0,0
20115,2019-05-25,694,0,694,46,740,740,0,0
20116,2019-05-25,1686,0,1686,134,1820,1820,0,0
20117,2019-05-25,1204,0,1204,96,1300,1300,0,0
20118,2019-05-25,954,0,954,76,1030,1030,0,0
20119,2019-05-25,889,0,889,71,960,960,0,0
20120,2019-05-25,1649,0,1649,131,1780,1780,0,0
20121,2019-05-25,3001,0,3001,239,3240,3240,0,0
20122,2019-05-25,612,0,612,48,660,660,0,0
20123,2019-05-25,575,0,575,45,620,620,0,0
20124,2019-05-25,1815,0,1815,145,1960,1960,0,0
20125,2019-05-25,788,0,788,62,850,850,0,0
20126,2019-05-25,565,0,565,45,610,610,0,0
20127,2019-05-25,917,0,917,73,990,990,0,0
20128,2019-05-25,389,0,389,31,420,420,0,0
20129,2019-05-25,277,0,277,13,290,290,0,0
20130,2019-05-25,334,0,334,26,360,360,0,0
20131,2019-05-25,1445,0,1445,115,1560,1560,0,0
20132,2019-05-25,149,0,149,11,160,160,0,0
20133,2019-05-25,908,0,908,72,980,980,0,0
20134,2019-05-25,389,0,389,31,420,420,0,0
20135,2019-05-25,630,0,630,50,680,680,0,0
20136,2019-05-25,389,0,389,31,420,420,0,0
20137,2019-05-25,436,0,436,34,470,470,0,0
20138,2019-05-25,602,0,602,48,650,650,0,0
20139,2019-05-25,288,0,288,22,310,310,0,0
20140,2019-05-25,399,0,399,31,430,430,0,0
20141,2019-05-25,1901,0,1901,151,2052,2052,0,0
20142,2019-05-25,408,0,408,32,440,440,0,0
20143,2019-05-25,1112,0,1112,88,1200,1200,0,0
20144,2019-05-25,1399,0,1399,111,1510,1510,0,0
20145,2019-05-25,426,0,426,34,460,460,0,0
20146,2019-05-25,260,0,260,20,280,280,0,0
20147,2019-05-25,417,0,417,33,450,450,0,0
20148,2019-05-25,491,0,491,39,530,530,0,0
20149,2019-05-25,269,0,269,21,290,290,0,0
20150,2019-05-25,491,0,491,39,530,530,0,0
20151,2019-05-25,510,0,510,40,550,550,0,0
20152,2019-05-25,620,0,620,40,660,660,0,0
20153,2019-05-25,982,0,982,78,1060,1060,0,0
20154,2019-05-25,686,0,686,54,740,740,0,0
20155,2019-05-25,1195,0,1195,95,1290,1290,0,0
20156,2019-05-25,3195,0,3195,255,3450,3450,0,0
20157,2019-05-25,1760,0,1760,140,1900,1900,0,0
20158,2019-05-25,778,0,778,62,840,840,0,0
20159,2019-05-25,417,0,417,33,450,450,0,0
20160,2019-05-25,686,0,686,54,740,740,0,0
20161,2019-05-25,2352,0,2352,188,2540,2540,0,0
20162,2019-05-25,1325,0,1325,105,1430,1430,0,0
20163,2019-05-25,732,0,732,58,790,790,0,0
20164,2019-05-25,1112,0,1112,88,1200,1200,0,0
20165,2019-05-25,1815,0,1815,145,1960,1960,0,0
20166,2019-05-25,908,0,908,72,980,980,0,0
20167,2019-05-25,704,0,704,56,760,760,0,0
20168,2019-05-25,2130,0,2130,170,2300,2300,0,0
20169,2019-05-25,361,0,361,19,380,380,0,0
20170,2019-05-25,1121,0,1121,89,1210,1210,0,0
20171,2019-05-25,389,0,389,31,420,420,0,0
20172,2019-05-25,491,0,491,39,530,530,0,0
20173,2019-05-25,223,0,223,17,240,240,0,0
20174,2019-05-25,186,0,186,14,200,200,0,0
20175,2019-05-25,343,0,343,27,370,370,0,0
20176,2019-05-25,1130,0,1130,90,1220,1220,0,0
20177,2019-05-25,1269,0,1269,101,1370,1370,0,0
20178,2019-05-25,1278,0,1278,102,1380,1380,0,0
20179,2019-05-25,339,-72,267,21,288,288,0,0
20180,2019-05-25,621,0,621,49,670,670,0,0
20181,2019-05-25,288,0,288,22,310,310,0,0
20182,2019-05-25,236,-50,186,14,200,200,0,0
20183,2019-05-25,3669,-780,2889,231,3120,3120,0,0
20184,2019-05-25,889,0,889,71,960,960,0,0
20185,2019-05-25,732,0,732,58,790,790,0,0
20186,2019-05-25,852,0,852,68,920,920,0,0
20187,2019-05-25,121,0,121,9,130,130,0,0
20188,2019-05-25,389,0,389,31,420,420,0,0
20189,2019-05-25,389,0,389,31,420,420,0,0
20190,2019-05-25,389,0,389,31,420,420,0,0
20191,2019-05-25,501,0,501,39,540,540,0,0
20192,2019-05-25,454,0,454,36,490,490,0,0
20193,2019-05-25,269,0,269,21,290,290,0,0
20194,2019-05-25,315,0,315,25,340,340,0,0
20195,2019-05-25,778,0,778,62,840,840,0,0
20196,2019-05-25,1472,0,1472,108,1580,1580,0,0
20197,2019-05-25,732,0,732,58,790,790,0,0
20198,2019-05-25,1538,0,1538,122,1660,1660,0,0
20199,2019-05-25,1528,0,1528,122,1650,1650,0,0
20200,2019-05-25,176,0,176,14,190,190,0,0
20201,2019-05-25,445,0,445,35,480,480,0,0
20202,2019-05-25,269,0,269,21,290,290,0,0
20203,2019-05-25,389,0,389,31,420,420,0,0
20204,2019-05-25,361,0,361,19,380,380,0,0
20205,2019-05-25,389,0,389,31,420,420,0,0
20206,2019-05-25,509,0,509,31,540,540,0,0
20207,2019-05-25,491,0,491,39,530,530,0,0
20208,2019-05-25,315,0,315,25,340,340,0,0
20209,2019-05-25,528,0,528,42,570,570,0,0
20210,2019-05-25,703,0,703,47,750,750,0,0
20211,2019-05-25,1815,0,1815,145,1960,1960,0,0
20212,2019-05-25,620,0,620,40,660,660,0,0
20213,2019-05-25,575,0,575,45,620,620,0,0
20214,2019-05-25,463,0,463,37,500,500,0,0
20215,2019-05-25,176,0,176,14,190,190,0,0
20216,2019-05-25,1213,0,1213,97,1310,1310,0,0
20217,2019-05-25,1538,0,1538,122,1660,1660,0,0
20218,2019-05-25,408,0,408,32,440,440,0,0
20219,2019-05-25,797,0,797,63,860,860,0,0
20220,2019-05-25,723,0,723,57,780,780,0,0
20221,2019-05-25,723,0,723,57,780,780,0,0
20222,2019-05-25,556,0,556,44,600,600,0,0
20223,2019-05-25,556,0,556,44,600,600,0,0
20224,2019-05-25,269,0,269,21,290,290,0,0
20225,2019-05-25,139,0,139,11,150,150,0,0
20226,2019-05-25,186,0,186,14,200,200,0,0
20227,2019-05-25,334,0,334,26,360,360,0,0
20228,2019-05-25,288,0,288,22,310,310,0,0
20229,2019-05-25,778,0,778,62,840,840,0,0
20230,2019-05-25,880,0,880,70,950,950,0,0
20231,2019-05-25,1158,0,1158,92,1250,1250,0,0
20232,2019-05-25,556,0,556,44,600,600,0,0
20233,2019-05-25,880,0,880,70,950,950,0,0
20234,2019-05-25,1241,0,1241,99,1340,1340,0,0
20235,2019-05-25,491,0,491,39,530,530,0,0
20236,2019-05-25,4482,0,4482,358,4840,4840,0,0
20237,2019-05-25,399,0,399,31,430,430,0,0
20238,2019-05-25,1343,0,1343,107,1450,1450,0,0
20239,2019-05-25,399,0,399,31,430,430,0,0
20240,2019-05-25,167,0,167,13,180,180,0,0
20241,2019-05-25,1047,0,1047,83,1130,1130,0,0
20242,2019-05-25,472,0,472,28,500,500,0,0
20243,2019-05-25,251,0,251,19,270,270,0,0
20244,2019-05-25,510,0,510,40,550,550,0,0
20245,2019-05-25,556,0,556,44,600,600,0,0
20246,2019-05-25,1056,0,1056,84,1140,1140,0,0
20247,2019-05-25,1111,0,1111,79,1190,1190,0,0
20248,2019-05-25,843,0,843,67,910,910,0,0
20249,2019-05-25,751,0,751,59,810,810,0,0
20250,2019-05-25,139,0,139,11,150,150,0,0
20251,2019-05-25,1167,0,1167,93,1260,1260,0,0
20252,2019-05-25,788,0,788,62,850,850,0,0
20253,2019-05-25,788,0,788,62,850,850,0,0
20254,2019-05-25,788,0,788,62,850,850,0,0
20255,2019-05-25,1575,0,1575,125,1700,1700,0,0
20256,2019-05-25,1575,0,1575,125,1700,1700,0,0
20257,2019-05-25,621,0,621,49,670,670,0,0
20258,2019-05-25,139,0,139,11,150,150,0,0
20259,2019-05-25,556,0,556,44,600,600,0,0
20260,2019-05-25,1575,0,1575,125,1700,1700,0,0
20261,2019-05-25,1575,0,1575,125,1700,1700,0,0
20262,2019-05-25,473,0,473,37,510,510,0,0
20263,2019-05-25,510,0,510,40,550,550,0,0
20264,2019-05-25,1149,0,1149,91,1240,1240,0,0
20265,2019-05-25,269,0,269,21,290,290,0,0
20266,2019-05-25,871,0,871,69,940,940,0,0
20267,2019-05-25,788,0,788,62,850,850,0,0
20268,2019-05-25,788,0,788,62,850,850,0,0
20269,2019-05-25,1241,0,1241,99,1340,1340,0,0
20270,2019-05-25,788,0,788,62,850,0,850,0
20271,2019-05-25,788,0,788,62,850,850,0,0
20272,2019-05-25,788,0,788,62,850,850,0,0
20273,2019-05-25,667,0,667,53,720,720,0,0
20274,2019-05-25,362,0,362,28,390,390,0,0
20275,2019-05-25,2362,0,2362,188,2550,2550,0,0
20276,2019-05-25,1575,0,1575,125,1700,1700,0,0
20277,2019-05-25,306,0,306,24,330,330,0,0
20278,2019-05-25,112,0,112,8,120,120,0,0
20279,2019-05-25,306,0,306,24,330,330,0,0
20280,2019-05-25,917,0,917,73,990,990,0,0
20281,2019-05-25,945,0,945,75,1020,1020,0,0
20282,2019-05-25,1917,0,1917,153,2070,2070,0,0
20283,2019-05-25,760,0,760,60,820,820,0,0
20284,2019-05-25,288,0,288,22,310,310,0,0
20285,2019-05-25,389,0,389,31,420,420,0,0
20286,2019-05-25,121,0,121,9,130,130,0,0
20287,2019-05-25,695,0,695,55,750,750,0,0
20288,2019-05-25,473,0,473,37,510,510,0,0
20289,2019-05-25,1139,0,1139,91,1230,1230,0,0
20290,2019-05-25,102,0,102,8,110,110,0,0
20291,2019-05-25,269,0,269,21,290,290,0,0
20292,2019-05-25,794,-85,709,56,765,765,0,0
20293,2019-05-25,343,0,343,27,370,370,0,0
20294,2019-05-25,95,-20,75,5,80,80,0,0
20295,2019-05-25,1575,0,1575,125,1700,1700,0,0
20296,2019-05-25,463,0,463,37,500,500,0,0
20297,2019-05-25,454,0,454,36,490,490,0,0
20298,2019-05-25,704,0,704,56,760,760,0,0
20299,2019-05-25,1176,0,1176,94,1270,1270,0,0
20300,2019-05-25,788,0,788,62,850,850,0,0
20301,2019-05-25,788,0,788,62,850,850,0,0
20302,2019-05-25,788,0,788,62,850,850,0,0
20303,2019-05-25,788,0,788,62,850,850,0,0
20304,2019-05-25,2351,0,2351,179,2530,2530,0,0
20305,2019-05-25,788,0,788,62,850,850,0,0
20306,2019-05-25,2130,0,2130,170,2300,2300,0,0
20307,2019-05-25,788,0,788,62,850,850,0,0
20308,2019-05-25,278,0,278,22,300,300,0,0
20309,2019-05-25,834,0,834,66,900,900,0,0
20310,2019-05-26,565,0,565,45,610,610,0,0
20311,2019-05-26,306,0,306,24,330,330,0,0
20312,2019-05-26,130,0,130,10,140,140,0,0
20313,2019-05-26,602,0,602,48,650,650,0,0
20314,2019-05-26,510,0,510,40,550,550,0,0
20315,2019-05-26,251,0,251,19,270,270,0,0
20316,2019-05-26,788,0,788,62,850,850,0,0
20317,2019-05-26,167,0,167,13,180,180,0,0
20318,2019-05-26,862,0,862,68,930,930,0,0
20319,2019-05-26,917,0,917,73,990,990,0,0
20320,2019-05-26,167,0,167,13,180,180,0,0
20321,2019-05-26,1575,0,1575,125,1700,1700,0,0
20322,2019-05-26,269,0,269,21,290,290,0,0
20323,2019-05-26,1093,0,1093,87,1180,1180,0,0
20324,2019-05-26,917,0,917,73,990,990,0,0
20325,2019-05-26,788,0,788,62,850,0,850,0
20326,2019-05-26,490,0,490,30,520,520,0,0
20327,2019-05-26,788,0,788,62,850,850,0,0
20328,2019-05-26,899,0,899,71,970,970,0,0
20329,2019-05-26,602,0,602,48,650,650,0,0
20330,2019-05-26,602,0,602,48,650,650,0,0
20331,2019-05-26,232,0,232,18,250,250,0,0
20332,2019-05-26,788,0,788,62,850,850,0,0
20333,2019-05-26,510,0,510,40,550,550,0,0
20334,2019-05-26,260,0,260,20,280,280,0,0
20335,2019-05-26,1297,0,1297,103,1400,1400,0,0
20336,2019-05-26,565,0,565,45,610,610,0,0
20337,2019-05-26,649,0,649,51,700,700,0,0
20338,2019-05-26,389,0,389,31,420,420,0,0
20339,2019-05-26,112,0,112,8,120,120,0,0
20340,2019-05-26,278,0,278,22,300,300,0,0
20341,2019-05-26,500,0,500,40,540,540,0,0
20342,2019-05-26,676,0,676,54,730,730,0,0
20343,2019-05-26,741,0,741,59,800,800,0,0
20344,2019-05-26,797,0,797,63,860,860,0,0
20345,2019-05-26,1575,0,1575,125,1700,0,1700,0
20346,2019-05-26,1870,0,1870,140,2010,2010,0,0
20347,2019-05-26,982,0,982,78,1060,1060,0,0
20348,2019-05-26,908,0,908,72,980,980,0,0
20349,2019-05-26,676,0,676,54,730,730,0,0
20350,2019-05-26,389,0,389,31,420,0,420,0
20351,2019-05-26,963,0,963,77,1040,1040,0,0
20352,2019-05-26,851,0,851,59,910,910,0,0
20353,2019-05-26,769,0,769,61,830,830,0,0
20354,2019-05-26,889,0,889,71,960,0,960,0
20355,2019-05-26,112,0,112,8,120,120,0,0
20356,2019-05-26,945,0,945,75,1020,1020,0,0
20357,2019-05-26,454,0,454,36,490,490,0,0
20358,2019-05-26,612,0,612,48,660,660,0,0
20359,2019-05-26,1186,0,1186,94,1280,1280,0,0
20360,2019-05-26,482,0,482,38,520,520,0,0
20361,2019-05-26,538,0,538,42,580,580,0,0
20362,2019-05-26,223,0,223,17,240,240,0,0
20363,2019-05-26,371,0,371,29,400,400,0,0
20364,2019-05-26,556,0,556,44,600,600,0,0
20365,2019-05-26,612,0,612,48,660,660,0,0
20366,2019-05-26,408,0,408,32,440,440,0,0
20367,2019-05-26,945,0,945,75,1020,1020,0,0
20368,2019-05-26,778,0,778,62,840,840,0,0
20369,2019-05-26,908,0,908,72,980,980,0,0
20370,2019-05-26,769,0,769,61,830,830,0,0
20371,2019-05-26,843,0,843,67,910,910,0,0
20372,2019-05-26,1223,0,1223,97,1320,1320,0,0
20373,2019-05-26,1260,0,1260,100,1360,1360,0,0
20374,2019-05-26,700,-75,625,50,675,675,0,0
20375,2019-05-26,445,0,445,35,480,480,0,0
20376,2019-05-26,491,0,491,39,530,530,0,0
20377,2019-05-26,445,0,445,35,480,480,0,0
20378,2019-05-26,611,0,611,39,650,650,0,0
20379,2019-05-26,314,0,314,16,330,330,0,0
20380,2019-05-26,1815,0,1815,145,1960,1960,0,0
20381,2019-05-26,954,0,954,76,1030,1030,0,0
20382,2019-05-26,926,0,926,74,1000,1000,0,0
20383,2019-05-26,1815,0,1815,145,1960,1960,0,0
20384,2019-05-26,334,0,334,26,360,360,0,0
20385,2019-05-26,315,0,315,25,340,340,0,0
20386,2019-05-26,139,0,139,11,150,150,0,0
20387,2019-05-26,1815,0,1815,145,1960,0,1960,0
20388,2019-05-26,862,0,862,68,930,930,0,0
20389,2019-05-26,538,0,538,42,580,580,0,0
20390,2019-05-26,704,0,704,56,760,760,0,0
20391,2019-05-26,593,0,593,47,640,640,0,0
20392,2019-05-26,713,0,713,57,770,770,0,0
20393,2019-05-26,102,0,102,8,110,110,0,0
20394,2019-05-26,399,0,399,31,430,430,0,0
20395,2019-05-26,1954,0,1954,156,2110,2110,0,0
20396,2019-05-26,778,0,778,62,840,840,0,0
20397,2019-05-26,834,0,834,66,900,900,0,0
20398,2019-05-26,723,0,723,57,780,780,0,0
20399,2019-05-26,389,0,389,31,420,420,0,0
20400,2019-05-26,186,0,186,14,200,200,0,0
20401,2019-05-26,954,0,954,76,1030,1030,0,0
20402,2019-05-26,954,0,954,76,1030,1030,0,0
20403,2019-05-26,565,0,565,45,610,610,0,0
20404,2019-05-26,514,-55,459,36,495,495,0,0
20405,2019-05-26,806,0,806,64,870,870,0,0
20406,2019-05-26,1102,0,1102,88,1190,1190,0,0
20407,2019-05-26,556,0,556,44,600,600,0,0
20408,2019-05-26,47,0,47,3,50,50,0,0
20409,2019-05-26,157,0,157,3,160,160,0,0
20410,2019-05-26,139,0,139,11,150,150,0,0
20411,2019-05-26,436,0,436,34,470,470,0,0
20412,2019-05-26,908,0,908,72,980,980,0,0
20413,2019-05-26,908,0,908,72,980,980,0,0
20414,2019-05-26,778,0,778,62,840,840,0,0
20415,2019-05-26,936,0,936,74,1010,1010,0,0
20416,2019-05-26,565,0,565,45,610,610,0,0
20417,2019-05-26,1815,0,1815,145,1960,1960,0,0
20418,2019-05-26,1149,0,1149,91,1240,1240,0,0
20419,2019-05-26,639,0,639,51,690,690,0,0
20420,2019-05-26,908,0,908,72,980,980,0,0
20421,2019-05-26,797,0,797,63,860,860,0,0
20422,2019-05-26,389,0,389,31,420,420,0,0
20423,2019-05-26,565,0,565,45,610,610,0,0
20424,2019-05-26,343,0,343,27,370,370,0,0
20425,2019-05-26,788,0,788,62,850,850,0,0
20426,2019-05-26,176,0,176,14,190,190,0,0
20427,2019-05-26,778,0,778,62,840,840,0,0
20428,2019-05-26,2075,0,2075,165,2240,2240,0,0
20429,2019-05-26,1380,0,1380,110,1490,1490,0,0
20430,2019-05-26,1575,0,1575,125,1700,1700,0,0
20431,2019-05-26,1084,0,1084,86,1170,1170,0,0
20432,2019-05-26,788,0,788,62,850,850,0,0
20433,2019-05-26,1676,0,1676,134,1810,1810,0,0
20434,2019-05-26,1852,0,1852,148,2000,2000,0,0
20435,2019-05-26,788,0,788,62,850,850,0,0
20436,2019-05-26,491,0,491,39,530,530,0,0
20437,2019-05-26,788,0,788,62,850,850,0,0
20438,2019-05-26,926,0,926,74,1000,1000,0,0
20439,2019-05-26,1425,0,1425,105,1530,1530,0,0
20440,2019-05-26,278,0,278,22,300,300,0,0
20441,2019-05-26,788,0,788,62,850,850,0,0
20442,2019-05-26,788,0,788,62,850,850,0,0
20443,2019-05-26,501,0,501,39,540,540,0,0
20444,2019-05-26,1575,0,1575,125,1700,1700,0,0
20445,2019-05-26,741,0,741,59,800,800,0,0
20446,2019-05-26,104,0,104,8,112,112,0,0
20447,2019-05-26,741,0,741,59,800,800,0,0
20448,2019-05-26,1139,0,1139,91,1230,1230,0,0
20449,2019-05-26,463,0,463,37,500,500,0,0
20450,2019-05-26,-297,0,-297,-23,-320,-320,0,0
20451,2019-05-26,269,0,269,21,290,290,0,0
20452,2019-05-26,602,0,602,48,650,650,0,0
20453,2019-05-26,945,0,945,75,1020,1020,0,0
20454,2019-05-26,269,0,269,21,290,290,0,0
20455,2019-05-26,352,0,352,28,380,380,0,0
20456,2019-05-26,436,0,436,34,470,470,0,0
20457,2019-05-26,232,0,232,18,250,250,0,0
20458,2019-05-26,973,0,973,77,1050,1050,0,0
20459,2019-05-26,760,0,760,60,820,820,0,0
20460,2019-05-26,-463,0,-463,-37,-500,-500,0,0
20461,2019-05-26,297,0,297,23,320,320,0,0
20462,2019-05-26,602,0,602,48,650,650,0,0
20463,2019-05-26,389,0,389,31,420,420,0,0
20464,2019-05-26,1389,0,1389,111,1500,1500,0,0
20465,2019-05-26,443,0,443,35,478,478,0,0
20466,2019-05-27,889,0,889,71,960,960,0,0
20467,2019-05-27,777,0,777,53,830,830,0,0
20468,2019-05-27,1251,0,1251,99,1350,1350,0,0
20469,2019-05-27,547,0,547,43,590,590,0,0
20470,2019-05-27,908,0,908,72,980,980,0,0
20471,2019-05-27,908,0,908,72,980,980,0,0
20472,2019-05-27,297,0,297,23,320,0,320,0
20473,2019-05-27,713,0,713,57,770,770,0,0
20474,2019-05-27,695,0,695,55,750,750,0,0
20475,2019-05-27,426,0,426,34,460,460,0,0
20476,2019-05-27,1242,-133,1109,88,1197,1197,0,0
20477,2019-05-27,4268,0,4268,332,4600,4600,0,0
20478,2019-05-27,1815,0,1815,145,1960,1960,0,0
20479,2019-05-27,1102,0,1102,88,1190,1190,0,0
20480,2019-05-27,1815,0,1815,145,1960,1960,0,0
20481,2019-05-27,519,0,519,41,560,560,0,0
20482,2019-05-27,362,0,362,28,390,390,0,0
20483,2019-05-27,1815,0,1815,145,1960,0,1960,0
20484,2019-05-27,436,0,436,34,470,470,0,0
20485,2019-05-27,3917,0,3917,313,4230,4230,0,0
20486,2019-05-27,834,0,834,66,900,900,0,0
20487,2019-05-27,908,0,908,72,980,980,0,0
20488,2019-05-27,1809,-193,1616,121,1737,1737,0,0
20489,2019-05-27,1047,0,1047,83,1130,1130,0,0
20490,2019-05-27,657,0,657,43,700,700,0,0
20491,2019-05-27,1158,0,1158,92,1250,1250,0,0
20492,2019-05-27,297,0,297,23,320,320,0,0
20493,2019-05-27,723,0,723,57,780,780,0,0
20494,2019-05-27,528,0,528,42,570,570,0,0
20495,2019-05-27,417,0,417,33,450,450,0,0
20496,2019-05-27,306,0,306,24,330,330,0,0
20497,2019-05-27,2713,0,2713,217,2930,2930,0,0
20498,2019-05-27,426,0,426,34,460,460,0,0
20499,2019-05-27,491,0,491,39,530,530,0,0
20500,2019-05-27,371,0,371,29,400,400,0,0
20501,2019-05-27,1565,0,1565,125,1690,1690,0,0
20502,2019-05-27,1815,0,1815,145,1960,1960,0,0
20503,2019-05-27,491,0,491,39,530,530,0,0
20504,2019-05-27,1843,0,1843,147,1990,1990,0,0
20505,2019-05-27,371,0,371,29,400,400,0,0
20506,2019-05-27,1075,0,1075,85,1160,1160,0,0
20507,2019-05-27,908,0,908,72,980,980,0,0
20508,2019-05-27,1130,0,1130,90,1220,0,1220,0
20509,2019-05-27,1528,0,1528,122,1650,1650,0,0
20510,2019-05-27,954,0,954,76,1030,1030,0,0
20511,2019-05-27,1815,0,1815,145,1960,1960,0,0
20512,2019-05-27,297,0,297,23,320,320,0,0
20513,2019-05-27,260,0,260,20,280,280,0,0
20514,2019-05-27,658,0,658,52,710,710,0,0
20515,2019-05-27,565,0,565,45,610,610,0,0
20516,2019-05-27,788,0,788,62,850,850,0,0
20517,2019-05-27,1269,0,1269,101,1370,1370,0,0
20518,2019-05-27,556,0,556,44,600,600,0,0
20519,2019-05-27,167,0,167,13,180,180,0,0
20520,2019-05-27,908,0,908,72,980,980,0,0
20521,2019-05-27,555,0,555,35,590,590,0,0
20522,2019-05-27,1232,0,1232,98,1330,1330,0,0
20523,2019-05-27,593,0,593,47,640,640,0,0
20524,2019-05-27,264,-56,208,16,224,224,0,0
20525,2019-05-27,1315,0,1315,105,1420,1420,0,0
20526,2019-05-27,371,0,371,29,400,400,0,0
20527,2019-05-27,463,0,463,37,500,500,0,0
20528,2019-05-27,973,0,973,77,1050,1050,0,0
20529,2019-05-27,519,0,519,41,560,560,0,0
20530,2019-05-27,204,0,204,16,220,220,0,0
20531,2019-05-27,186,0,186,14,200,200,0,0
20532,2019-05-27,778,0,778,62,840,840,0,0
20533,2019-05-27,797,0,797,63,860,860,0,0
20534,2019-05-27,834,0,834,66,900,900,0,0
20535,2019-05-27,240,0,240,10,250,250,0,0
20536,2019-05-27,260,0,260,20,280,280,0,0
20537,2019-05-27,491,0,491,39,530,530,0,0
20538,2019-05-27,352,0,352,28,380,0,380,0
20539,2019-05-27,778,0,778,62,840,840,0,0
20540,2019-05-27,1260,0,1260,100,1360,1360,0,0
20541,2019-05-27,269,0,269,21,290,290,0,0
20542,2019-05-27,417,0,417,33,450,450,0,0
20543,2019-05-27,556,0,556,44,600,600,0,0
20544,2019-05-27,-510,0,-510,-40,-550,-550,0,0
20545,2019-05-27,514,-55,459,36,495,495,0,0
20546,2019-05-27,510,0,510,40,550,550,0,0
20547,2019-05-27,732,0,732,58,790,790,0,0
20548,2019-05-27,704,0,704,56,760,760,0,0
20549,2019-05-27,297,0,297,23,320,320,0,0
20550,2019-05-27,1269,0,1269,101,1370,1370,0,0
20551,2019-05-27,399,0,399,31,430,430,0,0
20552,2019-05-27,778,0,778,62,840,840,0,0
20553,2019-05-27,1102,0,1102,88,1190,0,1190,0
20554,2019-05-27,887,-95,792,63,855,855,0,0
20555,2019-05-27,1575,0,1575,125,1700,1700,0,0
20556,2019-05-27,1084,0,1084,86,1170,1170,0,0
20557,2019-05-27,352,0,352,28,380,380,0,0
20558,2019-05-27,1138,0,1138,82,1220,1220,0,0
20559,2019-05-27,167,0,167,13,180,180,0,0
20560,2019-05-27,371,0,371,29,400,400,0,0
20561,2019-05-27,1204,0,1204,96,1300,1300,0,0
20562,2019-05-27,1575,0,1575,125,1700,1700,0,0
20563,2019-05-27,269,0,269,21,290,0,290,0
20564,2019-05-27,1075,0,1075,85,1160,0,1160,0
20565,2019-05-27,1575,0,1575,125,1700,1700,0,0
20566,2019-05-27,1473,0,1473,117,1590,1590,0,0
20567,2019-05-27,260,0,260,20,280,280,0,0
20568,2019-05-27,371,0,371,29,400,400,0,0
20569,2019-05-27,963,0,963,77,1040,1040,0,0
20570,2019-05-27,982,0,982,78,1060,1060,0,0
20571,2019-05-27,917,0,917,73,990,990,0,0
20572,2019-05-27,1075,0,1075,85,1160,1160,0,0
20573,2019-05-27,343,0,343,27,370,370,0,0
20574,2019-05-27,343,0,343,27,370,370,0,0
20575,2019-05-27,713,0,713,57,770,770,0,0
20576,2019-05-27,223,0,223,17,240,240,0,0
20577,2019-05-27,639,0,639,51,690,690,0,0
20578,2019-05-27,4584,0,4584,366,4950,0,4950,0
20579,2019-05-27,139,0,139,11,150,150,0,0
20580,2019-05-28,195,0,195,15,210,210,0,0
20581,2019-05-28,334,0,334,26,360,360,0,0
20582,2019-05-28,499,0,499,31,530,530,0,0
20583,2019-05-28,741,0,741,59,800,800,0,0
20584,2019-05-28,24,0,24,1,25,25,0,0
20585,2019-05-28,269,0,269,21,290,290,0,0
20586,2019-05-28,374,-40,334,26,360,360,0,0
20587,2019-05-28,139,0,139,11,150,150,0,0
20588,2019-05-28,621,0,621,49,670,670,0,0
20589,2019-05-28,203,0,203,16,219,219,0,0
20590,2019-05-28,325,0,325,25,350,350,0,0
20591,2019-05-28,1158,0,1158,92,1250,1250,0,0
20592,2019-05-28,538,0,538,42,580,580,0,0
20593,2019-05-28,195,0,195,15,210,210,0,0
20594,2019-05-28,491,0,491,39,530,530,0,0
20595,2019-05-28,473,0,473,37,510,510,0,0
20596,2019-05-28,1289,-138,1151,91,1242,1242,0,0
20597,2019-05-28,519,0,519,41,560,560,0,0
20598,2019-05-28,926,0,926,74,1000,1000,0,0
20599,2019-05-28,426,0,426,34,460,460,0,0
20600,2019-05-28,741,0,741,59,800,800,0,0
20601,2019-05-28,778,0,778,62,840,840,0,0
20602,2019-05-28,2436,0,2436,194,2630,2630,0,0
20603,2019-05-28,686,0,686,54,740,740,0,0
20604,2019-05-28,260,0,260,20,280,280,0,0
20605,2019-05-28,445,0,445,35,480,480,0,0
20606,2019-05-28,269,0,269,21,290,290,0,0
20607,2019-05-28,445,0,445,35,480,480,0,0
20608,2019-05-28,510,0,510,40,550,550,0,0
20609,2019-05-28,806,0,806,64,870,870,0,0
20610,2019-05-28,232,0,232,18,250,250,0,0
20611,2019-05-28,593,0,593,47,640,640,0,0
20612,2019-05-28,362,0,362,28,390,390,0,0
20613,2019-05-28,445,0,445,35,480,480,0,0
20614,2019-05-28,1621,0,1621,129,1750,1750,0,0
20615,2019-05-28,325,0,325,25,350,350,0,0
20616,2019-05-28,1352,0,1352,108,1460,1460,0,0
20617,2019-05-28,223,0,223,17,240,240,0,0
20618,2019-05-29,334,0,334,26,360,360,0,0
20619,2019-05-29,334,0,334,26,360,360,0,0
20620,2019-05-29,602,0,602,48,650,650,0,0
20621,2019-05-29,1463,0,1463,117,1580,1580,0,0
20622,2019-05-29,686,0,686,54,740,740,0,0
20623,2019-05-29,269,0,269,21,290,0,290,0
20624,2019-05-29,158,0,158,12,170,170,0,0
20625,2019-05-29,584,0,584,46,630,630,0,0
20626,2019-05-29,167,0,167,13,180,180,0,0
20627,2019-05-29,241,0,241,19,260,260,0,0
20628,2019-05-29,1815,0,1815,145,1960,0,1960,0
20629,2019-05-29,389,0,389,31,420,0,420,0
20630,2019-05-29,1806,0,1806,144,1950,1950,0,0
20631,2019-05-29,1584,0,1584,126,1710,1710,0,0
20632,2019-05-29,445,0,445,35,480,480,0,0
20633,2019-05-29,556,0,556,44,600,600,0,0
20634,2019-05-29,249,0,249,11,260,260,0,0
20635,2019-05-29,334,0,334,26,360,360,0,0
20636,2019-05-29,463,0,463,37,500,500,0,0
20637,2019-05-29,584,0,584,46,630,630,0,0
20638,2019-05-29,695,0,695,55,750,750,0,0
20639,2019-05-29,473,0,473,37,510,510,0,0
20640,2019-05-29,454,0,454,36,490,490,0,0
20641,2019-05-29,241,0,241,19,260,260,0,0
20642,2019-05-29,417,0,417,33,450,450,0,0
20643,2019-05-29,362,0,362,28,390,390,0,0
20644,2019-05-29,453,0,453,27,480,480,0,0
20645,2019-05-29,389,0,389,31,420,420,0,0
20646,2019-05-29,454,0,454,36,490,490,0,0
20647,2019-05-29,1815,0,1815,145,1960,1960,0,0
20648,2019-05-29,908,0,908,72,980,980,0,0
20649,2019-05-29,908,0,908,72,980,980,0,0
20650,2019-05-29,880,0,880,70,950,950,0,0
20651,2019-05-29,2093,0,2093,167,2260,2260,0,0
20652,2019-05-29,389,0,389,31,420,420,0,0
20653,2019-05-29,315,0,315,25,340,340,0,0
20654,2019-05-29,121,0,121,9,130,130,0,0
20655,2019-05-29,547,0,547,43,590,590,0,0
20656,2019-05-29,500,0,500,40,540,540,0,0
20657,2019-05-29,1112,0,1112,88,1200,1200,0,0
20658,2019-05-29,565,0,565,45,610,610,0,0
20659,2019-05-29,343,0,343,27,370,370,0,0
20660,2019-05-29,269,0,269,21,290,290,0,0
20661,2019-05-29,139,0,139,11,150,150,0,0
20662,2019-05-29,204,0,204,16,220,220,0,0
20663,2019-05-29,204,0,204,16,220,220,0,0
20664,2019-05-29,908,0,908,72,980,980,0,0
20665,2019-05-29,908,0,908,72,980,980,0,0
20666,2019-05-29,908,0,908,72,980,980,0,0
20667,2019-05-29,1158,0,1158,92,1250,1250,0,0
20668,2019-05-29,1815,0,1815,145,1960,1960,0,0
20669,2019-05-29,852,0,852,68,920,920,0,0
20670,2019-05-29,1815,0,1815,145,1960,1960,0,0
20671,2019-05-29,362,0,362,28,390,390,0,0
20672,2019-05-29,1815,0,1815,145,1960,1960,0,0
20673,2019-05-29,630,0,630,50,680,680,0,0
20674,2019-05-29,908,0,908,72,980,980,0,0
20675,2019-05-29,416,0,416,24,440,440,0,0
20676,2019-05-29,908,0,908,72,980,980,0,0
20677,2019-05-29,306,0,306,24,330,330,0,0
20678,2019-05-29,639,0,639,51,690,690,0,0
20679,2019-05-29,778,0,778,62,840,840,0,0
20680,2019-05-29,704,0,704,56,760,0,760,0
20681,2019-05-29,575,0,575,45,620,620,0,0
20682,2019-05-29,501,0,501,39,540,540,0,0
20683,2019-05-29,889,0,889,71,960,960,0,0
20684,2019-05-29,436,0,436,34,470,470,0,0
20685,2019-05-29,1112,0,1112,88,1200,1200,0,0
20686,2019-05-29,277,0,277,13,290,290,0,0
20687,2019-05-29,1575,0,1575,125,1700,1700,0,0
20688,2019-05-29,723,0,723,57,780,780,0,0
20689,2019-05-29,788,0,788,62,850,850,0,0
20690,2019-05-29,278,0,278,22,300,300,0,0
20691,2019-05-29,306,0,306,24,330,330,0,0
20692,2019-05-29,788,0,788,62,850,850,0,0
20693,2019-05-29,834,0,834,66,900,900,0,0
20694,2019-05-29,149,0,149,11,160,160,0,0
20695,2019-05-29,917,0,917,73,990,990,0,0
20696,2019-05-29,445,0,445,35,480,480,0,0
20697,2019-05-29,612,0,612,48,660,660,0,0
20698,2019-05-29,315,0,315,25,340,340,0,0
20699,2019-05-29,1213,0,1213,97,1310,1310,0,0
20700,2019-05-29,139,0,139,11,150,150,0,0
20701,2019-05-29,564,0,564,36,600,600,0,0
20702,2019-05-29,408,0,408,32,440,440,0,0
20703,2019-05-29,788,0,788,62,850,850,0,0
20704,2019-05-29,788,0,788,62,850,850,0,0
20705,2019-05-29,556,0,556,44,600,600,0,0
20706,2019-05-29,1575,0,1575,125,1700,1700,0,0
20707,2019-05-29,463,0,463,37,500,500,0,0
20708,2019-05-29,713,0,713,57,770,770,0,0
20709,2019-05-29,1473,0,1473,117,1590,1590,0,0
20710,2019-05-29,1575,0,1575,125,1700,1700,0,0
20711,2019-05-29,1584,0,1584,126,1710,1710,0,0
20712,2019-05-29,788,0,788,62,850,850,0,0
20713,2019-05-29,788,0,788,62,850,850,0,0
20714,2019-05-29,417,0,417,33,450,450,0,0
20715,2019-05-29,1575,0,1575,125,1700,1700,0,0
20716,2019-05-29,1158,-124,1034,82,1116,1116,0,0
20717,2019-05-29,306,0,306,24,330,330,0,0
20718,2019-05-29,463,0,463,37,500,500,0,0
20719,2019-05-29,1806,0,1806,144,1950,1950,0,0
20720,2019-05-29,473,0,473,37,510,510,0,0
20721,2019-05-29,362,0,362,28,390,390,0,0
20722,2019-05-29,334,0,334,26,360,360,0,0
20723,2019-05-29,240,0,240,10,250,250,0,0
20724,2019-05-29,501,0,501,39,540,0,540,0
20725,2019-05-29,1815,0,1815,145,1960,1960,0,0
20726,2019-05-29,278,0,278,22,300,300,0,0
20727,2019-05-29,732,0,732,58,790,790,0,0
20728,2019-05-29,834,0,834,66,900,900,0,0
20729,2019-05-29,297,0,297,23,320,320,0,0
20730,2019-05-29,362,0,362,28,390,390,0,0
20731,2019-05-29,362,0,362,28,390,390,0,0
20732,2019-05-29,963,0,963,77,1040,1040,0,0
20733,2019-05-29,325,0,325,25,350,350,0,0
20734,2019-05-29,1139,0,1139,91,1230,1230,0,0
20735,2019-05-29,278,0,278,22,300,300,0,0
20736,2019-05-29,250,0,250,20,270,270,0,0
20737,2019-05-29,908,0,908,72,980,980,0,0
20738,2019-05-29,676,0,676,54,730,730,0,0
20739,2019-05-29,672,-72,600,48,648,648,0,0
20740,2019-05-29,1149,0,1149,91,1240,1240,0,0
20741,2019-05-29,297,0,297,23,320,0,320,0
20742,2019-05-29,232,0,232,18,250,250,0,0
20743,2019-05-29,556,0,556,44,600,600,0,0
20744,2019-05-29,936,0,936,74,1010,1010,0,0
20745,2019-05-29,788,0,788,62,850,850,0,0
20746,2019-05-29,547,0,547,43,590,590,0,0
20747,2019-05-29,621,0,621,49,670,670,0,0
20748,2019-05-29,445,0,445,35,480,480,0,0
20749,2019-05-29,602,0,602,48,650,650,0,0
20750,2019-05-30,565,0,565,45,610,610,0,0
20751,2019-05-30,510,0,510,40,550,550,0,0
20752,2019-05-30,223,0,223,17,240,240,0,0
20753,2019-05-30,1538,0,1538,122,1660,1660,0,0
20754,2019-05-30,815,0,815,65,880,880,0,0
20755,2019-05-30,945,0,945,75,1020,1020,0,0
20756,2019-05-30,463,0,463,37,500,500,0,0
20757,2019-05-30,490,0,490,30,520,520,0,0
20758,2019-05-30,908,0,908,72,980,980,0,0
20759,2019-05-30,480,0,480,20,500,500,0,0
20760,2019-05-30,908,0,908,72,980,980,0,0
20761,2019-05-30,547,0,547,43,590,590,0,0
20762,2019-05-30,825,0,825,65,890,890,0,0
20763,2019-05-30,852,0,852,68,920,920,0,0
20764,2019-05-30,436,0,436,34,470,470,0,0
20765,2019-05-30,889,0,889,71,960,960,0,0
20766,2019-05-30,278,0,278,22,300,0,300,0
20767,2019-05-30,250,0,250,20,270,270,0,0
20768,2019-05-30,501,0,501,39,540,540,0,0
20769,2019-05-30,297,0,297,23,320,320,0,0
20770,2019-05-30,741,0,741,59,800,800,0,0
20771,2019-05-30,362,0,362,28,390,390,0,0
20772,2019-05-30,1815,0,1815,145,1960,0,1960,0
20773,2019-05-30,565,-120,445,35,480,480,0,0
20774,2019-05-30,1297,0,1297,103,1400,0,1400,0
20775,2019-05-30,408,0,408,32,440,440,0,0
20776,2019-05-30,1084,0,1084,86,1170,1170,0,0
20777,2019-05-30,963,0,963,77,1040,1040,0,0
20778,2019-05-30,778,0,778,62,840,840,0,0
20779,2019-05-30,260,0,260,20,280,280,0,0
20780,2019-05-30,675,0,675,45,720,720,0,0
20781,2019-05-30,546,0,546,34,580,580,0,0
20782,2019-05-30,167,0,167,13,180,180,0,0
20783,2019-05-30,352,0,352,28,380,380,0,0
20784,2019-05-30,908,0,908,72,980,980,0,0
20785,2019-05-30,232,0,232,18,250,250,0,0
20786,2019-05-30,408,0,408,32,440,440,0,0
20787,2019-05-30,667,0,667,53,720,720,0,0
20788,2019-05-30,899,0,899,71,970,970,0,0
20789,2019-05-30,236,-50,186,14,200,200,0,0
20790,2019-05-30,852,0,852,68,920,920,0,0
20791,2019-05-30,463,0,463,37,500,500,0,0
20792,2019-05-30,963,0,963,77,1040,1040,0,0
20793,2019-05-30,260,0,260,20,280,280,0,0
20794,2019-05-30,260,0,260,20,280,280,0,0
20795,2019-05-30,917,0,917,73,990,990,0,0
20796,2019-05-30,565,0,565,45,610,610,0,0
20797,2019-05-30,371,0,371,29,400,400,0,0
20798,2019-05-30,1129,0,1129,81,1210,1210,0,0
20799,2019-05-30,380,0,380,30,410,410,0,0
20800,2019-05-30,908,0,908,72,980,980,0,0
20801,2019-05-30,3166,0,3166,244,3410,3410,0,0
20802,2019-05-30,639,0,639,51,690,690,0,0
20803,2019-05-30,1815,0,1815,145,1960,1960,0,0
20804,2019-05-30,269,0,269,21,290,290,0,0
20805,2019-05-30,1982,0,1982,158,2140,2140,0,0
20806,2019-05-30,908,0,908,72,980,980,0,0
20807,2019-05-30,908,0,908,72,980,980,0,0
20808,2019-05-30,908,0,908,72,980,980,0,0
20809,2019-05-30,343,0,343,27,370,370,0,0
20810,2019-05-30,491,0,491,39,530,530,0,0
20811,2019-05-30,315,0,315,25,340,340,0,0
20812,2019-05-30,908,0,908,72,980,980,0,0
20813,2019-05-30,982,0,982,78,1060,1060,0,0
20814,2019-05-30,260,0,260,20,280,280,0,0
20815,2019-05-30,751,0,751,59,810,810,0,0
20816,2019-05-30,889,0,889,71,960,960,0,0
20817,2019-05-30,260,0,260,20,280,280,0,0
20818,2019-05-30,1047,0,1047,83,1130,1130,0,0
20819,2019-05-30,232,0,232,18,250,250,0,0
20820,2019-05-30,236,-50,186,14,200,200,0,0
20821,2019-05-30,732,0,732,58,790,790,0,0
20822,2019-05-30,695,0,695,55,750,750,0,0
20823,2019-05-30,389,0,389,31,420,420,0,0
20824,2019-05-30,686,0,686,54,740,740,0,0
20825,2019-05-30,297,0,297,23,320,320,0,0
20826,2019-05-30,547,0,547,43,590,590,0,0
20827,2019-05-30,667,0,667,53,720,720,0,0
20828,2019-05-30,1010,0,1010,80,1090,1090,0,0
20829,2019-05-30,463,0,463,37,500,500,0,0
20830,2019-05-30,352,0,352,28,380,380,0,0
20831,2019-05-30,788,0,788,62,850,850,0,0
20832,2019-05-30,769,0,769,61,830,830,0,0
20833,2019-05-30,2186,0,2186,174,2360,2360,0,0
20834,2019-05-30,1075,0,1075,85,1160,1160,0,0
20835,2019-05-30,426,0,426,34,460,460,0,0
20836,2019-05-30,788,0,788,62,850,850,0,0
20837,2019-05-30,380,0,380,30,410,410,0,0
20838,2019-05-30,945,0,945,75,1020,1020,0,0
20839,2019-05-30,878,-94,784,62,846,846,0,0
20840,2019-05-30,463,0,463,37,500,500,0,0
20841,2019-05-30,352,0,352,28,380,380,0,0
20842,2019-05-30,241,0,241,19,260,260,0,0
20843,2019-05-30,620,0,620,40,660,660,0,0
20844,2019-05-30,547,0,547,43,590,590,0,0
20845,2019-05-30,371,0,371,29,400,400,0,0
20846,2019-05-30,593,0,593,47,640,640,0,0
20847,2019-05-30,804,0,804,46,850,850,0,0
20848,2019-05-30,880,0,880,70,950,950,0,0
20849,2019-05-30,260,0,260,20,280,280,0,0
20850,2019-05-30,509,0,509,31,540,540,0,0
20851,2019-05-30,695,0,695,55,750,750,0,0
20852,2019-05-30,389,0,389,31,420,420,0,0
20853,2019-05-30,297,0,297,23,320,320,0,0
20854,2019-05-30,325,0,325,25,350,350,0,0
20855,2019-05-30,1176,0,1176,94,1270,1270,0,0
20856,2019-05-30,315,0,315,25,340,340,0,0
20857,2019-05-30,538,0,538,42,580,580,0,0
20858,2019-05-30,908,0,908,72,980,980,0,0
20859,2019-05-30,908,0,908,72,980,980,0,0
20860,2019-05-30,1010,0,1010,80,1090,1090,0,0
20861,2019-05-30,417,0,417,33,450,450,0,0
20862,2019-05-30,315,0,315,25,340,340,0,0
20863,2019-05-30,547,0,547,43,590,590,0,0
20864,2019-05-30,1084,0,1084,86,1170,1170,0,0
20865,2019-05-30,565,0,565,45,610,610,0,0
20866,2019-05-30,473,0,473,37,510,510,0,0
20867,2019-05-30,871,0,871,69,940,940,0,0
20868,2019-05-30,936,0,936,74,1010,1010,0,0
20869,2019-05-30,491,0,491,39,530,530,0,0
20870,2019-05-30,1121,0,1121,89,1210,0,1210,0
20871,2019-05-30,149,0,149,11,160,160,0,0
20872,2019-05-30,538,0,538,42,580,580,0,0
20873,2019-05-30,426,0,426,34,460,460,0,0
20874,2019-05-30,1380,0,1380,110,1490,1490,0,0
20875,2019-05-30,825,0,825,65,890,890,0,0
20876,2019-05-30,788,0,788,62,850,850,0,0
20877,2019-05-30,1408,0,1408,112,1520,1520,0,0
20878,2019-05-30,788,0,788,62,850,850,0,0
20879,2019-05-30,417,0,417,33,450,450,0,0
20880,2019-05-30,1362,0,1362,108,1470,1470,0,0
20881,2019-05-30,695,0,695,55,750,750,0,0
20882,2019-05-30,2336,0,2336,134,2470,2470,0,0
20883,2019-05-30,806,0,806,64,870,870,0,0
20884,2019-05-30,514,0,514,41,555,555,0,0
20885,2019-05-30,778,0,778,62,840,0,840,0
20886,2019-05-30,732,0,732,58,790,790,0,0
20887,2019-05-30,297,0,297,23,320,320,0,0
20888,2019-05-30,342,0,342,18,360,360,0,0
20889,2019-05-30,352,0,352,28,380,380,0,0
20890,2019-05-31,852,0,852,68,920,920,0,0
20891,2019-05-31,1028,0,1028,82,1110,0,1110,0
20892,2019-05-31,908,0,908,72,980,980,0,0
20893,2019-05-31,834,0,834,66,900,900,0,0
20894,2019-05-31,139,0,139,11,150,0,150,0
20895,2019-05-31,542,-58,484,38,522,522,0,0
20896,2019-05-31,269,0,269,21,290,290,0,0
20897,2019-05-31,547,0,547,43,590,590,0,0
20898,2019-05-31,954,0,954,76,1030,1030,0,0
20899,2019-05-31,751,0,751,59,810,810,0,0
20900,2019-05-31,676,0,676,54,730,730,0,0
20901,2019-05-31,741,0,741,59,800,800,0,0
20902,2019-05-31,399,0,399,31,430,430,0,0
20903,2019-05-31,2204,0,2204,176,2380,0,2380,0
20904,2019-05-31,1936,0,1936,154,2090,2090,0,0
20905,2019-05-31,454,0,454,36,490,490,0,0
20906,2019-05-31,732,0,732,58,790,790,0,0
20907,2019-05-31,436,0,436,34,470,470,0,0
20908,2019-05-31,751,0,751,59,810,810,0,0
20909,2019-05-31,1408,0,1408,112,1520,1520,0,0
20910,2019-05-31,630,0,630,50,680,680,0,0
20911,2019-05-31,908,0,908,72,980,980,0,0
20912,2019-05-31,392,-42,350,28,378,378,0,0
20913,2019-05-31,454,0,454,36,490,490,0,0
20914,2019-05-31,649,0,649,51,700,700,0,0
20915,2019-05-31,1704,0,1704,136,1840,1840,0,0
20916,2019-05-31,1815,0,1815,145,1960,1960,0,0
20917,2019-05-31,2519,0,2519,201,2720,2720,0,0
20918,2019-05-31,392,-42,350,28,378,378,0,0
20919,2019-05-31,674,0,674,36,710,710,0,0
20920,2019-05-31,1362,0,1362,108,1470,1470,0,0
20921,2019-05-31,778,0,778,62,840,840,0,0
20922,2019-05-31,908,0,908,72,980,980,0,0
20923,2019-05-31,1362,0,1362,108,1470,1470,0,0
20924,2019-05-31,389,0,389,31,420,420,0,0
20925,2019-05-31,899,0,899,71,970,970,0,0
20926,2019-05-31,1815,0,1815,145,1960,1960,0,0
20927,2019-05-31,436,0,436,34,470,470,0,0
20928,2019-05-31,436,0,436,34,470,470,0,0
20929,2019-05-31,1862,0,1862,148,2010,2010,0,0
20930,2019-05-31,1278,0,1278,102,1380,1380,0,0
20931,2019-05-31,908,0,908,72,980,980,0,0
20932,2019-05-31,760,0,760,60,820,820,0,0
20933,2019-05-31,1584,0,1584,126,1710,1710,0,0
20934,2019-05-31,843,0,843,67,910,910,0,0
20935,2019-05-31,741,0,741,59,800,800,0,0
20936,2019-05-31,663,0,663,52,715,715,0,0
20937,2019-05-31,741,0,741,59,800,800,0,0
20938,2019-05-31,1815,0,1815,145,1960,1960,0,0
20939,2019-05-31,168,-18,150,12,162,162,0,0
20940,2019-05-31,149,0,149,11,160,160,0,0
20941,2019-05-31,251,0,251,19,270,270,0,0
20942,2019-05-31,149,0,149,11,160,160,0,0
20943,2019-05-31,204,0,204,16,220,220,0,0
20944,2019-05-31,334,0,334,26,360,360,0,0
20945,2019-05-31,751,0,751,59,810,810,0,0
20946,2019-05-31,204,0,204,16,220,220,0,0
20947,2019-05-31,815,0,815,65,880,880,0,0
20948,2019-05-31,908,0,908,72,980,980,0,0
20949,2019-05-31,389,0,389,31,420,0,420,0
20950,2019-05-31,584,0,584,46,630,630,0,0
20951,2019-05-31,1251,0,1251,99,1350,1350,0,0
20952,2019-05-31,575,0,575,45,620,620,0,0
20953,2019-05-31,759,0,759,51,810,810,0,0
20954,2019-05-31,454,0,454,36,490,490,0,0
20955,2019-05-31,1047,0,1047,83,1130,1130,0,0
20956,2019-05-31,519,0,519,41,560,560,0,0
20957,2019-05-31,1815,0,1815,145,1960,1960,0,0
20958,2019-05-31,908,0,908,72,980,980,0,0
20959,2019-05-31,908,0,908,72,980,980,0,0
20960,2019-05-31,380,0,380,30,410,410,0,0
20961,2019-05-31,499,0,499,31,530,0,530,0
20962,2019-05-31,602,0,602,48,650,650,0,0
20963,2019-05-31,1815,0,1815,145,1960,1960,0,0
20964,2019-05-31,908,0,908,72,980,980,0,0
20965,2019-05-31,908,0,908,72,980,980,0,0
20966,2019-05-31,2018,0,2018,152,2170,0,2170,0
20967,2019-05-31,379,0,379,21,400,400,0,0
20968,2019-05-31,139,0,139,11,150,150,0,0
20969,2019-05-31,850,-91,759,60,819,819,0,0
20970,2019-05-31,1213,0,1213,97,1310,1310,0,0
20971,2019-05-31,1815,0,1815,145,1960,1960,0,0
20972,2019-05-31,908,0,908,72,980,980,0,0
20973,2019-05-31,1815,0,1815,145,1960,1960,0,0
20974,2019-05-31,741,0,741,59,800,800,0,0
20975,2019-05-31,695,0,695,55,750,750,0,0
20976,2019-05-31,667,0,667,53,720,720,0,0
20977,2019-05-31,260,0,260,20,280,280,0,0
20978,2019-05-31,783,0,783,62,845,845,0,0
20979,2019-05-31,223,0,223,17,240,240,0,0
20980,2019-05-31,269,0,269,21,290,290,0,0
20981,2019-05-31,1575,0,1575,125,1700,1700,0,0
20982,2019-05-31,1065,0,1065,85,1150,1150,0,0
20983,2019-05-31,2130,0,2130,170,2300,2300,0,0
20984,2019-05-31,1547,0,1547,123,1670,1670,0,0
20985,2019-05-31,769,0,769,61,830,830,0,0
20986,2019-05-31,695,0,695,55,750,750,0,0
20987,2019-05-31,1778,0,1778,142,1920,1920,0,0
20988,2019-05-31,788,0,788,62,850,850,0,0
20989,2019-05-31,463,0,463,37,500,500,0,0
20990,2019-05-31,788,0,788,62,850,850,0,0
20991,2019-05-31,2176,0,2176,174,2350,2350,0,0
20992,2019-05-31,1575,0,1575,125,1700,1700,0,0
20993,2019-05-31,269,0,269,21,290,290,0,0
20994,2019-05-31,686,0,686,54,740,740,0,0
20995,2019-05-31,2723,0,2723,217,2940,2940,0,0
20996,2019-05-31,1723,0,1723,137,1860,1860,0,0
20997,2019-05-31,167,0,167,13,180,180,0,0
20998,2019-05-31,565,0,565,45,610,610,0,0
20999,2019-05-31,232,0,232,18,250,250,0,0
21000,2019-05-31,1102,0,1102,88,1190,1190,0,0
21001,2019-05-31,565,0,565,45,610,610,0,0
21002,2019-05-31,723,0,723,57,780,780,0,0
21003,2019-05-31,426,0,426,34,460,460,0,0
21004,2019-05-31,463,0,463,37,500,500,0,0
21005,2019-05-31,325,0,325,25,350,0,350,0
21006,2019-05-31,602,0,602,48,650,650,0,0
21007,2019-05-31,519,0,519,41,560,560,0,0
21008,2019-05-31,139,0,139,11,150,150,0,0
21009,2019-05-31,510,0,510,40,550,550,0,0
21010,2019-05-31,1047,0,1047,83,1130,1130,0,0
21011,2019-05-31,1065,0,1065,85,1150,1150,0,0
21012,2019-05-31,612,0,612,48,660,660,0,0
21013,2019-05-31,788,0,788,62,850,850,0,0
21014,2019-05-31,241,0,241,19,260,260,0,0
21015,2019-05-31,565,0,565,45,610,610,0,0
21016,2019-05-31,889,0,889,71,960,960,0,0
21017,2019-05-31,639,0,639,51,690,690,0,0
21018,2019-05-31,213,0,213,17,230,230,0,0
21019,2019-05-31,1121,0,1121,89,1210,1210,0,0
21020,2019-05-31,130,0,130,10,140,140,0,0
21021,2019-05-31,1288,0,1288,102,1390,1390,0,0
21022,2019-05-31,241,0,241,19,260,260,0,0
21023,2019-05-31,1010,0,1010,80,1090,1090,0,0
21024,2019-05-31,482,0,482,38,520,520,0,0
21025,2019-05-31,704,0,704,56,760,760,0,0
21026,2019-05-31,250,0,250,20,270,270,0,0
21027,2019-05-31,399,0,399,31,430,430,0,0
21028,2019-05-31,565,0,565,45,610,610,0,0
21029,2019-05-31,1741,0,1741,139,1880,0,1880,0
21030,2019-05-31,945,0,945,75,1020,1020,0,0
21031,2019-05-31,500,0,500,40,540,540,0,0
21032,2019-05-31,788,0,788,62,850,850,0,0
21033,2019-05-31,1149,0,1149,91,1240,1240,0,0
21034,2019-05-31,741,0,741,59,800,800,0,0
21035,2019-05-31,1149,0,1149,91,1240,1240,0,0
21036,2019-05-31,1843,0,1843,147,1990,1990,0,0
21037,2019-05-31,436,0,436,34,470,470,0,0
21038,2019-05-31,362,0,362,28,390,390,0,0
21039,2019-05-31,602,0,602,48,650,650,0,0
21040,2019-05-31,788,0,788,62,850,850,0,0
21041,2019-05-31,723,0,723,57,780,780,0,0
21042,2019-05-31,612,0,612,48,660,660,0,0
21043,2019-05-31,1380,0,1380,110,1490,1490,0,0
21044,2019-05-31,482,0,482,38,520,520,0,0
21045,2019-05-31,389,0,389,31,420,420,0,0
21046,2019-05-31,1575,0,1575,125,1700,1700,0,0
21047,2019-05-31,573,0,573,37,610,610,0,0
21048,2019-05-31,362,0,362,28,390,390,0,0
21049,2019-05-31,769,0,769,61,830,830,0,0
21050,2019-05-31,667,0,667,53,720,720,0,0
21051,2019-05-31,343,0,343,27,370,0,370,0
21052,2019-05-31,788,0,788,62,850,850,0,0
21053,2019-05-31,788,0,788,62,850,850,0,0
21054,2019-05-31,778,0,778,62,840,840,0,0
21055,2019-05-31,2362,0,2362,188,2550,0,2550,0
21056,2019-06-01,788,0,788,62,850,850,0,0
21057,2019-06-01,667,0,667,53,720,720,0,0
21058,2019-06-01,778,0,778,62,840,840,0,0
21059,2019-06-01,1343,0,1343,107,1450,1450,0,0
21060,2019-06-01,732,0,732,58,790,790,0,0
21061,2019-06-01,612,0,612,48,660,660,0,0
21062,2019-06-01,667,0,667,53,720,720,0,0
21063,2019-06-01,288,0,288,22,310,310,0,0
21064,2019-06-01,3084,0,3084,246,3330,3330,0,0
21065,2019-06-01,1251,0,1251,99,1350,1350,0,0
21066,2019-06-01,1926,0,1926,154,2080,2080,0,0
21067,2019-06-01,1278,0,1278,102,1380,1380,0,0
21068,2019-06-01,2426,0,2426,194,2620,0,2620,0
21069,2019-06-01,575,0,575,45,620,620,0,0
21070,2019-06-01,908,0,908,72,980,980,0,0
21071,2019-06-01,908,0,908,72,980,980,0,0
21072,2019-06-01,741,0,741,59,800,800,0,0
21073,2019-06-01,908,0,908,72,980,980,0,0
21074,2019-06-01,1889,0,1889,151,2040,2040,0,0
21075,2019-06-01,954,0,954,76,1030,1030,0,0
21076,2019-06-01,565,0,565,45,610,610,0,0
21077,2019-06-01,630,0,630,50,680,680,0,0
21078,2019-06-01,1028,0,1028,82,1110,1110,0,0
21079,2019-06-01,2723,0,2723,217,2940,2940,0,0
21080,2019-06-01,1213,0,1213,97,1310,1310,0,0
21081,2019-06-01,1130,0,1130,90,1220,1220,0,0
21082,2019-06-01,351,0,351,19,370,370,0,0
21083,2019-06-01,658,0,658,52,710,710,0,0
21084,2019-06-01,1408,0,1408,112,1520,1520,0,0
21085,2019-06-01,612,0,612,48,660,660,0,0
21086,2019-06-01,116,0,116,9,125,125,0,0
21087,2019-06-01,352,0,352,28,380,380,0,0
21088,2019-06-01,695,0,695,55,750,750,0,0
21089,2019-06-01,306,0,306,24,330,330,0,0
21090,2019-06-01,463,0,463,37,500,500,0,0
21091,2019-06-01,1167,0,1167,93,1260,1260,0,0
21092,2019-06-01,1075,0,1075,85,1160,1160,0,0
21093,2019-06-01,426,0,426,34,460,460,0,0
21094,2019-06-01,658,0,658,52,710,710,0,0
21095,2019-06-01,306,0,306,24,330,330,0,0
21096,2019-06-01,2723,0,2723,217,2940,2940,0,0
21097,2019-06-01,149,0,149,11,160,160,0,0
21098,2019-06-01,609,0,609,31,640,640,0,0
21099,2019-06-01,778,0,778,62,840,840,0,0
21100,2019-06-01,1389,0,1389,111,1500,1500,0,0
21101,2019-06-01,806,0,806,64,870,870,0,0
21102,2019-06-01,1815,0,1815,145,1960,1960,0,0
21103,2019-06-01,908,0,908,72,980,980,0,0
21104,2019-06-01,908,0,908,72,980,980,0,0
21105,2019-06-01,982,0,982,78,1060,1060,0,0
21106,2019-06-01,760,0,760,60,820,0,820,0
21107,2019-06-01,778,0,778,62,840,840,0,0
21108,2019-06-01,93,0,93,7,100,100,0,0
21109,2019-06-01,417,0,417,33,450,450,0,0
21110,2019-06-01,482,0,482,38,520,520,0,0
21111,2019-06-01,426,0,426,34,460,460,0,0
21112,2019-06-01,306,0,306,24,330,330,0,0
21113,2019-06-01,510,0,510,40,550,550,0,0
21114,2019-06-01,538,0,538,42,580,580,0,0
21115,2019-06-01,565,0,565,45,610,610,0,0
21116,2019-06-01,334,0,334,26,360,360,0,0
21117,2019-06-01,1028,0,1028,82,1110,1110,0,0
21118,2019-06-01,426,0,426,34,460,460,0,0
21119,2019-06-01,1260,0,1260,100,1360,1360,0,0
21120,2019-06-01,612,0,612,48,660,660,0,0
21121,2019-06-01,1815,0,1815,145,1960,1960,0,0
21122,2019-06-01,908,0,908,72,980,980,0,0
21123,2019-06-01,1269,0,1269,101,1370,1370,0,0
21124,2019-06-01,482,0,482,38,520,520,0,0
21125,2019-06-01,630,0,630,50,680,680,0,0
21126,2019-06-01,167,0,167,13,180,180,0,0
21127,2019-06-01,334,0,334,26,360,360,0,0
21128,2019-06-01,1945,0,1945,155,2100,2100,0,0
21129,2019-06-01,473,0,473,37,510,510,0,0
21130,2019-06-01,436,0,436,34,470,470,0,0
21131,2019-06-01,676,0,676,54,730,730,0,0
21132,2019-06-01,371,0,371,29,400,400,0,0
21133,2019-06-01,926,0,926,74,1000,1000,0,0
21134,2019-06-01,269,0,269,21,290,290,0,0
21135,2019-06-01,1362,0,1362,108,1470,1470,0,0
21136,2019-06-01,315,0,315,25,340,340,0,0
21137,2019-06-01,408,0,408,32,440,440,0,0
21138,2019-06-01,908,0,908,72,980,980,0,0
21139,2019-06-01,1445,0,1445,115,1560,1560,0,0
21140,2019-06-01,491,0,491,39,530,530,0,0
21141,2019-06-01,988,-105,883,62,945,945,0,0
21142,2019-06-01,805,0,805,55,860,860,0,0
21143,2019-06-01,806,0,806,64,870,870,0,0
21144,2019-06-01,908,0,908,72,980,980,0,0
21145,2019-06-01,908,0,908,72,980,980,0,0
21146,2019-06-01,463,0,463,37,500,500,0,0
21147,2019-06-01,1063,0,1063,67,1130,1130,0,0
21148,2019-06-01,1036,0,1036,74,1110,1110,0,0
21149,2019-06-01,648,0,648,42,690,690,0,0
21150,2019-06-01,601,0,601,39,640,640,0,0
21151,2019-06-01,982,0,982,78,1060,1060,0,0
21152,2019-06-01,473,0,473,37,510,510,0,0
21153,2019-06-01,306,0,306,24,330,330,0,0
21154,2019-06-01,251,0,251,19,270,270,0,0
21155,2019-06-01,751,0,751,59,810,810,0,0
21156,2019-06-01,1815,0,1815,145,1960,1960,0,0
21157,2019-06-01,510,0,510,40,550,550,0,0
21158,2019-06-01,213,0,213,17,230,230,0,0
21159,2019-06-01,306,0,306,24,330,330,0,0
21160,2019-06-01,1102,0,1102,88,1190,1190,0,0
21161,2019-06-01,731,0,731,49,780,780,0,0
21162,2019-06-01,1297,0,1297,103,1400,1400,0,0
21163,2019-06-01,1362,0,1362,108,1470,1470,0,0
21164,2019-06-01,223,0,223,17,240,240,0,0
21165,2019-06-01,630,0,630,50,680,680,0,0
21166,2019-06-01,528,0,528,42,570,570,0,0
21167,2019-06-01,584,0,584,46,630,630,0,0
21168,2019-06-01,232,0,232,18,250,250,0,0
21169,2019-06-01,601,0,601,39,640,640,0,0
21170,2019-06-01,158,0,158,12,170,170,0,0
21171,2019-06-01,584,0,584,46,630,630,0,0
21172,2019-06-01,204,0,204,16,220,220,0,0
21173,2019-06-01,945,0,945,75,1020,1020,0,0
21174,2019-06-01,250,0,250,20,270,270,0,0
21175,2019-06-01,399,0,399,31,430,430,0,0
21176,2019-06-01,399,0,399,31,430,430,0,0
21177,2019-06-01,399,0,399,31,430,430,0,0
21178,2019-06-01,528,0,528,42,570,570,0,0
21179,2019-06-01,639,0,639,51,690,690,0,0
21180,2019-06-01,778,0,778,62,840,840,0,0
21181,2019-06-01,389,0,389,31,420,420,0,0
21182,2019-06-01,945,0,945,75,1020,1020,0,0
21183,2019-06-01,797,0,797,63,860,860,0,0
21184,2019-06-01,1326,-142,1184,94,1278,1278,0,0
21185,2019-06-01,945,0,945,75,1020,1020,0,0
21186,2019-06-01,352,0,352,28,380,380,0,0
21187,2019-06-01,389,0,389,31,420,420,0,0
21188,2019-06-01,417,0,417,33,450,450,0,0
21189,2019-06-01,1035,0,1035,65,1100,1100,0,0
21190,2019-06-01,686,0,686,54,740,740,0,0
21191,2019-06-01,491,0,491,39,530,530,0,0
21192,2019-06-01,760,0,760,60,820,820,0,0
21193,2019-06-01,362,0,362,28,390,390,0,0
21194,2019-06-01,806,0,806,64,870,870,0,0
21195,2019-06-01,315,0,315,25,340,340,0,0
21196,2019-06-01,325,0,325,25,350,350,0,0
21197,2019-06-01,915,-98,817,65,882,882,0,0
21198,2019-06-01,371,0,371,29,400,400,0,0
21199,2019-06-01,371,0,371,29,400,400,0,0
21200,2019-06-01,686,0,686,54,740,740,0,0
21201,2019-06-01,232,0,232,18,250,250,0,0
21202,2019-06-01,371,0,371,29,400,400,0,0
21203,2019-06-01,843,0,843,67,910,910,0,0
21204,2019-06-01,454,0,454,36,490,0,490,0
21205,2019-06-01,769,0,769,61,830,830,0,0
21206,2019-06-01,999,0,999,71,1070,1070,0,0
21207,2019-06-01,973,0,973,77,1050,1050,0,0
21208,2019-06-01,1760,0,1760,140,1900,1900,0,0
21209,2019-06-01,871,0,871,69,940,940,0,0
21210,2019-06-01,167,0,167,13,180,180,0,0
21211,2019-06-01,954,0,954,76,1030,0,1030,0
21212,2019-06-01,630,0,630,50,680,680,0,0
21213,2019-06-01,473,0,473,37,510,510,0,0
21214,2019-06-01,778,0,778,62,840,840,0,0
21215,2019-06-01,704,0,704,56,760,760,0,0
21216,2019-06-01,547,0,547,43,590,590,0,0
21217,2019-06-01,482,0,482,38,520,520,0,0
21218,2019-06-01,593,0,593,47,640,640,0,0
21219,2019-06-01,251,0,251,19,270,270,0,0
21220,2019-06-01,417,0,417,33,450,450,0,0
21221,2019-06-01,306,0,306,24,330,330,0,0
21222,2019-06-01,102,0,102,8,110,110,0,0
21223,2019-06-01,1575,0,1575,125,1700,1700,0,0
21224,2019-06-01,249,0,249,11,260,260,0,0
21225,2019-06-01,1575,0,1575,125,1700,1700,0,0
21226,2019-06-01,788,0,788,62,850,850,0,0
21227,2019-06-01,1575,0,1575,125,1700,1700,0,0
21228,2019-06-01,1575,0,1575,125,1700,1700,0,0
21229,2019-06-01,1028,0,1028,82,1110,1110,0,0
21230,2019-06-01,880,0,880,70,950,950,0,0
21231,2019-06-01,1445,0,1445,115,1560,1560,0,0
21232,2019-06-01,851,0,851,59,910,910,0,0
21233,2019-06-01,1769,0,1769,141,1910,1910,0,0
21234,2019-06-01,510,0,510,40,550,550,0,0
21235,2019-06-01,584,0,584,46,630,630,0,0
21236,2019-06-01,778,0,778,62,840,840,0,0
21237,2019-06-01,1028,0,1028,82,1110,1110,0,0
21238,2019-06-01,1288,0,1288,102,1390,0,1390,0
21239,2019-06-01,1195,0,1195,95,1290,1290,0,0
21240,2019-06-01,547,0,547,43,590,590,0,0
21241,2019-06-01,852,0,852,68,920,920,0,0
21242,2019-06-01,788,0,788,62,850,850,0,0
21243,2019-06-01,501,0,501,39,540,0,540,0
21244,2019-06-01,788,0,788,62,850,850,0,0
21245,2019-06-01,982,0,982,78,1060,1060,0,0
21246,2019-06-01,788,0,788,62,850,850,0,0
21247,2019-06-01,945,0,945,75,1020,1020,0,0
21248,2019-06-01,945,0,945,75,1020,1020,0,0
21249,2019-06-01,491,0,491,39,530,530,0,0
21250,2019-06-01,926,0,926,74,1000,1000,0,0
21251,2019-06-01,676,0,676,54,730,730,0,0
21252,2019-06-01,501,0,501,39,540,540,0,0
21253,2019-06-01,371,0,371,29,400,400,0,0
21254,2019-06-01,389,0,389,31,420,420,0,0
21255,2019-06-01,149,0,149,11,160,160,0,0
21256,2019-06-01,139,0,139,11,150,150,0,0
21257,2019-06-01,1584,0,1584,126,1710,1710,0,0
21258,2019-06-01,454,0,454,36,490,490,0,0
21259,2019-06-01,4260,0,4260,340,4600,0,4600,0
21260,2019-06-01,788,0,788,62,850,850,0,0
21261,2019-06-01,1575,0,1575,125,1700,1700,0,0
21262,2019-06-01,269,0,269,21,290,290,0,0
21263,2019-06-01,899,0,899,71,970,970,0,0
21264,2019-06-01,454,0,454,36,490,490,0,0
21265,2019-06-01,1575,0,1575,125,1700,1700,0,0
21266,2019-06-01,1575,0,1575,125,1700,1700,0,0
21267,2019-06-01,556,0,556,44,600,0,600,0
21268,2019-06-01,1575,0,1575,125,1700,0,1700,0
21269,2019-06-01,1871,0,1871,149,2020,2020,0,0
21270,2019-06-02,917,0,917,73,990,990,0,0
21271,2019-06-02,575,0,575,45,620,620,0,0
21272,2019-06-02,657,0,657,43,700,700,0,0
21273,2019-06-02,232,0,232,18,250,250,0,0
21274,2019-06-02,547,0,547,43,590,590,0,0
21275,2019-06-02,1815,0,1815,145,1960,1960,0,0
21276,2019-06-02,1510,0,1510,120,1630,1630,0,0
21277,2019-06-02,482,0,482,38,520,520,0,0
21278,2019-06-02,556,0,556,44,600,600,0,0
21279,2019-06-02,1751,0,1751,139,1890,1890,0,0
21280,2019-06-02,343,0,343,27,370,370,0,0
21281,2019-06-02,510,0,510,40,550,550,0,0
21282,2019-06-02,223,0,223,17,240,240,0,0
21283,2019-06-02,649,0,649,51,700,700,0,0
21284,2019-06-02,269,0,269,21,290,290,0,0
21285,2019-06-02,704,0,704,56,760,760,0,0
21286,2019-06-02,1815,0,1815,145,1960,1960,0,0
21287,2019-06-02,-908,0,-908,-72,-980,-980,0,0
21288,2019-06-02,389,0,389,31,420,420,0,0
21289,2019-06-02,306,0,306,24,330,330,0,0
21290,2019-06-02,1815,0,1815,145,1960,1960,0,0
21291,2019-06-02,1815,0,1815,145,1960,1960,0,0
21292,2019-06-02,1195,0,1195,95,1290,1290,0,0
21293,2019-06-02,389,0,389,31,420,420,0,0
21294,2019-06-02,908,0,908,72,980,980,0,0
21295,2019-06-02,908,0,908,72,980,980,0,0
21296,2019-06-02,417,0,417,33,450,450,0,0
21297,2019-06-02,915,-98,817,65,882,882,0,0
21298,2019-06-02,1445,0,1445,115,1560,1560,0,0
21299,2019-06-02,167,0,167,13,180,180,0,0
21300,2019-06-02,1788,0,1788,142,1930,1930,0,0
21301,2019-06-02,1056,0,1056,84,1140,1140,0,0
21302,2019-06-02,908,0,908,72,980,980,0,0
21303,2019-06-02,251,0,251,19,270,270,0,0
21304,2019-06-02,343,0,343,27,370,370,0,0
21305,2019-06-02,371,0,371,29,400,400,0,0
21306,2019-06-02,343,0,343,27,370,370,0,0
21307,2019-06-02,630,0,630,50,680,680,0,0
21308,2019-06-02,908,0,908,72,980,980,0,0
21309,2019-06-02,110,0,110,0,110,110,0,0
21310,2019-06-02,371,0,371,29,400,400,0,0
21311,2019-06-02,269,0,269,21,290,290,0,0
21312,2019-06-02,278,0,278,22,300,300,0,0
21313,2019-06-02,491,0,491,39,530,530,0,0
21314,2019-06-02,389,0,389,31,420,420,0,0
21315,2019-06-02,704,0,704,56,760,760,0,0
21316,2019-06-02,380,0,380,30,410,410,0,0
21317,2019-06-02,1315,0,1315,105,1420,1420,0,0
21318,2019-06-02,843,0,843,67,910,910,0,0
21319,2019-06-02,260,0,260,20,280,280,0,0
21320,2019-06-02,306,0,306,24,330,330,0,0
21321,2019-06-02,1362,0,1362,108,1470,1470,0,0
21322,2019-06-02,315,0,315,25,340,340,0,0
21323,2019-06-02,536,0,536,34,570,570,0,0
21324,2019-06-02,658,0,658,52,710,710,0,0
21325,2019-06-02,260,0,260,20,280,280,0,0
21326,2019-06-02,538,0,538,42,580,580,0,0
21327,2019-06-02,592,0,592,38,630,630,0,0
21328,2019-06-02,1056,0,1056,84,1140,1140,0,0
21329,2019-06-02,547,0,547,43,590,590,0,0
21330,2019-06-02,-908,0,-908,-72,-980,-980,0,0
21331,2019-06-02,232,0,232,18,250,250,0,0
21332,2019-06-02,806,0,806,64,870,870,0,0
21333,2019-06-02,908,0,908,72,980,980,0,0
21334,2019-06-02,1815,0,1815,145,1960,1960,0,0
21335,2019-06-02,2973,0,2973,237,3210,3210,0,0
21336,2019-06-02,1815,0,1815,145,1960,1960,0,0
21337,2019-06-02,1325,0,1325,105,1430,1430,0,0
21338,2019-06-02,840,-90,750,60,810,810,0,0
21339,2019-06-02,1315,0,1315,105,1420,1420,0,0
21340,2019-06-02,704,0,704,56,760,760,0,0
21341,2019-06-02,741,0,741,59,800,800,0,0
21342,2019-06-02,195,0,195,15,210,210,0,0
21343,2019-06-02,695,0,695,55,750,750,0,0
21344,2019-06-02,306,0,306,24,330,330,0,0
21345,2019-06-02,973,0,973,77,1050,1050,0,0
21346,2019-06-02,1019,0,1019,81,1100,1100,0,0
21347,2019-06-02,889,0,889,71,960,0,960,0
21348,2019-06-02,232,0,232,18,250,250,0,0
21349,2019-06-02,223,0,223,17,240,240,0,0
21350,2019-06-02,2889,0,2889,231,3120,3120,0,0
21351,2019-06-02,894,0,894,71,965,965,0,0
21352,2019-06-02,426,0,426,34,460,460,0,0
21353,2019-06-02,1982,0,1982,158,2140,2140,0,0
21354,2019-06-02,269,0,269,21,290,290,0,0
21355,2019-06-02,102,0,102,8,110,110,0,0
21356,2019-06-02,426,0,426,34,460,460,0,0
21357,2019-06-02,325,0,325,25,350,350,0,0
21358,2019-06-02,338,0,338,27,365,365,0,0
21359,2019-06-02,1065,0,1065,85,1150,1150,0,0
21360,2019-06-02,658,0,658,52,710,710,0,0
21361,2019-06-02,260,0,260,20,280,280,0,0
21362,2019-06-02,482,0,482,38,520,520,0,0
21363,2019-06-02,186,0,186,14,200,200,0,0
21364,2019-06-02,260,0,260,20,280,280,0,0
21365,2019-06-02,167,0,167,13,180,180,0,0
21366,2019-06-02,288,0,288,22,310,310,0,0
21367,2019-06-02,510,0,510,40,550,550,0,0
21368,2019-06-02,1269,0,1269,101,1370,1370,0,0
21369,2019-06-02,260,0,260,20,280,280,0,0
21370,2019-06-02,519,0,519,41,560,560,0,0
21371,2019-06-02,1158,0,1158,92,1250,0,1250,0
21372,2019-06-02,547,0,547,43,590,590,0,0
21373,2019-06-02,167,0,167,13,180,180,0,0
21374,2019-06-02,399,0,399,31,430,430,0,0
21375,2019-06-02,741,0,741,59,800,800,0,0
21376,2019-06-02,584,0,584,46,630,630,0,0
21377,2019-06-02,639,0,639,51,690,690,0,0
21378,2019-06-02,788,0,788,62,850,850,0,0
21379,2019-06-02,528,0,528,42,570,570,0,0
21380,2019-06-02,797,0,797,63,860,860,0,0
21381,2019-06-02,982,0,982,78,1060,1060,0,0
21382,2019-06-02,241,0,241,19,260,260,0,0
21383,2019-06-02,204,0,204,16,220,220,0,0
21384,2019-06-02,251,0,251,19,270,270,0,0
21385,2019-06-02,463,0,463,37,500,500,0,0
21386,2019-06-02,834,0,834,66,900,900,0,0
21387,2019-06-02,2065,0,2065,165,2230,2230,0,0
21388,2019-06-02,1575,0,1575,125,1700,1700,0,0
21389,2019-06-02,1575,0,1575,125,1700,1700,0,0
21390,2019-06-02,788,0,788,62,850,850,0,0
21391,2019-06-02,334,0,334,26,360,360,0,0
21392,2019-06-02,575,0,575,45,620,620,0,0
21393,2019-06-02,695,0,695,55,750,750,0,0
21394,2019-06-02,251,0,251,19,270,270,0,0
21395,2019-06-02,454,0,454,36,490,490,0,0
21396,2019-06-02,371,0,371,29,400,400,0,0
21397,2019-06-02,538,0,538,42,580,580,0,0
21398,2019-06-02,399,0,399,31,430,430,0,0
21399,2019-06-02,389,0,389,31,420,420,0,0
21400,2019-06-02,269,0,269,21,290,290,0,0
21401,2019-06-02,1806,0,1806,144,1950,1950,0,0
21402,2019-06-02,1223,0,1223,97,1320,1320,0,0
21403,2019-06-02,649,0,649,51,700,700,0,0
21404,2019-06-02,306,0,306,24,330,330,0,0
21405,2019-06-02,269,0,269,21,290,290,0,0
21406,2019-06-02,713,0,713,57,770,770,0,0
21407,2019-06-02,399,0,399,31,430,430,0,0
21408,2019-06-02,362,0,362,28,390,390,0,0
21409,2019-06-02,1600,-340,1260,100,1360,1360,0,0
21410,2019-06-02,796,0,796,54,850,850,0,0
21411,2019-06-02,2658,0,2658,212,2870,2870,0,0
21412,2019-06-02,306,0,306,24,330,330,0,0
21413,2019-06-02,788,0,788,62,850,850,0,0
21414,2019-06-02,2130,0,2130,170,2300,2300,0,0
21415,2019-06-02,362,0,362,28,390,390,0,0
21416,2019-06-02,1473,0,1473,117,1590,1590,0,0
21417,2019-06-02,1111,0,1111,79,1190,1190,0,0
21418,2019-06-02,277,0,277,13,290,290,0,0
21419,2019-06-02,278,0,278,22,300,300,0,0
21420,2019-06-02,102,0,102,8,110,110,0,0
21421,2019-06-02,325,0,325,25,350,350,0,0
21422,2019-06-02,306,0,306,24,330,330,0,0
21423,2019-06-02,315,0,315,25,340,340,0,0
21424,2019-06-02,491,0,491,39,530,530,0,0
21425,2019-06-02,788,0,788,62,850,850,0,0
21426,2019-06-02,306,0,306,24,330,330,0,0
21427,2019-06-03,491,0,491,39,530,530,0,0
21428,2019-06-03,806,0,806,64,870,870,0,0
21429,2019-06-03,917,0,917,73,990,990,0,0
21430,2019-06-03,1001,0,1001,79,1080,1080,0,0
21431,2019-06-03,1751,0,1751,139,1890,1890,0,0
21432,2019-06-03,325,0,325,25,350,350,0,0
21433,2019-06-03,639,0,639,51,690,690,0,0
21434,2019-06-03,880,0,880,70,950,950,0,0
21435,2019-06-03,982,0,982,78,1060,1060,0,0
21436,2019-06-03,343,0,343,27,370,370,0,0
21437,2019-06-03,473,0,473,37,510,510,0,0
21438,2019-06-03,843,0,843,67,910,910,0,0
21439,2019-06-03,713,0,713,57,770,0,770,0
21440,2019-06-03,788,0,788,62,850,850,0,0
21441,2019-06-03,2001,0,2001,159,2160,2160,0,0
21442,2019-06-03,352,0,352,28,380,380,0,0
21443,2019-06-03,234,-25,209,16,225,225,0,0
21444,2019-06-03,788,0,788,62,850,850,0,0
21445,2019-06-03,1130,0,1130,90,1220,1220,0,0
21446,2019-06-03,232,0,232,18,250,250,0,0
21447,2019-06-03,1241,0,1241,99,1340,1340,0,0
21448,2019-06-03,195,0,195,15,210,210,0,0
21449,2019-06-03,260,0,260,20,280,280,0,0
21450,2019-06-03,822,-88,734,58,792,0,792,0
21451,2019-06-03,908,0,908,72,980,980,0,0
21452,2019-06-03,2204,0,2204,176,2380,2380,0,0
21453,2019-06-03,343,0,343,27,370,370,0,0
21454,2019-06-03,436,0,436,34,470,0,470,0
21455,2019-06-03,482,0,482,38,520,520,0,0
21456,2019-06-03,1429,-153,1276,101,1377,1377,0,0
21457,2019-06-03,454,0,454,36,490,490,0,0
21458,2019-06-03,880,0,880,70,950,950,0,0
21459,2019-06-03,426,0,426,34,460,460,0,0
21460,2019-06-03,269,0,269,21,290,290,0,0
21461,2019-06-03,-1815,0,-1815,-145,-1960,-1960,0,0
21462,2019-06-03,1815,0,1815,145,1960,1960,0,0
21463,2019-06-03,593,0,593,47,640,640,0,0
21464,2019-06-03,982,0,982,78,1060,1060,0,0
21465,2019-06-03,3305,0,3305,255,3560,3560,0,0
21466,2019-06-03,584,0,584,46,630,630,0,0
21467,2019-06-03,358,-76,282,22,304,304,0,0
21468,2019-06-03,510,0,510,40,550,550,0,0
21469,2019-06-03,538,0,538,42,580,580,0,0
21470,2019-06-03,463,0,463,37,500,500,0,0
21471,2019-06-03,151,-32,119,9,128,128,0,0
21472,2019-06-03,426,0,426,34,460,460,0,0
21473,2019-06-03,408,0,408,32,440,440,0,0
21474,2019-06-03,806,0,806,64,870,870,0,0
21475,2019-06-03,260,0,260,20,280,280,0,0
21476,2019-06-03,862,0,862,68,930,930,0,0
21477,2019-06-03,908,0,908,72,980,980,0,0
21478,2019-06-03,778,0,778,62,840,840,0,0
21479,2019-06-03,1297,0,1297,103,1400,1400,0,0
21480,2019-06-03,825,0,825,65,890,890,0,0
21481,2019-06-03,362,0,362,28,390,390,0,0
21482,2019-06-03,426,0,426,34,460,460,0,0
21483,2019-06-03,408,0,408,32,440,440,0,0
21484,2019-06-03,649,0,649,51,700,700,0,0
21485,2019-06-03,250,0,250,20,270,270,0,0
21486,2019-06-03,778,0,778,62,840,840,0,0
21487,2019-06-03,371,0,371,29,400,400,0,0
21488,2019-06-03,899,0,899,71,970,970,0,0
21489,2019-06-03,334,0,334,26,360,360,0,0
21490,2019-06-03,426,0,426,34,460,460,0,0
21491,2019-06-03,778,0,778,62,840,840,0,0
21492,2019-06-03,445,0,445,35,480,480,0,0
21493,2019-06-03,1306,0,1306,104,1410,1410,0,0
21494,2019-06-03,334,0,334,26,360,360,0,0
21495,2019-06-03,306,0,306,24,330,330,0,0
21496,2019-06-03,223,0,223,17,240,240,0,0
21497,2019-06-03,469,0,469,11,480,480,0,0
21498,2019-06-03,538,0,538,42,580,580,0,0
21499,2019-06-03,445,0,445,35,480,480,0,0
21500,2019-06-03,1528,0,1528,122,1650,1650,0,0
21501,2019-06-03,654,-70,584,46,630,630,0,0
21502,2019-06-03,259,0,259,11,270,270,0,0
21503,2019-06-03,538,0,538,42,580,580,0,0
21504,2019-06-03,788,0,788,62,850,850,0,0
21505,2019-06-03,195,0,195,15,210,210,0,0
21506,2019-06-03,236,-50,186,14,200,200,0,0
21507,2019-06-03,334,0,334,26,360,360,0,0
21508,2019-06-03,602,0,602,48,650,650,0,0
21509,2019-06-03,1408,0,1408,112,1520,1520,0,0
21510,2019-06-03,1315,0,1315,105,1420,1420,0,0
21511,2019-06-03,1260,0,1260,100,1360,1360,0,0
21512,2019-06-03,232,0,232,18,250,250,0,0
21513,2019-06-03,741,0,741,59,800,800,0,0
21514,2019-06-03,1241,0,1241,99,1340,1340,0,0
21515,2019-06-03,1167,0,1167,93,1260,1260,0,0
21516,2019-06-03,917,0,917,73,990,990,0,0
21517,2019-06-03,102,0,102,8,110,110,0,0
21518,2019-06-03,584,0,584,46,630,630,0,0
21519,2019-06-03,1426,0,1426,114,1540,1540,0,0
21520,2019-06-03,473,0,473,37,510,510,0,0
21521,2019-06-03,315,0,315,25,340,340,0,0
21522,2019-06-03,1047,0,1047,83,1130,1130,0,0
21523,2019-06-03,232,0,232,18,250,250,0,0
21524,2019-06-03,232,0,232,18,250,250,0,0
21525,2019-06-03,788,0,788,62,850,850,0,0
21526,2019-06-03,1028,0,1028,82,1110,1110,0,0
21527,2019-06-03,788,0,788,62,850,850,0,0
21528,2019-06-03,251,0,251,19,270,270,0,0
21529,2019-06-03,1158,-124,1034,82,1116,1116,0,0
21530,2019-06-03,593,0,593,47,640,640,0,0
21531,2019-06-03,417,0,417,33,450,450,0,0
21532,2019-06-03,593,0,593,47,640,640,0,0
21533,2019-06-03,788,0,788,62,850,850,0,0
21534,2019-06-04,713,0,713,57,770,770,0,0
21535,2019-06-04,500,0,500,40,540,540,0,0
21536,2019-06-04,269,0,269,21,290,290,0,0
21537,2019-06-04,1296,0,1296,94,1390,1390,0,0
21538,2019-06-04,1517,0,1517,103,1620,1620,0,0
21539,2019-06-04,584,0,584,46,630,630,0,0
21540,2019-06-04,408,0,408,32,440,440,0,0
21541,2019-06-04,2676,0,2676,214,2890,2890,0,0
21542,2019-06-04,269,0,269,21,290,290,0,0
21543,2019-06-04,362,0,362,28,390,390,0,0
21544,2019-06-04,1001,0,1001,79,1080,1080,0,0
21545,2019-06-04,306,0,306,24,330,330,0,0
21546,2019-06-04,260,0,260,20,280,280,0,0
21547,2019-06-04,1075,0,1075,85,1160,1160,0,0
21548,2019-06-04,612,0,612,48,660,660,0,0
21549,2019-06-04,208,0,208,16,224,224,0,0
21550,2019-06-04,575,0,575,45,620,620,0,0
21551,2019-06-04,223,0,223,17,240,240,0,0
21552,2019-06-04,260,0,260,20,280,280,0,0
21553,2019-06-04,334,0,334,26,360,360,0,0
21554,2019-06-04,772,-164,608,48,656,656,0,0
21555,2019-06-05,112,0,112,8,120,120,0,0
21556,2019-06-05,908,0,908,72,980,980,0,0
21557,2019-06-05,778,0,778,62,840,840,0,0
21558,2019-06-05,176,0,176,14,190,190,0,0
21559,2019-06-05,334,0,334,26,360,360,0,0
21560,2019-06-05,445,0,445,35,480,480,0,0
21561,2019-06-05,1436,0,1436,114,1550,1550,0,0
21562,2019-06-05,852,0,852,68,920,920,0,0
21563,2019-06-05,626,-67,559,44,603,603,0,0
21564,2019-06-05,852,0,852,68,920,920,0,0
21565,2019-06-05,2723,0,2723,217,2940,2940,0,0
21566,2019-06-05,926,0,926,74,1000,1000,0,0
21567,2019-06-05,232,0,232,18,250,250,0,0
21568,2019-06-05,1149,0,1149,91,1240,1240,0,0
21569,2019-06-05,982,0,982,78,1060,1060,0,0
21570,2019-06-05,371,0,371,29,400,400,0,0
21571,2019-06-05,936,0,936,74,1010,1010,0,0
21572,2019-06-05,1394,0,1394,76,1470,1470,0,0
21573,2019-06-05,315,0,315,25,340,340,0,0
21574,2019-06-05,389,0,389,31,420,420,0,0
21575,2019-06-05,445,0,445,35,480,480,0,0
21576,2019-06-05,260,0,260,20,280,280,0,0
21577,2019-06-05,695,0,695,55,750,750,0,0
21578,2019-06-05,371,0,371,29,400,400,0,0
21579,2019-06-05,753,-160,593,47,640,640,0,0
21580,2019-06-05,1269,0,1269,101,1370,1370,0,0
21581,2019-06-05,601,0,601,39,640,640,0,0
21582,2019-06-05,852,0,852,68,920,920,0,0
21583,2019-06-05,509,0,509,31,540,540,0,0
21584,2019-06-05,667,0,667,53,720,720,0,0
21585,2019-06-05,269,0,269,21,290,290,0,0
21586,2019-06-05,389,0,389,31,420,420,0,0
21587,2019-06-05,1139,0,1139,91,1230,1230,0,0
21588,2019-06-05,491,0,491,39,530,530,0,0
21589,2019-06-05,1815,0,1815,145,1960,1960,0,0
21590,2019-06-05,556,0,556,44,600,600,0,0
21591,2019-06-05,621,0,621,49,670,670,0,0
21592,2019-06-05,297,0,297,23,320,320,0,0
21593,2019-06-05,899,0,899,71,970,970,0,0
21594,2019-06-05,195,0,195,15,210,210,0,0
21595,2019-06-05,454,0,454,36,490,490,0,0
21596,2019-06-05,788,0,788,62,850,850,0,0
21597,2019-06-05,491,0,491,39,530,530,0,0
21598,2019-06-05,251,0,251,19,270,270,0,0
21599,2019-06-05,399,0,399,31,430,430,0,0
21600,2019-06-05,1575,0,1575,125,1700,1700,0,0
21601,2019-06-05,232,0,232,18,250,250,0,0
21602,2019-06-05,1584,0,1584,126,1710,1710,0,0
21603,2019-06-05,321,0,321,25,346,346,0,0
21604,2019-06-05,308,-33,275,22,297,297,0,0
21605,2019-06-05,371,0,371,29,400,400,0,0
21606,2019-06-05,704,0,704,56,760,760,0,0
21607,2019-06-05,102,0,102,8,110,110,0,0
21608,2019-06-05,823,0,823,57,880,880,0,0
21609,2019-06-05,760,0,760,60,820,820,0,0
21610,2019-06-05,1871,0,1871,149,2020,2020,0,0
21611,2019-06-05,1121,0,1121,89,1210,1210,0,0
21612,2019-06-05,2612,0,2612,208,2820,2820,0,0
21613,2019-06-05,1362,0,1362,108,1470,1470,0,0
21614,2019-06-05,593,0,593,47,640,640,0,0
21615,2019-06-05,741,0,741,59,800,800,0,0
21616,2019-06-05,1028,0,1028,82,1110,1110,0,0
21617,2019-06-05,445,0,445,35,480,480,0,0
21618,2019-06-05,936,0,936,74,1010,1010,0,0
21619,2019-06-05,880,0,880,70,950,950,0,0
21620,2019-06-05,788,0,788,62,850,850,0,0
21621,2019-06-05,1278,0,1278,102,1380,1380,0,0
21622,2019-06-05,538,0,538,42,580,580,0,0
21623,2019-06-05,288,0,288,22,310,310,0,0
21624,2019-06-06,749,0,749,51,800,800,0,0
21625,2019-06-06,1667,0,1667,133,1800,1800,0,0
21626,2019-06-06,1769,0,1769,141,1910,1910,0,0
21627,2019-06-06,825,0,825,65,890,890,0,0
21628,2019-06-06,556,0,556,44,600,600,0,0
21629,2019-06-06,973,0,973,77,1050,1050,0,0
21630,2019-06-06,305,0,305,15,320,320,0,0
21631,2019-06-06,1556,0,1556,124,1680,1680,0,0
21632,2019-06-06,713,0,713,57,770,770,0,0
21633,2019-06-06,1783,-191,1592,127,1719,1719,0,0
21634,2019-06-06,2454,0,2454,196,2650,0,2650,0
21635,2019-06-06,667,0,667,53,720,720,0,0
21636,2019-06-06,973,0,973,77,1050,1050,0,0
21637,2019-06-06,297,0,297,23,320,320,0,0
21638,2019-06-06,667,0,667,53,720,720,0,0
21639,2019-06-06,1436,0,1436,114,1550,1550,0,0
21640,2019-06-06,1815,0,1815,145,1960,1960,0,0
21641,2019-06-06,389,0,389,31,420,420,0,0
21642,2019-06-06,741,0,741,59,800,800,0,0
21643,2019-06-06,334,0,334,26,360,360,0,0
21644,2019-06-06,1899,0,1899,151,2050,2050,0,0
21645,2019-06-06,445,0,445,35,480,480,0,0
21646,2019-06-06,306,0,306,24,330,330,0,0
21647,2019-06-06,788,0,788,62,850,850,0,0
21648,2019-06-06,676,0,676,54,730,730,0,0
21649,2019-06-06,825,0,825,65,890,890,0,0
21650,2019-06-06,676,0,676,54,730,730,0,0
21651,2019-06-06,656,0,656,34,690,690,0,0
21652,2019-06-06,1463,0,1463,117,1580,1580,0,0
21653,2019-06-06,231,0,231,9,240,0,240,0
21654,2019-06-06,-249,0,-249,-11,-260,0,0,-260
21655,2019-06-06,249,0,249,11,260,0,0,260
21656,2019-06-06,556,0,556,44,600,600,0,0
21657,2019-06-06,325,0,325,25,350,350,0,0
21658,2019-06-06,1445,0,1445,115,1560,1560,0,0
21659,2019-06-06,260,0,260,20,280,280,0,0
21660,2019-06-06,463,0,463,37,500,500,0,0
21661,2019-06-06,908,0,908,72,980,980,0,0
21662,2019-06-06,1102,0,1102,88,1190,1190,0,0
21663,2019-06-06,908,0,908,72,980,980,0,0
21664,2019-06-06,788,0,788,62,850,850,0,0
21665,2019-06-06,1121,0,1121,89,1210,1210,0,0
21666,2019-06-06,277,0,277,13,290,290,0,0
21667,2019-06-06,1047,0,1047,83,1130,1130,0,0
21668,2019-06-06,315,0,315,25,340,340,0,0
21669,2019-06-06,399,0,399,31,430,0,430,0
21670,2019-06-06,269,0,269,21,290,290,0,0
21671,2019-06-06,250,0,250,20,270,270,0,0
21672,2019-06-06,371,0,371,29,400,400,0,0
21673,2019-06-06,250,0,250,20,270,270,0,0
21674,2019-06-06,815,0,815,65,880,880,0,0
21675,2019-06-06,436,0,436,34,470,470,0,0
21676,2019-06-06,1815,0,1815,145,1960,1960,0,0
21677,2019-06-06,176,0,176,14,190,190,0,0
21678,2019-06-06,519,0,519,41,560,560,0,0
21679,2019-06-06,528,0,528,42,570,570,0,0
21680,2019-06-06,612,0,612,48,660,660,0,0
21681,2019-06-06,584,0,584,46,630,630,0,0
21682,2019-06-06,1251,0,1251,99,1350,1350,0,0
21683,2019-06-06,667,0,667,53,720,720,0,0
21684,2019-06-06,436,0,436,34,470,470,0,0
21685,2019-06-06,518,0,518,32,550,550,0,0
21686,2019-06-06,713,0,713,57,770,770,0,0
21687,2019-06-06,649,0,649,51,700,700,0,0
21688,2019-06-06,408,0,408,32,440,440,0,0
21689,2019-06-06,514,-55,459,36,495,495,0,0
21690,2019-06-06,176,0,176,14,190,190,0,0
21691,2019-06-06,176,0,176,14,190,190,0,0
21692,2019-06-06,538,0,538,42,580,580,0,0
21693,2019-06-06,288,0,288,22,310,310,0,0
21694,2019-06-06,473,0,473,37,510,510,0,0
21695,2019-06-06,260,0,260,20,280,280,0,0
21696,2019-06-06,473,0,473,37,510,510,0,0
21697,2019-06-06,2639,0,2639,211,2850,2850,0,0
21698,2019-06-06,2334,0,2334,186,2520,2520,0,0
21699,2019-06-06,1973,0,1973,157,2130,2130,0,0
21700,2019-06-06,1056,0,1056,84,1140,0,1140,0
21701,2019-06-06,547,0,547,43,590,590,0,0
21702,2019-06-06,556,0,556,44,600,600,0,0
21703,2019-06-06,399,0,399,31,430,430,0,0
21704,2019-06-06,3176,0,3176,254,3430,3430,0,0
21705,2019-06-06,991,0,991,79,1070,1070,0,0
21706,2019-06-06,380,0,380,30,410,410,0,0
21707,2019-06-06,343,0,343,27,370,370,0,0
21708,2019-06-06,417,0,417,33,450,450,0,0
21709,2019-06-06,547,0,547,43,590,590,0,0
21710,2019-06-06,732,0,732,58,790,790,0,0
21711,2019-06-06,1852,0,1852,148,2000,2000,0,0
21712,2019-06-06,862,0,862,68,930,930,0,0
21713,2019-06-06,1038,0,1038,82,1120,1120,0,0
21714,2019-06-06,102,0,102,8,110,110,0,0
21715,2019-06-06,1019,0,1019,81,1100,1100,0,0
21716,2019-06-06,334,0,334,26,360,360,0,0
21717,2019-06-06,573,0,573,37,610,610,0,0
21718,2019-06-06,788,0,788,62,850,850,0,0
21719,2019-06-06,704,0,704,56,760,760,0,0
21720,2019-06-06,-788,0,-788,-62,-850,-850,0,0
21721,2019-06-06,788,0,788,62,850,0,850,0
21722,2019-06-06,788,0,788,62,850,850,0,0
21723,2019-06-06,399,0,399,31,430,430,0,0
21724,2019-06-06,1343,0,1343,107,1450,1450,0,0
21725,2019-06-06,760,0,760,60,820,820,0,0
21726,2019-06-06,2583,0,2583,197,2780,2780,0,0
21727,2019-06-06,510,0,510,40,550,550,0,0
21728,2019-06-06,788,0,788,62,850,850,0,0
21729,2019-06-06,445,0,445,35,480,480,0,0
21730,2019-06-06,1075,0,1075,85,1160,1160,0,0
21731,2019-06-06,565,0,565,45,610,610,0,0
21732,2019-06-06,277,0,277,13,290,290,0,0
21733,2019-06-06,371,0,371,29,400,400,0,0
21734,2019-06-06,236,-50,186,14,200,200,0,0
21735,2019-06-06,167,0,167,13,180,180,0,0
21736,2019-06-06,1038,0,1038,82,1120,1120,0,0
21737,2019-06-06,676,0,676,54,730,730,0,0
21738,2019-06-06,223,0,223,17,240,240,0,0
21739,2019-06-06,788,0,788,62,850,850,0,0
21740,2019-06-06,788,0,788,62,850,850,0,0
21741,2019-06-07,732,0,732,58,790,790,0,0
21742,2019-06-07,2232,0,2232,178,2410,2410,0,0
21743,2019-06-07,704,0,704,56,760,760,0,0
21744,2019-06-07,1815,0,1815,145,1960,1960,0,0
21745,2019-06-07,1065,0,1065,85,1150,1150,0,0
21746,2019-06-07,686,0,686,54,740,740,0,0
21747,2019-06-07,658,0,658,52,710,710,0,0
21748,2019-06-07,1830,-196,1634,130,1764,1764,0,0
21749,2019-06-07,1445,0,1445,115,1560,1560,0,0
21750,2019-06-07,2380,0,2380,190,2570,2570,0,0
21751,2019-06-07,565,0,565,45,610,610,0,0
21752,2019-06-07,991,0,991,79,1070,1070,0,0
21753,2019-06-07,473,0,473,37,510,510,0,0
21754,2019-06-07,1046,0,1046,74,1120,1120,0,0
21755,2019-06-07,1047,0,1047,83,1130,1130,0,0
21756,2019-06-07,657,0,657,43,700,700,0,0
21757,2019-06-07,501,0,501,39,540,540,0,0
21758,2019-06-07,704,0,704,56,760,760,0,0
21759,2019-06-07,825,0,825,65,890,890,0,0
21760,2019-06-07,654,-70,584,46,630,630,0,0
21761,2019-06-07,1832,0,1832,128,1960,1960,0,0
21762,2019-06-07,1593,0,1593,127,1720,0,1720,0
21763,2019-06-07,551,-59,492,39,531,531,0,0
21764,2019-06-07,1538,0,1538,122,1660,1660,0,0
21765,2019-06-07,862,0,862,68,930,930,0,0
21766,2019-06-07,908,0,908,72,980,980,0,0
21767,2019-06-07,676,0,676,54,730,730,0,0
21768,2019-06-07,908,0,908,72,980,980,0,0
21769,2019-06-07,1815,0,1815,145,1960,1960,0,0
21770,2019-06-07,553,0,553,17,570,570,0,0
21771,2019-06-07,519,0,519,41,560,560,0,0
21772,2019-06-07,2017,-216,1801,143,1944,1944,0,0
21773,2019-06-07,908,0,908,72,980,980,0,0
21774,2019-06-07,917,0,917,73,990,990,0,0
21775,2019-06-07,1028,0,1028,82,1110,1110,0,0
21776,2019-06-07,1269,0,1269,101,1370,1370,0,0
21777,2019-06-07,907,0,907,63,970,970,0,0
21778,2019-06-07,797,0,797,63,860,860,0,0
21779,2019-06-07,778,0,778,62,840,840,0,0
21780,2019-06-07,751,0,751,59,810,810,0,0
21781,2019-06-07,973,0,973,77,1050,1050,0,0
21782,2019-06-07,315,0,315,25,340,340,0,0
21783,2019-06-07,630,0,630,50,680,680,0,0
21784,2019-06-07,1788,0,1788,142,1930,1930,0,0
21785,2019-06-07,1436,0,1436,114,1550,1550,0,0
21786,2019-06-07,954,0,954,76,1030,1030,0,0
21787,2019-06-07,528,0,528,42,570,570,0,0
21788,2019-06-07,565,0,565,45,610,610,0,0
21789,2019-06-07,1325,0,1325,105,1430,1430,0,0
21790,2019-06-07,325,0,325,25,350,350,0,0
21791,2019-06-07,315,0,315,25,340,340,0,0
21792,2019-06-07,1547,0,1547,123,1670,1670,0,0
21793,2019-06-07,575,0,575,45,620,620,0,0
21794,2019-06-07,269,0,269,21,290,290,0,0
21795,2019-06-07,1065,0,1065,85,1150,1150,0,0
21796,2019-06-07,656,0,656,34,690,690,0,0
21797,2019-06-07,538,0,538,42,580,580,0,0
21798,2019-06-07,425,0,425,25,450,450,0,0
21799,2019-06-07,1815,0,1815,145,1960,1960,0,0
21800,2019-06-07,1830,-196,1634,130,1764,1764,0,0
21801,2019-06-07,751,0,751,59,810,810,0,0
21802,2019-06-07,1195,0,1195,95,1290,1290,0,0
21803,2019-06-07,2278,0,2278,182,2460,2460,0,0
21804,2019-06-07,149,0,149,11,160,160,0,0
21805,2019-06-07,686,0,686,54,740,740,0,0
21806,2019-06-07,751,0,751,59,810,810,0,0
21807,2019-06-07,362,0,362,28,390,390,0,0
21808,2019-06-07,-364,39,-325,-26,-351,-351,0,0
21809,2019-06-07,-362,0,-362,-28,-390,-390,0,0
21810,2019-06-07,364,-39,325,26,351,351,0,0
21811,2019-06-07,250,0,250,20,270,270,0,0
21812,2019-06-07,686,0,686,54,740,740,0,0
21813,2019-06-07,732,0,732,58,790,790,0,0
21814,2019-06-07,473,0,473,37,510,510,0,0
21815,2019-06-07,364,-39,325,26,351,351,0,0
21816,2019-06-07,269,0,269,21,290,290,0,0
21817,2019-06-07,788,0,788,62,850,850,0,0
21818,2019-06-07,1575,0,1575,125,1700,1700,0,0
21819,2019-06-07,334,0,334,26,360,360,0,0
21820,2019-06-07,260,0,260,20,280,0,0,280
21821,2019-06-07,167,0,167,13,180,180,0,0
21822,2019-06-07,-260,0,-260,-20,-280,0,0,-280
21823,2019-06-07,408,0,408,32,440,440,0,0
21824,2019-06-07,713,0,713,57,770,770,0,0
21825,2019-06-07,176,0,176,14,190,190,0,0
21826,2019-06-07,1000,0,1000,80,1080,1080,0,0
21827,2019-06-07,514,0,514,41,555,555,0,0
21828,2019-06-07,260,0,260,20,280,0,0,280
21829,2019-06-07,463,0,463,37,500,0,0,500
21830,2019-06-07,-463,0,-463,-37,-500,0,0,-500
21831,2019-06-07,-260,0,-260,-20,-280,0,0,-280
21832,2019-06-07,667,0,667,53,720,720,0,0
21833,2019-06-07,695,0,695,55,750,0,750,0
21834,2019-06-07,-362,0,-362,-28,-390,0,0,-390
21835,2019-06-07,362,0,362,28,390,0,0,390
21836,2019-06-07,-379,0,-379,-21,-400,0,0,-400
21837,2019-06-07,379,0,379,21,400,0,0,400
21838,2019-06-07,1815,0,1815,145,1960,1960,0,0
21839,2019-06-07,786,0,786,54,840,840,0,0
21840,2019-06-07,473,0,473,37,510,510,0,0
21841,2019-06-07,926,0,926,74,1000,1000,0,0
21842,2019-06-07,908,0,908,72,980,980,0,0
21843,2019-06-07,436,0,436,34,470,470,0,0
21844,2019-06-07,1815,0,1815,145,1960,0,1960,0
21845,2019-06-07,658,0,658,52,710,710,0,0
21846,2019-06-07,519,0,519,41,560,560,0,0
21847,2019-06-07,593,0,593,47,640,640,0,0
21848,2019-06-07,286,0,286,14,300,300,0,0
21849,2019-06-07,269,0,269,21,290,290,0,0
21850,2019-06-07,491,0,491,39,530,530,0,0
21851,2019-06-07,732,0,732,58,790,790,0,0
21852,2019-06-07,862,0,862,68,930,930,0,0
21853,2019-06-07,234,-25,209,16,225,225,0,0
21854,2019-06-07,232,0,232,18,250,250,0,0
21855,2019-06-07,703,0,703,47,750,0,750,0
21856,2019-06-07,371,0,371,29,400,400,0,0
21857,2019-06-07,788,0,788,62,850,850,0,0
21858,2019-06-07,277,0,277,13,290,290,0,0
21859,2019-06-07,426,0,426,34,460,460,0,0
21860,2019-06-07,788,0,788,62,850,850,0,0
21861,2019-06-07,889,0,889,71,960,960,0,0
21862,2019-06-07,788,0,788,62,850,850,0,0
21863,2019-06-07,732,0,732,58,790,790,0,0
21864,2019-06-07,510,0,510,40,550,550,0,0
21865,2019-06-07,584,0,584,46,630,630,0,0
21866,2019-06-07,1093,0,1093,87,1180,0,1180,0
21867,2019-06-07,1575,0,1575,125,1700,0,1700,0
21868,2019-06-07,417,0,417,33,450,450,0,0
21869,2019-06-07,1334,0,1334,106,1440,1440,0,0
21870,2019-06-07,408,0,408,32,440,440,0,0
21871,2019-06-07,2019,0,2019,161,2180,2180,0,0
21872,2019-06-07,1852,0,1852,148,2000,2000,0,0
21873,2019-06-07,760,0,760,60,820,820,0,0
21874,2019-06-07,482,0,482,38,520,520,0,0
21875,2019-06-07,1139,0,1139,91,1230,1230,0,0
21876,2019-06-07,371,0,371,29,400,400,0,0
21877,2019-06-07,1575,0,1575,125,1700,1700,0,0
21878,2019-06-07,741,0,741,59,800,800,0,0
21879,2019-06-07,482,0,482,38,520,520,0,0
21880,2019-06-07,788,0,788,62,850,850,0,0
21881,2019-06-07,945,0,945,75,1020,1020,0,0
21882,2019-06-07,806,0,806,64,870,870,0,0
21883,2019-06-07,1852,0,1852,148,2000,2000,0,0
21884,2019-06-07,1612,0,1612,128,1740,1740,0,0
21885,2019-06-07,639,0,639,51,690,690,0,0
21886,2019-06-07,306,0,306,24,330,330,0,0
21887,2019-06-07,417,0,417,33,450,450,0,0
21888,2019-06-07,417,0,417,33,450,450,0,0
21889,2019-06-07,306,0,306,24,330,330,0,0
21890,2019-06-07,704,0,704,56,760,760,0,0
21891,2019-06-07,612,0,612,48,660,660,0,0
21892,2019-06-07,1602,0,1602,128,1730,1730,0,0
21893,2019-06-07,654,-70,584,46,630,630,0,0
21894,2019-06-08,991,0,991,79,1070,1070,0,0
21895,2019-06-08,605,0,605,48,653,0,653,0
21896,2019-06-08,1195,0,1195,95,1290,1290,0,0
21897,2019-06-08,732,0,732,58,790,790,0,0
21898,2019-06-08,694,0,694,46,740,0,740,0
21899,2019-06-08,1815,0,1815,145,1960,1960,0,0
21900,2019-06-08,1305,0,1305,95,1400,1400,0,0
21901,2019-06-08,343,0,343,27,370,370,0,0
21902,2019-06-08,2222,-238,1984,158,2142,0,2142,0
21903,2019-06-08,1130,0,1130,90,1220,1220,0,0
21904,2019-06-08,676,0,676,54,730,730,0,0
21905,2019-06-08,528,0,528,42,570,570,0,0
21906,2019-06-08,936,0,936,74,1010,1010,0,0
21907,2019-06-08,1167,0,1167,93,1260,1260,0,0
21908,2019-06-08,2723,0,2723,217,2940,2940,0,0
21909,2019-06-08,815,0,815,65,880,880,0,0
21910,2019-06-08,908,0,908,72,980,980,0,0
21911,2019-06-08,1815,0,1815,145,1960,1960,0,0
21912,2019-06-08,334,0,334,26,360,360,0,0
21913,2019-06-08,915,-98,817,65,882,882,0,0
21914,2019-06-08,695,0,695,55,750,0,750,0
21915,2019-06-08,417,0,417,33,450,450,0,0
21916,2019-06-08,1815,0,1815,145,1960,1960,0,0
21917,2019-06-08,1315,0,1315,105,1420,1420,0,0
21918,2019-06-08,260,0,260,20,280,280,0,0
21919,2019-06-08,843,0,843,67,910,0,910,0
21920,2019-06-08,815,0,815,65,880,880,0,0
21921,2019-06-08,519,0,519,41,560,560,0,0
21922,2019-06-08,917,0,917,73,990,990,0,0
21923,2019-06-08,778,0,778,62,840,840,0,0
21924,2019-06-08,463,0,463,37,500,500,0,0
21925,2019-06-08,1075,0,1075,85,1160,1160,0,0
21926,2019-06-08,908,0,908,72,980,980,0,0
21927,2019-06-08,325,0,325,25,350,350,0,0
21928,2019-06-08,1204,0,1204,96,1300,1300,0,0
21929,2019-06-08,815,0,815,65,880,880,0,0
21930,2019-06-08,760,0,760,60,820,820,0,0
21931,2019-06-08,269,0,269,21,290,290,0,0
21932,2019-06-08,1389,0,1389,111,1500,1500,0,0
21933,2019-06-08,370,0,370,29,399,399,0,0
21934,2019-06-08,908,0,908,72,980,980,0,0
21935,2019-06-08,667,0,667,53,720,720,0,0
21936,2019-06-08,1102,0,1102,88,1190,1190,0,0
21937,2019-06-08,732,0,732,58,790,790,0,0
21938,2019-06-08,1399,0,1399,111,1510,0,1510,0
21939,2019-06-08,232,0,232,18,250,250,0,0
21940,2019-06-08,1815,0,1815,145,1960,1960,0,0
21941,2019-06-08,519,0,519,41,560,560,0,0
21942,2019-06-08,1851,0,1851,139,1990,1990,0,0
21943,2019-06-08,963,0,963,77,1040,1040,0,0
21944,2019-06-08,2093,0,2093,167,2260,2260,0,0
21945,2019-06-08,423,0,423,7,430,430,0,0
21946,2019-06-08,491,0,491,39,530,530,0,0
21947,2019-06-08,1056,0,1056,84,1140,1140,0,0
21948,2019-06-08,926,0,926,74,1000,1000,0,0
21949,2019-06-08,2723,0,2723,217,2940,2940,0,0
21950,2019-06-08,260,0,260,20,280,280,0,0
21951,2019-06-08,288,0,288,22,310,310,0,0
21952,2019-06-08,130,0,130,10,140,140,0,0
21953,2019-06-08,130,0,130,10,140,140,0,0
21954,2019-06-08,547,0,547,43,590,590,0,0
21955,2019-06-08,926,0,926,74,1000,1000,0,0
21956,2019-06-08,2056,0,2056,164,2220,2220,0,0
21957,2019-06-08,269,0,269,21,290,290,0,0
21958,2019-06-08,269,0,269,21,290,290,0,0
21959,2019-06-08,362,0,362,28,390,390,0,0
21960,2019-06-08,519,0,519,41,560,560,0,0
21961,2019-06-08,1649,0,1649,131,1780,1780,0,0
21962,2019-06-08,704,0,704,56,760,760,0,0
21963,2019-06-08,362,0,362,28,390,390,0,0
21964,2019-06-08,519,0,519,41,560,560,0,0
21965,2019-06-08,187,-20,167,13,180,180,0,0
21966,2019-06-08,501,0,501,39,540,540,0,0
21967,2019-06-08,269,0,269,21,290,290,0,0
21968,2019-06-08,788,0,788,62,850,850,0,0
21969,2019-06-08,667,0,667,53,720,720,0,0
21970,2019-06-08,1463,0,1463,117,1580,1580,0,0
21971,2019-06-08,463,0,463,37,500,500,0,0
21972,2019-06-08,667,0,667,53,720,720,0,0
21973,2019-06-08,547,0,547,43,590,590,0,0
21974,2019-06-08,834,0,834,66,900,900,0,0
21975,2019-06-08,1815,0,1815,145,1960,1960,0,0
21976,2019-06-08,149,0,149,11,160,160,0,0
21977,2019-06-08,371,0,371,29,400,400,0,0
21978,2019-06-08,575,0,575,45,620,620,0,0
21979,2019-06-08,713,0,713,57,770,770,0,0
21980,2019-06-08,713,0,713,57,770,770,0,0
21981,2019-06-08,510,0,510,40,550,550,0,0
21982,2019-06-08,1954,0,1954,156,2110,2110,0,0
21983,2019-06-08,371,0,371,29,400,400,0,0
21984,2019-06-08,1713,0,1713,137,1850,1850,0,0
21985,2019-06-08,565,0,565,45,610,610,0,0
21986,2019-06-08,1982,0,1982,158,2140,2140,0,0
21987,2019-06-08,2076,0,2076,166,2242,2242,0,0
21988,2019-06-08,788,0,788,62,850,850,0,0
21989,2019-06-08,1815,0,1815,145,1960,1960,0,0
21990,2019-06-08,1815,0,1815,145,1960,1960,0,0
21991,2019-06-08,871,0,871,69,940,0,940,0
21992,2019-06-08,1121,0,1121,89,1210,1210,0,0
21993,2019-06-08,871,0,871,69,940,940,0,0
21994,2019-06-08,454,0,454,36,490,490,0,0
21995,2019-06-08,889,0,889,71,960,960,0,0
21996,2019-06-08,1445,0,1445,115,1560,1560,0,0
21997,2019-06-08,482,0,482,38,520,520,0,0
21998,2019-06-08,538,0,538,42,580,580,0,0
21999,2019-06-08,260,0,260,20,280,280,0,0
22000,2019-06-08,417,0,417,33,450,450,0,0
22001,2019-06-08,908,0,908,72,980,980,0,0
22002,2019-06-08,908,0,908,72,980,980,0,0
22003,2019-06-08,278,0,278,22,300,300,0,0
22004,2019-06-08,501,0,501,39,540,540,0,0
22005,2019-06-08,1454,0,1454,116,1570,1570,0,0
22006,2019-06-08,501,0,501,39,540,540,0,0
22007,2019-06-08,1334,0,1334,106,1440,1440,0,0
22008,2019-06-08,612,0,612,48,660,660,0,0
22009,2019-06-08,2251,0,2251,179,2430,2430,0,0
22010,2019-06-08,491,0,491,39,530,530,0,0
22011,2019-06-08,491,0,491,39,530,530,0,0
22012,2019-06-08,1167,0,1167,93,1260,1260,0,0
22013,2019-06-08,343,0,343,27,370,370,0,0
22014,2019-06-08,1962,0,1962,148,2110,2110,0,0
22015,2019-06-08,880,0,880,70,950,950,0,0
22016,2019-06-08,1195,0,1195,95,1290,1290,0,0
22017,2019-06-08,510,0,510,40,550,550,0,0
22018,2019-06-08,232,0,232,18,250,250,0,0
22019,2019-06-08,1575,0,1575,125,1700,0,1700,0
22020,2019-06-08,593,0,593,47,640,640,0,0
22021,2019-06-08,538,0,538,42,580,580,0,0
22022,2019-06-08,3288,0,3288,262,3550,3550,0,0
22023,2019-06-08,1093,0,1093,87,1180,1180,0,0
22024,2019-06-08,389,0,389,31,420,420,0,0
22025,2019-06-08,306,0,306,24,330,330,0,0
22026,2019-06-08,667,0,667,53,720,720,0,0
22027,2019-06-08,1991,0,1991,159,2150,2150,0,0
22028,2019-06-08,945,0,945,75,1020,1020,0,0
22029,2019-06-08,556,0,556,44,600,600,0,0
22030,2019-06-08,602,0,602,48,650,650,0,0
22031,2019-06-08,269,0,269,21,290,290,0,0
22032,2019-06-08,519,0,519,41,560,560,0,0
22033,2019-06-08,482,0,482,38,520,520,0,0
22034,2019-06-08,186,0,186,14,200,200,0,0
22035,2019-06-08,584,0,584,46,630,630,0,0
22036,2019-06-08,278,0,278,22,300,300,0,0
22037,2019-06-08,751,0,751,59,810,810,0,0
22038,2019-06-08,352,0,352,28,380,380,0,0
22039,2019-06-08,1112,0,1112,88,1200,1200,0,0
22040,2019-06-08,1815,0,1815,145,1960,1960,0,0
22041,2019-06-08,167,0,167,13,180,180,0,0
22042,2019-06-08,1815,0,1815,145,1960,1960,0,0
22043,2019-06-08,399,0,399,31,430,430,0,0
22044,2019-06-08,760,0,760,60,820,820,0,0
22045,2019-06-08,399,0,399,31,430,430,0,0
22046,2019-06-08,399,0,399,31,430,430,0,0
22047,2019-06-08,436,0,436,34,470,470,0,0
22048,2019-06-08,602,0,602,48,650,650,0,0
22049,2019-06-08,278,0,278,22,300,300,0,0
22050,2019-06-08,741,0,741,59,800,800,0,0
22051,2019-06-08,936,0,936,74,1010,1010,0,0
22052,2019-06-08,1019,0,1019,81,1100,1100,0,0
22053,2019-06-08,232,0,232,18,250,250,0,0
22054,2019-06-08,260,0,260,20,280,280,0,0
22055,2019-06-08,973,0,973,77,1050,1050,0,0
22056,2019-06-08,167,0,167,13,180,180,0,0
22057,2019-06-08,167,0,167,13,180,180,0,0
22058,2019-06-08,797,0,797,63,860,860,0,0
22059,2019-06-08,769,0,769,61,830,830,0,0
22060,2019-06-08,176,0,176,14,190,190,0,0
22061,2019-06-08,538,0,538,42,580,580,0,0
22062,2019-06-08,1130,0,1130,90,1220,1220,0,0
22063,2019-06-08,473,0,473,37,510,510,0,0
22064,2019-06-08,389,0,389,31,420,420,0,0
22065,2019-06-08,371,0,371,29,400,400,0,0
22066,2019-06-08,751,0,751,59,810,810,0,0
22067,2019-06-08,732,0,732,58,790,790,0,0
22068,2019-06-08,1575,0,1575,125,1700,1700,0,0
22069,2019-06-08,788,0,788,62,850,850,0,0
22070,2019-06-08,788,0,788,62,850,850,0,0
22071,2019-06-08,176,0,176,14,190,190,0,0
22072,2019-06-08,695,0,695,55,750,750,0,0
22073,2019-06-08,788,0,788,62,850,850,0,0
22074,2019-06-08,2362,0,2362,188,2550,2550,0,0
22075,2019-06-08,621,0,621,49,670,670,0,0
22076,2019-06-08,1575,0,1575,125,1700,1700,0,0
22077,2019-06-08,695,0,695,55,750,750,0,0
22078,2019-06-08,306,0,306,24,330,330,0,0
22079,2019-06-08,925,0,925,65,990,990,0,0
22080,2019-06-08,1148,0,1148,82,1230,1230,0,0
22081,2019-06-08,380,0,380,30,410,410,0,0
22082,2019-06-08,1575,0,1575,125,1700,1700,0,0
22083,2019-06-08,889,0,889,71,960,960,0,0
22084,2019-06-08,1658,0,1658,132,1790,1790,0,0
22085,2019-06-08,704,0,704,56,760,760,0,0
22086,2019-06-08,482,0,482,38,520,520,0,0
22087,2019-06-08,638,0,638,42,680,680,0,0
22088,2019-06-08,972,0,972,68,1040,1040,0,0
22089,2019-06-08,575,0,575,45,620,620,0,0
22090,2019-06-08,723,0,723,57,780,780,0,0
22091,2019-06-08,288,0,288,22,310,310,0,0
22092,2019-06-08,1575,0,1575,125,1700,1700,0,0
22093,2019-06-08,362,0,362,28,390,390,0,0
22094,2019-06-08,510,0,510,40,550,550,0,0
22095,2019-06-08,769,0,769,61,830,830,0,0
22096,2019-06-08,334,0,334,26,360,360,0,0
22097,2019-06-08,825,0,825,65,890,890,0,0
22098,2019-06-08,538,0,538,42,580,580,0,0
22099,2019-06-08,584,0,584,46,630,630,0,0
22100,2019-06-08,547,0,547,43,590,590,0,0
22101,2019-06-08,621,0,621,49,670,670,0,0
22102,2019-06-08,167,0,167,13,180,180,0,0
22103,2019-06-08,399,0,399,31,430,430,0,0
22104,2019-06-08,510,0,510,40,550,550,0,0
22105,2019-06-08,408,0,408,32,440,0,440,0
22106,2019-06-08,278,0,278,22,300,300,0,0
22107,2019-06-08,491,0,491,39,530,0,530,0
22108,2019-06-08,1278,0,1278,102,1380,1380,0,0
22109,2019-06-08,380,0,380,30,410,0,410,0
22110,2019-06-08,788,0,788,62,850,850,0,0
22111,2019-06-08,788,0,788,62,850,850,0,0
22112,2019-06-08,1575,0,1575,125,1700,1700,0,0
22113,2019-06-08,3195,0,3195,255,3450,3450,0,0
22114,2019-06-08,3149,0,3149,251,3400,3400,0,0
22115,2019-06-08,1445,0,1445,115,1560,1560,0,0
22116,2019-06-08,362,0,362,28,390,390,0,0
22117,2019-06-08,269,0,269,21,290,290,0,0
22118,2019-06-08,278,0,278,22,300,300,0,0
22119,2019-06-08,1871,0,1871,149,2020,0,2020,0
22120,2019-06-09,982,0,982,78,1060,1060,0,0
22121,2019-06-09,1315,0,1315,105,1420,1420,0,0
22122,2019-06-09,2297,-246,2051,163,2214,2214,0,0
22123,2019-06-09,260,0,260,20,280,280,0,0
22124,2019-06-09,1815,0,1815,145,1960,1960,0,0
22125,2019-06-09,1167,0,1167,93,1260,1260,0,0
22126,2019-06-09,538,0,538,42,580,580,0,0
22127,2019-06-09,667,0,667,53,720,720,0,0
22128,2019-06-09,1158,0,1158,92,1250,1250,0,0
22129,2019-06-09,713,0,713,57,770,770,0,0
22130,2019-06-09,658,0,658,52,710,710,0,0
22131,2019-06-09,1815,0,1815,145,1960,1960,0,0
22132,2019-06-09,1815,0,1815,145,1960,1960,0,0
22133,2019-06-09,908,0,908,72,980,0,980,0
22134,2019-06-09,1167,0,1167,93,1260,1260,0,0
22135,2019-06-09,1575,0,1575,125,1700,1700,0,0
22136,2019-06-09,2130,0,2130,170,2300,2300,0,0
22137,2019-06-09,686,0,686,54,740,740,0,0
22138,2019-06-09,936,0,936,74,1010,1010,0,0
22139,2019-06-09,1575,0,1575,125,1700,1700,0,0
22140,2019-06-09,1629,0,1629,121,1750,1750,0,0
22141,2019-06-09,389,0,389,31,420,420,0,0
22142,2019-06-09,389,0,389,31,420,420,0,0
22143,2019-06-09,1038,0,1038,82,1120,1120,0,0
22144,2019-06-09,371,0,371,29,400,400,0,0
22145,2019-06-09,179,-38,141,11,152,152,0,0
22146,2019-06-09,1167,0,1167,93,1260,1260,0,0
22147,2019-06-09,963,0,963,77,1040,1040,0,0
22148,2019-06-09,1815,0,1815,145,1960,1960,0,0
22149,2019-06-09,667,0,667,53,720,720,0,0
22150,2019-06-09,945,0,945,75,1020,1020,0,0
22151,2019-06-09,1417,0,1417,113,1530,1530,0,0
22152,2019-06-09,658,0,658,52,710,710,0,0
22153,2019-06-09,389,0,389,31,420,0,420,0
22154,2019-06-09,1241,0,1241,99,1340,1340,0,0
22155,2019-06-09,788,0,788,62,850,850,0,0
22156,2019-06-09,179,-38,141,11,152,152,0,0
22157,2019-06-09,482,0,482,38,520,520,0,0
22158,2019-06-09,723,0,723,57,780,780,0,0
22159,2019-06-09,399,0,399,31,430,430,0,0
22160,2019-06-09,306,0,306,24,330,330,0,0
22161,2019-06-09,713,0,713,57,770,770,0,0
22162,2019-06-09,788,0,788,62,850,850,0,0
22163,2019-06-09,306,0,306,24,330,330,0,0
22164,2019-06-09,1815,0,1815,145,1960,0,1960,0
22165,2019-06-09,1815,0,1815,145,1960,1960,0,0
22166,2019-06-09,1547,0,1547,123,1670,1670,0,0
22167,2019-06-09,1343,0,1343,107,1450,1450,0,0
22168,2019-06-09,343,0,343,27,370,370,0,0
22169,2019-06-09,527,0,527,33,560,560,0,0
22170,2019-06-09,751,0,751,59,810,810,0,0
22171,2019-06-09,556,0,556,44,600,600,0,0
22172,2019-06-09,500,0,500,40,540,540,0,0
22173,2019-06-09,565,0,565,45,610,610,0,0
22174,2019-06-09,889,0,889,71,960,960,0,0
22175,2019-06-09,399,0,399,31,430,430,0,0
22176,2019-06-09,1056,0,1056,84,1140,1140,0,0
22177,2019-06-09,297,0,297,23,320,320,0,0
22178,2019-06-09,371,0,371,29,400,400,0,0
22179,2019-06-09,167,0,167,13,180,180,0,0
22180,2019-06-09,389,0,389,31,420,420,0,0
22181,2019-06-09,371,0,371,29,400,400,0,0
22182,2019-06-09,417,0,417,33,450,450,0,0
22183,2019-06-09,491,0,491,39,530,530,0,0
22184,2019-06-09,843,0,843,67,910,910,0,0
22185,2019-06-09,334,0,334,26,360,0,0,360
22186,2019-06-09,1538,0,1538,122,1660,1660,0,0
22187,2019-06-09,352,0,352,28,380,380,0,0
22188,2019-06-09,288,0,288,22,310,310,0,0
22189,2019-06-09,352,0,352,28,380,380,0,0
22190,2019-06-09,139,0,139,11,150,150,0,0
22191,2019-06-09,1047,0,1047,83,1130,1130,0,0
22192,2019-06-09,463,0,463,37,500,500,0,0
22193,2019-06-09,167,0,167,13,180,180,0,0
22194,2019-06-09,741,0,741,59,800,800,0,0
22195,2019-06-09,112,0,112,8,120,120,0,0
22196,2019-06-09,667,0,667,53,720,720,0,0
22197,2019-06-09,260,0,260,20,280,280,0,0
22198,2019-06-09,1371,0,1371,109,1480,1480,0,0
22199,2019-06-09,232,0,232,18,250,250,0,0
22200,2019-06-09,501,0,501,39,540,540,0,0
22201,2019-06-09,352,0,352,28,380,380,0,0
22202,2019-06-09,862,0,862,68,930,930,0,0
22203,2019-06-09,1362,0,1362,108,1470,1470,0,0
22204,2019-06-09,1158,0,1158,92,1250,1250,0,0
22205,2019-06-09,121,0,121,9,130,130,0,0
22206,2019-06-09,288,0,288,22,310,310,0,0
22207,2019-06-09,1075,0,1075,85,1160,1160,0,0
22208,2019-06-09,306,0,306,24,330,330,0,0
22209,2019-06-09,454,0,454,36,490,490,0,0
22210,2019-06-09,278,0,278,22,300,300,0,0
22211,2019-06-09,1575,0,1575,125,1700,1700,0,0
22212,2019-06-09,1575,0,1575,125,1700,1700,0,0
22213,2019-06-09,417,0,417,33,450,450,0,0
22214,2019-06-09,797,0,797,63,860,860,0,0
22215,2019-06-09,584,0,584,46,630,630,0,0
22216,2019-06-09,399,0,399,31,430,430,0,0
22217,2019-06-09,1065,0,1065,85,1150,0,0,1150
22218,2019-06-09,325,0,325,25,350,350,0,0
22219,2019-06-09,1065,0,1065,85,1150,1150,0,0
22220,2019-06-09,232,0,232,18,250,250,0,0
22221,2019-06-09,463,0,463,37,500,500,0,0
22222,2019-06-09,741,0,741,59,800,800,0,0
22223,2019-06-09,232,0,232,18,250,250,0,0
22224,2019-06-09,371,0,371,29,400,400,0,0
22225,2019-06-09,1575,0,1575,125,1700,0,1700,0
22226,2019-06-09,788,0,788,62,850,850,0,0
22227,2019-06-09,1575,0,1575,125,1700,1700,0,0
22228,2019-06-09,788,0,788,62,850,850,0,0
22229,2019-06-09,1213,0,1213,97,1310,1310,0,0
22230,2019-06-09,454,0,454,36,490,490,0,0
22231,2019-06-10,1815,0,1815,145,1960,1960,0,0
22232,2019-06-10,473,0,473,37,510,510,0,0
22233,2019-06-10,747,-80,667,53,720,720,0,0
22234,2019-06-10,408,0,408,32,440,440,0,0
22235,2019-06-10,704,0,704,56,760,760,0,0
22236,2019-06-10,251,0,251,19,270,270,0,0
22237,2019-06-10,501,0,501,39,540,540,0,0
22238,2019-06-10,908,0,908,72,980,980,0,0
22239,2019-06-10,473,0,473,37,510,510,0,0
22240,2019-06-10,501,0,501,39,540,540,0,0
22241,2019-06-10,149,0,149,11,160,160,0,0
22242,2019-06-10,527,0,527,33,560,560,0,0
22243,2019-06-10,1232,0,1232,98,1330,1330,0,0
22244,2019-06-10,575,0,575,45,620,620,0,0
22245,2019-06-10,1186,0,1186,94,1280,1280,0,0
22246,2019-06-10,565,0,565,45,610,610,0,0
22247,2019-06-10,362,0,362,28,390,390,0,0
22248,2019-06-10,936,0,936,74,1010,1010,0,0
22249,2019-06-10,1815,0,1815,145,1960,1960,0,0
22250,2019-06-10,389,0,389,31,420,420,0,0
22251,2019-06-10,1830,-196,1634,130,1764,0,1764,0
22252,2019-06-10,908,0,908,72,980,980,0,0
22253,2019-06-10,565,0,565,45,610,610,0,0
22254,2019-06-10,908,0,908,72,980,980,0,0
22255,2019-06-10,908,0,908,72,980,980,0,0
22256,2019-06-10,1010,0,1010,80,1090,1090,0,0
22257,2019-06-10,732,0,732,58,790,790,0,0
22258,2019-06-10,908,0,908,72,980,980,0,0
22259,2019-06-10,908,0,908,72,980,980,0,0
22260,2019-06-10,-269,0,-269,-21,-290,0,0,-290
22261,2019-06-10,-139,0,-139,-11,-150,0,0,-150
22262,2019-06-10,408,0,408,32,440,0,0,440
22263,2019-06-10,-110,0,-110,0,-110,0,0,-110
22264,2019-06-10,110,0,110,0,110,0,0,110
22265,2019-06-10,445,0,445,35,480,480,0,0
22266,2019-06-10,315,0,315,25,340,340,0,0
22267,2019-06-10,223,0,223,17,240,240,0,0
22268,2019-06-10,1232,0,1232,98,1330,1330,0,0
22269,2019-06-10,343,0,343,27,370,370,0,0
22270,2019-06-10,417,0,417,33,450,450,0,0
22271,2019-06-10,473,0,473,37,510,510,0,0
22272,2019-06-10,1010,0,1010,80,1090,1090,0,0
22273,2019-06-10,593,0,593,47,640,640,0,0
22274,2019-06-10,741,0,741,59,800,800,0,0
22275,2019-06-10,343,0,343,27,370,370,0,0
22276,2019-06-10,908,0,908,72,980,980,0,0
22277,2019-06-10,686,0,686,54,740,740,0,0
22278,2019-06-10,510,0,510,40,550,550,0,0
22279,2019-06-10,436,0,436,34,470,470,0,0
22280,2019-06-10,695,0,695,55,750,750,0,0
22281,2019-06-10,1815,0,1815,145,1960,1960,0,0
22282,2019-06-10,241,0,241,19,260,260,0,0
22283,2019-06-10,908,0,908,72,980,980,0,0
22284,2019-06-10,788,0,788,62,850,850,0,0
22285,2019-06-10,796,0,796,54,850,850,0,0
22286,2019-06-10,788,0,788,62,850,850,0,0
22287,2019-06-10,788,0,788,62,850,850,0,0
22288,2019-06-10,788,0,788,62,850,850,0,0
22289,2019-06-10,788,0,788,62,850,850,0,0
22290,2019-06-10,-102,0,-102,-8,-110,0,0,-110
22291,2019-06-10,102,0,102,8,110,0,0,110
22292,2019-06-10,751,0,751,59,810,810,0,0
22293,2019-06-10,436,0,436,34,470,470,0,0
22294,2019-06-10,547,0,547,43,590,590,0,0
22295,2019-06-10,704,0,704,56,760,760,0,0
22296,2019-06-10,862,0,862,68,930,930,0,0
22297,2019-06-10,3019,0,3019,241,3260,3260,0,0
22298,2019-06-10,1001,0,1001,79,1080,1080,0,0
22299,2019-06-10,232,0,232,18,250,250,0,0
22300,2019-06-10,139,0,139,11,150,150,0,0
22301,2019-06-10,1371,0,1371,109,1480,1480,0,0
22302,2019-06-10,638,0,638,42,680,680,0,0
22303,2019-06-10,723,0,723,57,780,780,0,0
22304,2019-06-10,315,0,315,25,340,340,0,0
22305,2019-06-10,870,0,870,60,930,930,0,0
22306,2019-06-10,908,0,908,72,980,980,0,0
22307,2019-06-10,186,0,186,14,200,200,0,0
22308,2019-06-10,788,0,788,62,850,850,0,0
22309,2019-06-10,584,0,584,46,630,630,0,0
22310,2019-06-10,251,0,251,19,270,270,0,0
22311,2019-06-10,1815,0,1815,145,1960,0,1960,0
22312,2019-06-10,423,0,423,7,430,430,0,0
22313,2019-06-10,1815,0,1815,145,1960,1960,0,0
22314,2019-06-10,778,0,778,62,840,840,0,0
22315,2019-06-10,491,0,491,39,530,530,0,0
22316,2019-06-10,1936,0,1936,154,2090,2090,0,0
22317,2019-06-10,1102,0,1102,88,1190,1190,0,0
22318,2019-06-10,926,0,926,74,1000,1000,0,0
22319,2019-06-10,1019,0,1019,81,1100,1100,0,0
22320,2019-06-10,751,0,751,59,810,810,0,0
22321,2019-06-10,667,0,667,53,720,720,0,0
22322,2019-06-10,519,0,519,41,560,560,0,0
22323,2019-06-10,908,0,908,72,980,980,0,0
22324,2019-06-10,556,0,556,44,600,600,0,0
22325,2019-06-10,506,0,506,14,520,520,0,0
22326,2019-06-10,232,0,232,18,250,250,0,0
22327,2019-06-10,732,0,732,58,790,0,790,0
22328,2019-06-10,232,0,232,18,250,250,0,0
22329,2019-06-10,723,0,723,57,780,780,0,0
22330,2019-06-10,371,0,371,29,400,400,0,0
22331,2019-06-10,602,0,602,48,650,650,0,0
22332,2019-06-10,463,0,463,37,500,500,0,0
22333,2019-06-10,788,0,788,62,850,850,0,0
22334,2019-06-10,56,0,56,4,60,60,0,0
22335,2019-06-10,334,0,334,26,360,360,0,0
22336,2019-06-11,676,0,676,54,730,730,0,0
22337,2019-06-11,2139,0,2139,171,2310,2310,0,0
22338,2019-06-11,297,0,297,23,320,320,0,0
22339,2019-06-11,260,0,260,20,280,280,0,0
22340,2019-06-11,4140,-880,3260,260,3520,3520,0,0
22341,2019-06-11,399,0,399,31,430,430,0,0
22342,2019-06-11,686,0,686,54,740,740,0,0
22343,2019-06-11,-110,0,-110,0,-110,0,-110,0
22344,2019-06-11,1658,0,1658,132,1790,1790,0,0
22345,2019-06-11,260,0,260,20,280,280,0,0
22346,2019-06-11,1028,0,1028,82,1110,1110,0,0
22347,2019-06-11,110,0,110,0,110,0,110,0
22348,2019-06-11,537,0,537,43,580,580,0,0
22349,2019-06-11,528,0,528,42,570,570,0,0
22350,2019-06-11,321,0,321,25,346,346,0,0
22351,2019-06-11,843,0,843,67,910,910,0,0
22352,2019-06-11,584,0,584,46,630,630,0,0
22353,2019-06-11,538,0,538,42,580,580,0,0
22354,2019-06-11,1010,0,1010,80,1090,1090,0,0
22355,2019-06-11,593,0,593,47,640,640,0,0
22356,2019-06-11,491,0,491,39,530,530,0,0
22357,2019-06-11,269,0,269,21,290,290,0,0
22358,2019-06-11,1038,0,1038,82,1120,1120,0,0
22359,2019-06-11,501,0,501,39,540,0,540,0
22360,2019-06-11,797,0,797,63,860,860,0,0
22361,2019-06-11,1130,0,1130,90,1220,0,1220,0
22362,2019-06-11,639,0,639,51,690,690,0,0
22363,2019-06-11,491,0,491,39,530,530,0,0
22364,2019-06-11,862,0,862,68,930,930,0,0
22365,2019-06-11,862,0,862,68,930,930,0,0
22366,2019-06-11,408,0,408,32,440,440,0,0
22367,2019-06-11,658,0,658,52,710,710,0,0
22368,2019-06-11,371,0,371,29,400,400,0,0
22369,2019-06-11,741,0,741,59,800,800,0,0
22370,2019-06-11,602,0,602,48,650,650,0,0
22371,2019-06-11,288,0,288,22,310,310,0,0
22372,2019-06-11,482,0,482,38,520,520,0,0
22373,2019-06-11,399,0,399,31,430,430,0,0
22374,2019-06-12,565,0,565,45,610,610,0,0
22375,2019-06-12,1417,0,1417,113,1530,1530,0,0
22376,2019-06-12,612,0,612,48,660,660,0,0
22377,2019-06-12,102,0,102,8,110,110,0,0
22378,2019-06-12,567,-19,548,43,591,591,0,0
22379,2019-06-12,908,0,908,72,980,980,0,0
22380,2019-06-12,315,0,315,25,340,340,0,0
22381,2019-06-12,749,0,749,51,800,800,0,0
22382,2019-06-12,269,0,269,21,290,290,0,0
22383,2019-06-12,1501,0,1501,119,1620,1620,0,0
22384,2019-06-12,908,0,908,72,980,980,0,0
22385,2019-06-12,908,0,908,72,980,980,0,0
22386,2019-06-12,380,0,380,30,410,410,0,0
22387,2019-06-12,1815,0,1815,145,1960,1960,0,0
22388,2019-06-12,500,0,500,40,540,540,0,0
22389,2019-06-12,473,0,473,37,510,510,0,0
22390,2019-06-12,612,0,612,48,660,660,0,0
22391,2019-06-12,389,0,389,31,420,420,0,0
22392,2019-06-12,908,0,908,72,980,980,0,0
22393,2019-06-12,991,0,991,79,1070,1070,0,0
22394,2019-06-12,713,0,713,57,770,770,0,0
22395,2019-06-12,426,0,426,34,460,460,0,0
22396,2019-06-12,686,0,686,54,740,740,0,0
22397,2019-06-12,1149,0,1149,91,1240,1240,0,0
22398,2019-06-12,908,0,908,72,980,980,0,0
22399,2019-06-12,2388,0,2388,182,2570,0,2570,0
22400,2019-06-12,908,0,908,72,980,980,0,0
22401,2019-06-12,908,0,908,72,980,980,0,0
22402,2019-06-12,1130,0,1130,90,1220,1220,0,0
22403,2019-06-12,908,0,908,72,980,980,0,0
22404,2019-06-12,315,0,315,25,340,340,0,0
22405,2019-06-12,269,0,269,21,290,290,0,0
22406,2019-06-12,334,0,334,26,360,360,0,0
22407,2019-06-12,204,0,204,16,220,220,0,0
22408,2019-06-12,380,0,380,30,410,410,0,0
22409,2019-06-12,1815,0,1815,145,1960,1960,0,0
22410,2019-06-12,815,0,815,65,880,880,0,0
22411,2019-06-12,232,0,232,18,250,250,0,0
22412,2019-06-12,112,0,112,8,120,120,0,0
22413,2019-06-12,908,0,908,72,980,980,0,0
22414,2019-06-12,501,0,501,39,540,540,0,0
22415,2019-06-12,620,0,620,40,660,660,0,0
22416,2019-06-12,908,0,908,72,980,980,0,0
22417,2019-06-12,510,0,510,40,550,550,0,0
22418,2019-06-12,1815,0,1815,145,1960,1960,0,0
22419,2019-06-12,167,0,167,13,180,180,0,0
22420,2019-06-12,371,0,371,29,400,400,0,0
22421,2019-06-12,935,0,935,65,1000,1000,0,0
22422,2019-06-12,269,0,269,21,290,290,0,0
22423,2019-06-12,649,0,649,51,700,700,0,0
22424,2019-06-12,315,0,315,25,340,0,0,340
22425,2019-06-12,176,0,176,14,190,190,0,0
22426,2019-06-12,491,0,491,39,530,530,0,0
22427,2019-06-12,713,0,713,57,770,770,0,0
22428,2019-06-12,499,-106,393,31,424,424,0,0
22429,2019-06-12,463,0,463,37,500,500,0,0
22430,2019-06-12,467,-50,417,33,450,450,0,0
22431,2019-06-12,788,0,788,62,850,850,0,0
22432,2019-06-12,389,0,389,31,420,420,0,0
22433,2019-06-12,788,0,788,62,850,850,0,0
22434,2019-06-12,510,0,510,40,550,550,0,0
22435,2019-06-12,500,0,500,40,540,540,0,0
22436,2019-06-12,788,0,788,62,850,850,0,0
22437,2019-06-12,788,0,788,62,850,850,0,0
22438,2019-06-12,1806,0,1806,144,1950,1950,0,0
22439,2019-06-12,1065,0,1065,85,1150,1150,0,0
22440,2019-06-12,1065,0,1065,85,1150,1150,0,0
22441,2019-06-12,991,0,991,79,1070,1070,0,0
22442,2019-06-12,417,0,417,33,450,450,0,0
22443,2019-06-12,547,0,547,43,590,590,0,0
22444,2019-06-12,56,0,56,4,60,60,0,0
22445,2019-06-12,788,0,788,62,850,850,0,0
22446,2019-06-12,204,0,204,16,220,220,0,0
22447,2019-06-12,315,0,315,25,340,340,0,0
22448,2019-06-12,334,0,334,26,360,360,0,0
22449,2019-06-12,825,0,825,65,890,890,0,0
22450,2019-06-12,778,0,778,62,840,840,0,0
22451,2019-06-12,286,0,286,14,300,300,0,0
22452,2019-06-12,1575,0,1575,125,1700,1700,0,0
22453,2019-06-12,788,0,788,62,850,850,0,0
22454,2019-06-12,917,0,917,73,990,990,0,0
22455,2019-06-12,788,0,788,62,850,850,0,0
22456,2019-06-12,362,0,362,28,390,390,0,0
22457,2019-06-12,1371,0,1371,109,1480,1480,0,0
22458,2019-06-12,510,0,510,40,550,550,0,0
22459,2019-06-12,463,0,463,37,500,500,0,0
22460,2019-06-12,788,0,788,62,850,850,0,0
22461,2019-06-12,1649,0,1649,131,1780,1780,0,0
22462,2019-06-12,232,0,232,18,250,250,0,0
22463,2019-06-12,741,0,741,59,800,800,0,0
22464,2019-06-12,575,0,575,45,620,620,0,0
22465,2019-06-12,675,0,675,45,720,720,0,0
22466,2019-06-12,788,0,788,62,850,850,0,0
22467,2019-06-12,936,0,936,74,1010,1010,0,0
22468,2019-06-12,1565,0,1565,125,1690,1690,0,0
22469,2019-06-12,2232,0,2232,178,2410,2410,0,0
22470,2019-06-12,667,0,667,53,720,720,0,0
22471,2019-06-12,2528,0,2528,202,2730,2730,0,0
22472,2019-06-12,1241,0,1241,99,1340,1340,0,0
22473,2019-06-12,686,0,686,54,740,740,0,0
22474,2019-06-12,1204,0,1204,96,1300,1300,0,0
22475,2019-06-12,167,0,167,13,180,180,0,0
22476,2019-06-12,1139,0,1139,91,1230,1230,0,0
22477,2019-06-12,110,0,110,0,110,0,0,110
22478,2019-06-12,-110,0,-110,0,-110,0,0,-110
22479,2019-06-12,1575,0,1575,125,1700,0,1700,0
22480,2019-06-12,797,0,797,63,860,860,0,0
22481,2019-06-12,1158,0,1158,92,1250,1250,0,0
22482,2019-06-12,399,0,399,31,430,430,0,0
22483,2019-06-12,1149,0,1149,91,1240,1240,0,0
22484,2019-06-12,667,0,667,53,720,720,0,0
22485,2019-06-12,1343,0,1343,107,1450,0,0,1450
22486,2019-06-12,1158,0,1158,92,1250,1250,0,0
22487,2019-06-12,1121,0,1121,89,1210,1210,0,0
22488,2019-06-12,399,0,399,31,430,430,0,0
22489,2019-06-12,1102,0,1102,88,1190,1190,0,0
22490,2019-06-13,556,0,556,44,600,600,0,0
22491,2019-06-13,399,0,399,31,430,430,0,0
22492,2019-06-13,343,0,343,27,370,370,0,0
22493,2019-06-13,1510,0,1510,120,1630,0,1630,0
22494,2019-06-13,417,0,417,33,450,450,0,0
22495,2019-06-13,612,0,612,48,660,660,0,0
22496,2019-06-13,139,0,139,11,150,150,0,0
22497,2019-06-13,797,0,797,63,860,860,0,0
22498,2019-06-13,1325,0,1325,105,1430,1430,0,0
22499,2019-06-13,399,0,399,31,430,430,0,0
22500,2019-06-13,-399,0,-399,-31,-430,-430,0,0
22501,2019-06-13,1482,0,1482,118,1600,1600,0,0
22502,2019-06-13,436,0,436,34,470,470,0,0
22503,2019-06-13,495,-53,442,35,477,477,0,0
22504,2019-06-13,602,0,602,48,650,650,0,0
22505,2019-06-13,751,0,751,59,810,810,0,0
22506,2019-06-13,306,0,306,24,330,330,0,0
22507,2019-06-13,778,0,778,62,840,840,0,0
22508,2019-06-13,399,0,399,31,430,430,0,0
22509,2019-06-13,1963,0,1963,157,2120,2120,0,0
22510,2019-06-13,908,0,908,72,980,980,0,0
22511,2019-06-13,362,0,362,28,390,390,0,0
22512,2019-06-13,528,0,528,42,570,570,0,0
22513,2019-06-13,584,0,584,46,630,630,0,0
22514,2019-06-13,1344,-144,1200,96,1296,1296,0,0
22515,2019-06-13,139,0,139,11,150,150,0,0
22516,2019-06-13,509,0,509,31,540,540,0,0
22517,2019-06-13,453,0,453,27,480,480,0,0
22518,2019-06-13,908,0,908,72,980,980,0,0
22519,2019-06-13,1815,0,1815,145,1960,1960,0,0
22520,2019-06-13,1223,0,1223,97,1320,1320,0,0
22521,2019-06-13,380,0,380,30,410,410,0,0
22522,2019-06-13,723,0,723,57,780,780,0,0
22523,2019-06-13,1019,0,1019,81,1100,1100,0,0
22524,2019-06-13,501,0,501,39,540,540,0,0
22525,2019-06-13,1815,0,1815,145,1960,1960,0,0
22526,2019-06-13,880,0,880,70,950,950,0,0
22527,2019-06-13,732,0,732,58,790,790,0,0
22528,2019-06-13,593,0,593,47,640,640,0,0
22529,2019-06-13,1444,0,1444,106,1550,1550,0,0
22530,2019-06-13,1815,0,1815,145,1960,1960,0,0
22531,2019-06-13,389,0,389,31,420,420,0,0
22532,2019-06-13,1221,0,1221,79,1300,1300,0,0
22533,2019-06-13,297,0,297,23,320,320,0,0
22534,2019-06-13,908,0,908,72,980,980,0,0
22535,2019-06-13,1426,0,1426,114,1540,1540,0,0
22536,2019-06-13,658,0,658,52,710,710,0,0
22537,2019-06-13,454,0,454,36,490,490,0,0
22538,2019-06-13,408,0,408,32,440,440,0,0
22539,2019-06-13,510,0,510,40,550,550,0,0
22540,2019-06-13,1346,-286,1060,84,1144,1144,0,0
22541,2019-06-13,915,-98,817,65,882,882,0,0
22542,2019-06-13,260,0,260,20,280,280,0,0
22543,2019-06-13,315,0,315,25,340,340,0,0
22544,2019-06-13,436,0,436,34,470,470,0,0
22545,2019-06-13,607,-65,542,43,585,585,0,0
22546,2019-06-13,213,0,213,17,230,230,0,0
22547,2019-06-13,871,0,871,69,940,940,0,0
22548,2019-06-13,426,0,426,34,460,460,0,0
22549,2019-06-13,343,0,343,27,370,370,0,0
22550,2019-06-13,444,0,444,26,470,470,0,0
22551,2019-06-13,426,0,426,34,460,460,0,0
22552,2019-06-13,167,0,167,13,180,180,0,0
22553,2019-06-13,954,0,954,76,1030,1030,0,0
22554,2019-06-13,371,0,371,29,400,400,0,0
22555,2019-06-13,446,-47,399,24,423,423,0,0
22556,2019-06-13,751,0,751,59,810,810,0,0
22557,2019-06-13,1047,0,1047,83,1130,1130,0,0
22558,2019-06-13,908,0,908,72,980,980,0,0
22559,2019-06-13,584,0,584,46,630,630,0,0
22560,2019-06-13,278,0,278,22,300,0,0,300
22561,2019-06-13,786,0,786,54,840,840,0,0
22562,2019-06-13,1047,0,1047,83,1130,1130,0,0
22563,2019-06-13,426,0,426,34,460,460,0,0
22564,2019-06-13,880,0,880,70,950,950,0,0
22565,2019-06-13,1593,0,1593,127,1720,1720,0,0
22566,2019-06-13,1494,-160,1334,106,1440,1440,0,0
22567,2019-06-13,288,0,288,22,310,310,0,0
22568,2019-06-13,584,0,584,46,630,630,0,0
22569,2019-06-13,908,0,908,72,980,980,0,0
22570,2019-06-13,908,0,908,72,980,980,0,0
22571,2019-06-13,584,0,584,46,630,630,0,0
22572,2019-06-13,1084,0,1084,86,1170,1170,0,0
22573,2019-06-13,1028,0,1028,82,1110,1110,0,0
22574,2019-06-13,843,0,843,67,910,910,0,0
22575,2019-06-13,667,0,667,53,720,720,0,0
22576,2019-06-13,371,0,371,29,400,400,0,0
22577,2019-06-13,102,0,102,8,110,110,0,0
22578,2019-06-13,222,0,222,8,230,230,0,0
22579,2019-06-13,371,0,371,29,400,400,0,0
22580,2019-06-13,954,0,954,76,1030,1030,0,0
22581,2019-06-13,417,0,417,33,450,450,0,0
22582,2019-06-13,1083,0,1083,77,1160,1160,0,0
22583,2019-06-13,510,0,510,40,550,550,0,0
22584,2019-06-13,676,0,676,54,730,730,0,0
22585,2019-06-13,139,0,139,11,150,150,0,0
22586,2019-06-13,260,0,260,20,280,280,0,0
22587,2019-06-13,639,0,639,51,690,690,0,0
22588,2019-06-13,121,0,121,9,130,130,0,0
22589,2019-06-13,325,0,325,25,350,350,0,0
22590,2019-06-13,158,0,158,12,170,170,0,0
22591,2019-06-13,417,0,417,33,450,0,450,0
22592,2019-06-13,149,0,149,11,160,160,0,0
22593,2019-06-13,399,0,399,31,430,430,0,0
22594,2019-06-13,620,0,620,40,660,660,0,0
22595,2019-06-13,399,0,399,31,430,430,0,0
22596,2019-06-13,389,0,389,31,420,420,0,0
22597,2019-06-13,260,0,260,20,280,280,0,0
22598,2019-06-13,788,0,788,62,850,850,0,0
22599,2019-06-13,1371,0,1371,109,1480,1480,0,0
22600,2019-06-13,573,0,573,37,610,610,0,0
22601,2019-06-13,445,0,445,35,480,480,0,0
22602,2019-06-13,399,0,399,31,430,430,0,0
22603,2019-06-13,260,0,260,20,280,280,0,0
22604,2019-06-13,954,0,954,76,1030,1030,0,0
22605,2019-06-13,1371,0,1371,109,1480,1480,0,0
22606,2019-06-13,676,0,676,54,730,730,0,0
22607,2019-06-13,1186,0,1186,94,1280,1280,0,0
22608,2019-06-13,2593,0,2593,207,2800,2800,0,0
22609,2019-06-13,538,0,538,42,580,580,0,0
22610,2019-06-13,565,0,565,45,610,610,0,0
22611,2019-06-13,1445,0,1445,115,1560,1560,0,0
22612,2019-06-13,806,0,806,64,870,870,0,0
22613,2019-06-13,778,0,778,62,840,840,0,0
22614,2019-06-13,139,0,139,11,150,150,0,0
22615,2019-06-13,741,0,741,59,800,800,0,0
22616,2019-06-13,260,0,260,20,280,280,0,0
22617,2019-06-13,352,0,352,28,380,380,0,0
22618,2019-06-13,936,0,936,74,1010,1010,0,0
22619,2019-06-13,620,0,620,40,660,660,0,0
22620,2019-06-13,112,0,112,8,120,120,0,0
22621,2019-06-13,491,0,491,39,530,530,0,0
22622,2019-06-13,260,0,260,20,280,280,0,0
22623,2019-06-13,649,0,649,51,700,700,0,0
22624,2019-06-13,2130,0,2130,170,2300,2300,0,0
22625,2019-06-13,269,0,269,21,290,290,0,0
22626,2019-06-13,389,0,389,31,420,420,0,0
22627,2019-06-13,1352,0,1352,108,1460,1460,0,0
22628,2019-06-13,1186,0,1186,94,1280,1280,0,0
22629,2019-06-13,139,0,139,11,150,150,0,0
22630,2019-06-13,676,0,676,54,730,730,0,0
22631,2019-06-13,389,0,389,31,420,420,0,0
22632,2019-06-13,1297,0,1297,103,1400,1400,0,0
22633,2019-06-13,389,0,389,31,420,420,0,0
22634,2019-06-13,389,0,389,31,420,420,0,0
22635,2019-06-13,371,0,371,29,400,400,0,0
22636,2019-06-13,425,0,425,25,450,450,0,0
22637,2019-06-13,871,0,871,69,940,940,0,0
22638,2019-06-13,654,-70,584,46,630,630,0,0
22639,2019-06-13,306,0,306,24,330,330,0,0
22640,2019-06-13,1075,0,1075,85,1160,1160,0,0
22641,2019-06-13,756,-81,675,54,729,729,0,0
22642,2019-06-13,2723,0,2723,217,2940,2940,0,0
22643,2019-06-13,899,0,899,71,970,970,0,0
22644,2019-06-13,788,0,788,62,850,850,0,0
22645,2019-06-13,501,0,501,39,540,540,0,0
22646,2019-06-13,2453,0,2453,187,2640,0,2640,0
22647,2019-06-13,112,0,112,8,120,120,0,0
22648,2019-06-13,1575,0,1575,125,1700,1700,0,0
22649,2019-06-13,658,0,658,52,710,710,0,0
22650,2019-06-13,1575,0,1575,125,1700,1700,0,0
22651,2019-06-13,667,0,667,53,720,720,0,0
22652,2019-06-13,334,0,334,26,360,360,0,0
22653,2019-06-13,1028,0,1028,82,1110,1110,0,0
22654,2019-06-13,186,0,186,14,200,200,0,0
22655,2019-06-13,888,0,888,62,950,950,0,0
22656,2019-06-13,695,0,695,55,750,750,0,0
22657,2019-06-13,1251,0,1251,99,1350,1350,0,0
22658,2019-06-13,788,0,788,62,850,850,0,0
22659,2019-06-13,963,0,963,77,1040,1040,0,0
22660,2019-06-13,768,0,768,52,820,820,0,0
22661,2019-06-13,954,0,954,76,1030,1030,0,0
22662,2019-06-13,834,0,834,66,900,900,0,0
22663,2019-06-13,741,0,741,59,800,800,0,0
22664,2019-06-13,463,0,463,37,500,500,0,0
22665,2019-06-13,315,0,315,25,340,340,0,0
22666,2019-06-13,371,0,371,29,400,400,0,0
22667,2019-06-13,232,0,232,18,250,250,0,0
22668,2019-06-13,538,0,538,42,580,580,0,0
22669,2019-06-13,579,-62,517,41,558,558,0,0
22670,2019-06-14,889,0,889,71,960,960,0,0
22671,2019-06-14,788,0,788,62,850,850,0,0
22672,2019-06-14,297,0,297,23,320,320,0,0
22673,2019-06-14,612,0,612,48,660,660,0,0
22674,2019-06-14,741,0,741,59,800,800,0,0
22675,2019-06-14,232,0,232,18,250,250,0,0
22676,2019-06-14,371,0,371,29,400,400,0,0
22677,2019-06-14,899,0,899,71,970,970,0,0
22678,2019-06-14,352,0,352,28,380,380,0,0
22679,2019-06-14,813,-87,726,57,783,783,0,0
22680,2019-06-14,612,0,612,48,660,660,0,0
22681,2019-06-14,806,0,806,64,870,870,0,0
22682,2019-06-14,843,0,843,67,910,910,0,0
22683,2019-06-14,1371,0,1371,109,1480,1480,0,0
22684,2019-06-14,658,0,658,52,710,710,0,0
22685,2019-06-14,1121,0,1121,89,1210,1210,0,0
22686,2019-06-14,786,0,786,54,840,840,0,0
22687,2019-06-14,806,0,806,64,870,870,0,0
22688,2019-06-14,1982,0,1982,158,2140,2140,0,0
22689,2019-06-14,241,0,241,19,260,260,0,0
22690,2019-06-14,908,0,908,72,980,980,0,0
22691,2019-06-14,1038,0,1038,82,1120,1120,0,0
22692,2019-06-14,954,0,954,76,1030,1030,0,0
22693,2019-06-14,936,0,936,74,1010,1010,0,0
22694,2019-06-14,426,0,426,34,460,460,0,0
22695,2019-06-14,2450,0,2450,160,2610,2610,0,0
22696,2019-06-14,528,0,528,42,570,570,0,0
22697,2019-06-14,667,0,667,53,720,720,0,0
22698,2019-06-14,1000,0,1000,80,1080,1080,0,0
22699,2019-06-14,1547,0,1547,123,1670,1670,0,0
22700,2019-06-14,834,0,834,66,900,900,0,0
22701,2019-06-14,593,0,593,47,640,640,0,0
22702,2019-06-14,473,0,473,37,510,510,0,0
22703,2019-06-14,1575,0,1575,125,1700,1700,0,0
22704,2019-06-14,426,0,426,34,460,460,0,0
22705,2019-06-14,676,0,676,54,730,730,0,0
22706,2019-06-14,1195,0,1195,95,1290,1290,0,0
22707,2019-06-14,380,0,380,30,410,410,0,0
22708,2019-06-14,747,-80,667,53,720,720,0,0
22709,2019-06-14,260,0,260,20,280,280,0,0
22710,2019-06-14,1815,0,1815,145,1960,1960,0,0
22711,2019-06-14,908,0,908,72,980,980,0,0
22712,2019-06-14,417,0,417,33,450,450,0,0
22713,2019-06-14,411,-44,367,29,396,396,0,0
22714,2019-06-14,318,-34,284,22,306,306,0,0
22715,2019-06-14,593,0,593,47,640,640,0,0
22716,2019-06-14,612,0,612,48,660,660,0,0
22717,2019-06-14,926,0,926,74,1000,1000,0,0
22718,2019-06-14,658,0,658,52,710,710,0,0
22719,2019-06-14,337,-36,301,23,324,324,0,0
22720,2019-06-14,741,0,741,59,800,800,0,0
22721,2019-06-14,1815,0,1815,145,1960,1960,0,0
22722,2019-06-14,936,0,936,74,1010,1010,0,0
22723,2019-06-14,519,0,519,41,560,560,0,0
22724,2019-06-14,234,-25,209,16,225,225,0,0
22725,2019-06-14,176,0,176,14,190,190,0,0
22726,2019-06-14,658,0,658,52,710,710,0,0
22727,2019-06-14,704,0,704,56,760,760,0,0
22728,2019-06-14,3006,-322,2684,214,2898,2898,0,0
22729,2019-06-14,277,0,277,13,290,290,0,0
22730,2019-06-14,2047,0,2047,163,2210,2210,0,0
22731,2019-06-14,2167,0,2167,173,2340,0,2340,0
22732,2019-06-14,491,0,491,39,530,530,0,0
22733,2019-06-14,621,0,621,49,670,670,0,0
22734,2019-06-14,621,0,621,49,670,670,0,0
22735,2019-06-14,-621,0,-621,-49,-670,-670,0,0
22736,2019-06-14,501,0,501,39,540,540,0,0
22737,2019-06-14,232,0,232,18,250,250,0,0
22738,2019-06-14,102,0,102,8,110,110,0,0
22739,2019-06-14,1575,0,1575,125,1700,0,1700,0
22740,2019-06-14,908,0,908,72,980,980,0,0
22741,2019-06-14,649,0,649,51,700,700,0,0
22742,2019-06-14,269,0,269,21,290,290,0,0
22743,2019-06-14,223,0,223,17,240,240,0,0
22744,2019-06-14,320,-68,252,20,272,0,0,272
22745,2019-06-14,834,0,834,66,900,900,0,0
22746,2019-06-14,463,0,463,37,500,500,0,0
22747,2019-06-14,195,0,195,15,210,210,0,0
22748,2019-06-14,399,0,399,31,430,430,0,0
22749,2019-06-14,362,0,362,28,390,390,0,0
22750,2019-06-14,325,0,325,25,350,350,0,0
22751,2019-06-14,501,0,501,39,540,540,0,0
22752,2019-06-14,501,0,501,39,540,540,0,0
22753,2019-06-14,334,0,334,26,360,360,0,0
22754,2019-06-14,769,0,769,61,830,830,0,0
22755,2019-06-14,297,0,297,23,320,320,0,0
22756,2019-06-14,491,0,491,39,530,530,0,0
22757,2019-06-14,362,0,362,28,390,390,0,0
22758,2019-06-14,908,0,908,72,980,980,0,0
22759,2019-06-14,223,0,223,17,240,240,0,0
22760,2019-06-14,260,0,260,20,280,280,0,0
22761,2019-06-14,1269,0,1269,101,1370,1370,0,0
22762,2019-06-14,908,0,908,72,980,980,0,0
22763,2019-06-14,908,0,908,72,980,980,0,0
22764,2019-06-14,362,0,362,28,390,390,0,0
22765,2019-06-14,195,0,195,15,210,210,0,0
22766,2019-06-14,908,0,908,72,980,980,0,0
22767,2019-06-14,1038,0,1038,82,1120,1120,0,0
22768,2019-06-14,915,-98,817,65,882,882,0,0
22769,2019-06-14,232,0,232,18,250,250,0,0
22770,2019-06-14,1149,0,1149,91,1240,1240,0,0
22771,2019-06-14,593,0,593,47,640,640,0,0
22772,2019-06-14,405,-86,319,25,344,344,0,0
22773,2019-06-14,649,0,649,51,700,700,0,0
22774,2019-06-14,139,0,139,11,150,150,0,0
22775,2019-06-14,880,0,880,70,950,950,0,0
22776,2019-06-14,167,0,167,13,180,180,0,0
22777,2019-06-14,704,0,704,56,760,760,0,0
22778,2019-06-14,167,0,167,13,180,180,0,0
22779,2019-06-14,1019,0,1019,81,1100,1100,0,0
22780,2019-06-14,1426,0,1426,114,1540,1540,0,0
22781,2019-06-14,1223,0,1223,97,1320,1320,0,0
22782,2019-06-14,510,0,510,40,550,550,0,0
22783,2019-06-14,463,0,463,37,500,500,0,0
22784,2019-06-14,695,0,695,55,750,750,0,0
22785,2019-06-14,440,0,440,0,440,440,0,0
22786,2019-06-14,149,0,149,11,160,160,0,0
22787,2019-06-14,936,0,936,74,1010,1010,0,0
22788,2019-06-14,288,0,288,22,310,310,0,0
22789,2019-06-14,1695,0,1695,135,1830,1830,0,0
22790,2019-06-14,500,0,500,40,540,540,0,0
22791,2019-06-14,1575,0,1575,125,1700,1700,0,0
22792,2019-06-14,1815,0,1815,145,1960,1960,0,0
22793,2019-06-14,538,0,538,42,580,580,0,0
22794,2019-06-14,1704,0,1704,136,1840,1840,0,0
22795,2019-06-14,1149,0,1149,91,1240,1240,0,0
22796,2019-06-14,556,0,556,44,600,600,0,0
22797,2019-06-14,788,0,788,62,850,0,850,0
22798,2019-06-14,538,0,538,42,580,0,0,580
22799,2019-06-14,908,0,908,72,980,980,0,0
22800,2019-06-14,213,0,213,17,230,230,0,0
22801,2019-06-14,778,0,778,62,840,840,0,0
22802,2019-06-14,861,0,861,59,920,920,0,0
22803,2019-06-14,1621,0,1621,129,1750,1750,0,0
22804,2019-06-14,704,0,704,56,760,760,0,0
22805,2019-06-14,584,0,584,46,630,630,0,0
22806,2019-06-14,788,0,788,62,850,850,0,0
22807,2019-06-14,843,0,843,67,910,910,0,0
22808,2019-06-14,482,0,482,38,520,0,0,520
22809,2019-06-15,1815,0,1815,145,1960,1960,0,0
22810,2019-06-15,1038,0,1038,82,1120,1120,0,0
22811,2019-06-15,1148,0,1148,82,1230,1230,0,0
22812,2019-06-15,741,0,741,59,800,800,0,0
22813,2019-06-15,598,-64,534,42,576,576,0,0
22814,2019-06-15,306,0,306,24,330,330,0,0
22815,2019-06-15,723,0,723,57,780,780,0,0
22816,2019-06-15,908,0,908,72,980,980,0,0
22817,2019-06-15,908,0,908,72,980,980,0,0
22818,2019-06-15,1815,0,1815,145,1960,1960,0,0
22819,2019-06-15,445,0,445,35,480,480,0,0
22820,2019-06-15,426,0,426,34,460,460,0,0
22821,2019-06-15,408,0,408,32,440,440,0,0
22822,2019-06-15,806,0,806,64,870,870,0,0
22823,2019-06-15,621,0,621,49,670,670,0,0
22824,2019-06-15,639,0,639,51,690,690,0,0
22825,2019-06-15,334,0,334,26,360,360,0,0
22826,2019-06-15,408,0,408,32,440,440,0,0
22827,2019-06-15,1139,0,1139,91,1230,1230,0,0
22828,2019-06-15,2204,0,2204,176,2380,2380,0,0
22829,2019-06-15,1454,0,1454,116,1570,1570,0,0
22830,2019-06-15,1325,0,1325,105,1430,1430,0,0
22831,2019-06-15,1306,0,1306,104,1410,1410,0,0
22832,2019-06-15,630,0,630,50,680,680,0,0
22833,2019-06-15,463,0,463,37,500,500,0,0
22834,2019-06-15,538,0,538,42,580,580,0,0
22835,2019-06-15,695,0,695,55,750,750,0,0
22836,2019-06-15,176,0,176,14,190,190,0,0
22837,2019-06-15,473,0,473,37,510,510,0,0
22838,2019-06-15,1167,0,1167,93,1260,1260,0,0
22839,2019-06-15,195,0,195,15,210,210,0,0
22840,2019-06-15,1815,0,1815,145,1960,1960,0,0
22841,2019-06-15,2973,0,2973,237,3210,3210,0,0
22842,2019-06-15,297,0,297,23,320,320,0,0
22843,2019-06-15,908,0,908,72,980,980,0,0
22844,2019-06-15,794,-85,709,56,765,765,0,0
22845,2019-06-15,732,0,732,58,790,790,0,0
22846,2019-06-15,1334,0,1334,106,1440,1440,0,0
22847,2019-06-15,315,0,315,25,340,340,0,0
22848,2019-06-15,501,0,501,39,540,540,0,0
22849,2019-06-15,1815,0,1815,145,1960,1960,0,0
22850,2019-06-15,176,0,176,14,190,190,0,0
22851,2019-06-15,482,0,482,38,520,520,0,0
22852,2019-06-15,768,0,768,52,820,820,0,0
22853,2019-06-15,343,0,343,27,370,370,0,0
22854,2019-06-15,899,0,899,71,970,970,0,0
22855,2019-06-15,1028,0,1028,82,1110,1110,0,0
22856,2019-06-15,686,0,686,54,740,740,0,0
22857,2019-06-15,889,0,889,71,960,960,0,0
22858,2019-06-15,871,0,871,69,940,940,0,0
22859,2019-06-15,908,0,908,72,980,980,0,0
22860,2019-06-15,278,0,278,22,300,300,0,0
22861,2019-06-15,1297,0,1297,103,1400,1400,0,0
22862,2019-06-15,1815,0,1815,145,1960,1960,0,0
22863,2019-06-15,538,0,538,42,580,580,0,0
22864,2019-06-15,1036,-111,925,74,999,999,0,0
22865,2019-06-15,1751,0,1751,139,1890,1890,0,0
22866,2019-06-15,1482,0,1482,118,1600,1600,0,0
22867,2019-06-15,1815,0,1815,145,1960,1960,0,0
22868,2019-06-15,796,0,796,54,850,850,0,0
22869,2019-06-15,167,0,167,13,180,180,0,0
22870,2019-06-15,861,0,861,59,920,920,0,0
22871,2019-06-15,1815,0,1815,145,1960,1960,0,0
22872,2019-06-15,352,0,352,28,380,380,0,0
22873,2019-06-15,565,0,565,45,610,610,0,0
22874,2019-06-15,325,0,325,25,350,350,0,0
22875,2019-06-15,167,0,167,13,180,180,0,0
22876,2019-06-15,963,0,963,77,1040,1040,0,0
22877,2019-06-15,1148,-123,1025,82,1107,1107,0,0
22878,2019-06-15,269,0,269,21,290,290,0,0
22879,2019-06-15,1575,0,1575,125,1700,1700,0,0
22880,2019-06-15,473,0,473,37,510,510,0,0
22881,2019-06-15,343,0,343,27,370,370,0,0
22882,2019-06-15,1399,0,1399,111,1510,1510,0,0
22883,2019-06-15,1019,0,1019,81,1100,1100,0,0
22884,2019-06-15,426,0,426,34,460,460,0,0
22885,2019-06-15,575,0,575,45,620,0,620,0
22886,2019-06-15,1056,0,1056,84,1140,1140,0,0
22887,2019-06-15,362,0,362,28,390,390,0,0
22888,2019-06-15,565,0,565,45,610,610,0,0
22889,2019-06-15,763,-162,601,47,648,648,0,0
22890,2019-06-15,1575,0,1575,125,1700,1700,0,0
22891,2019-06-15,1575,0,1575,125,1700,1700,0,0
22892,2019-06-15,871,0,871,69,940,940,0,0
22893,2019-06-15,788,0,788,62,850,850,0,0
22894,2019-06-15,288,0,288,22,310,310,0,0
22895,2019-06-15,788,0,788,62,850,850,0,0
22896,2019-06-15,315,0,315,25,340,340,0,0
22897,2019-06-15,306,0,306,24,330,330,0,0
22898,2019-06-15,1575,0,1575,125,1700,1700,0,0
22899,2019-06-15,167,0,167,13,180,180,0,0
22900,2019-06-15,723,0,723,57,780,780,0,0
22901,2019-06-15,584,0,584,46,630,630,0,0
22902,2019-06-15,621,0,621,49,670,670,0,0
22903,2019-06-15,288,0,288,22,310,310,0,0
22904,2019-06-15,1325,0,1325,105,1430,0,1430,0
22905,2019-06-15,223,0,223,17,240,240,0,0
22906,2019-06-15,760,0,760,60,820,820,0,0
22907,2019-06-15,519,0,519,41,560,560,0,0
22908,2019-06-15,380,0,380,30,410,410,0,0
22909,2019-06-15,639,0,639,51,690,690,0,0
22910,2019-06-15,491,0,491,39,530,530,0,0
22911,2019-06-15,499,-106,393,31,424,424,0,0
22912,2019-06-15,1223,0,1223,97,1320,1320,0,0
22913,2019-06-15,788,0,788,62,850,850,0,0
22914,2019-06-15,1575,0,1575,125,1700,1700,0,0
22915,2019-06-15,788,0,788,62,850,850,0,0
22916,2019-06-15,862,0,862,68,930,930,0,0
22917,2019-06-15,1713,0,1713,137,1850,1850,0,0
22918,2019-06-15,2102,0,2102,168,2270,2270,0,0
22919,2019-06-15,788,0,788,62,850,850,0,0
22920,2019-06-15,612,0,612,48,660,660,0,0
22921,2019-06-15,1575,0,1575,125,1700,1700,0,0
22922,2019-06-15,3149,0,3149,251,3400,3400,0,0
22923,2019-06-15,482,0,482,38,520,520,0,0
22924,2019-06-15,176,0,176,14,190,190,0,0
22925,2019-06-15,362,0,362,28,390,390,0,0
22926,2019-06-15,213,0,213,17,230,0,230,0
22927,2019-06-15,334,0,334,26,360,360,0,0
22928,2019-06-15,797,0,797,63,860,860,0,0
22929,2019-06-15,794,-85,709,56,765,765,0,0
22930,2019-06-15,630,0,630,50,680,680,0,0
22931,2019-06-15,417,0,417,33,450,450,0,0
22932,2019-06-15,1575,0,1575,125,1700,1700,0,0
22933,2019-06-15,399,0,399,31,430,430,0,0
22934,2019-06-15,504,-54,450,36,486,486,0,0
22935,2019-06-15,249,0,249,11,260,0,260,0
22936,2019-06-15,1575,0,1575,125,1700,1700,0,0
22937,2019-06-15,1575,0,1575,125,1700,1700,0,0
22938,2019-06-15,278,0,278,22,300,300,0,0
22939,2019-06-15,1575,0,1575,125,1700,1700,0,0
22940,2019-06-15,815,0,815,65,880,880,0,0
22941,2019-06-15,843,0,843,67,910,910,0,0
22942,2019-06-15,1158,0,1158,92,1250,1250,0,0
22943,2019-06-15,1575,0,1575,125,1700,1700,0,0
22944,2019-06-15,1575,0,1575,125,1700,1700,0,0
22945,2019-06-15,676,0,676,54,730,730,0,0
22946,2019-06-15,815,0,815,65,880,880,0,0
22947,2019-06-15,2362,0,2362,188,2550,2550,0,0
22948,2019-06-15,399,0,399,31,430,430,0,0
22949,2019-06-16,797,0,797,63,860,860,0,0
22950,2019-06-16,1815,0,1815,145,1960,1960,0,0
22951,2019-06-16,1296,-138,1158,84,1242,1242,0,0
22952,2019-06-16,1510,0,1510,120,1630,1630,0,0
22953,2019-06-16,598,-64,534,42,576,576,0,0
22954,2019-06-16,504,-54,450,36,486,486,0,0
22955,2019-06-16,834,0,834,66,900,900,0,0
22956,2019-06-16,556,0,556,44,600,600,0,0
22957,2019-06-16,426,0,426,34,460,460,0,0
22958,2019-06-16,1315,0,1315,105,1420,1420,0,0
22959,2019-06-16,445,0,445,35,480,480,0,0
22960,2019-06-16,908,0,908,72,980,980,0,0
22961,2019-06-16,260,0,260,20,280,280,0,0
22962,2019-06-16,973,0,973,77,1050,1050,0,0
22963,2019-06-16,936,0,936,74,1010,1010,0,0
22964,2019-06-16,584,0,584,46,630,630,0,0
22965,2019-06-16,362,0,362,28,390,390,0,0
22966,2019-06-16,973,0,973,77,1050,1050,0,0
22967,2019-06-16,288,0,288,22,310,310,0,0
22968,2019-06-16,788,0,788,62,850,850,0,0
22969,2019-06-16,1815,0,1815,145,1960,1960,0,0
22970,2019-06-16,538,0,538,42,580,580,0,0
22971,2019-06-16,297,0,297,23,320,320,0,0
22972,2019-06-16,408,0,408,32,440,440,0,0
22973,2019-06-16,306,0,306,24,330,330,0,0
22974,2019-06-16,407,0,407,23,430,430,0,0
22975,2019-06-16,278,0,278,22,300,300,0,0
22976,2019-06-16,241,0,241,19,260,260,0,0
22977,2019-06-16,445,0,445,35,480,480,0,0
22978,2019-06-16,621,0,621,49,670,670,0,0
22979,2019-06-16,306,0,306,24,330,330,0,0
22980,2019-06-16,788,0,788,62,850,850,0,0
22981,2019-06-16,315,0,315,25,340,340,0,0
22982,2019-06-16,445,0,445,35,480,480,0,0
22983,2019-06-16,519,0,519,41,560,560,0,0
22984,2019-06-16,963,0,963,77,1040,1040,0,0
22985,2019-06-16,467,-50,417,33,450,450,0,0
22986,2019-06-16,232,0,232,18,250,250,0,0
22987,2019-06-16,747,-80,667,53,720,720,0,0
22988,2019-06-16,417,0,417,33,450,450,0,0
22989,2019-06-16,565,0,565,45,610,610,0,0
22990,2019-06-16,482,0,482,38,520,520,0,0
22991,2019-06-16,695,0,695,55,750,750,0,0
22992,2019-06-16,362,0,362,28,390,390,0,0
22993,2019-06-16,269,0,269,21,290,290,0,0
22994,2019-06-16,675,0,675,45,720,720,0,0
22995,2019-06-16,436,0,436,34,470,470,0,0
22996,2019-06-16,417,0,417,33,450,450,0,0
22997,2019-06-16,1528,0,1528,122,1650,0,0,1650
22998,2019-06-16,481,0,481,29,510,510,0,0
22999,2019-06-16,547,0,547,43,590,590,0,0
23000,2019-06-16,260,0,260,20,280,280,0,0
23001,2019-06-16,305,0,305,15,320,320,0,0
23002,2019-06-16,399,0,399,31,430,430,0,0
23003,2019-06-16,232,0,232,18,250,250,0,0
23004,2019-06-16,695,0,695,55,750,750,0,0
23005,2019-06-16,649,0,649,51,700,700,0,0
23006,2019-06-16,519,0,519,41,560,560,0,0
23007,2019-06-16,741,0,741,59,800,800,0,0
23008,2019-06-16,251,0,251,19,270,270,0,0
23009,2019-06-16,454,0,454,36,490,490,0,0
23010,2019-06-16,408,0,408,32,440,440,0,0
23011,2019-06-16,538,0,538,42,580,580,0,0
23012,2019-06-16,769,0,769,61,830,830,0,0
23013,2019-06-16,399,0,399,31,430,430,0,0
23014,2019-06-16,501,0,501,39,540,540,0,0
23015,2019-06-16,399,0,399,31,430,430,0,0
23016,2019-06-16,278,0,278,22,300,0,0,300
23017,2019-06-16,482,0,482,38,520,520,0,0
23018,2019-06-16,473,0,473,37,510,510,0,0
23019,2019-06-16,713,0,713,57,770,0,770,0
23020,2019-06-16,723,0,723,57,780,780,0,0
23021,2019-06-16,343,0,343,27,370,370,0,0
23022,2019-06-16,806,0,806,64,870,870,0,0
23023,2019-06-16,500,0,500,40,540,540,0,0
23024,2019-06-16,741,0,741,59,800,800,0,0
23025,2019-06-16,445,0,445,35,480,480,0,0
23026,2019-06-16,519,0,519,41,560,560,0,0
23027,2019-06-16,204,0,204,16,220,220,0,0
23028,2019-06-16,323,0,323,17,340,340,0,0
23029,2019-06-16,1251,0,1251,99,1350,1350,0,0
23030,2019-06-16,575,0,575,45,620,620,0,0
23031,2019-06-16,519,0,519,41,560,560,0,0
23032,2019-06-16,852,0,852,68,920,920,0,0
23033,2019-06-16,260,0,260,20,280,280,0,0
23034,2019-06-16,343,0,343,27,370,370,0,0
23035,2019-06-16,112,0,112,8,120,120,0,0
23036,2019-06-16,167,0,167,13,180,180,0,0
23037,2019-06-16,3121,0,3121,249,3370,3370,0,0
23038,2019-06-16,176,0,176,14,190,190,0,0
23039,2019-06-16,1213,0,1213,97,1310,1310,0,0
23040,2019-06-16,463,0,463,37,500,500,0,0
23041,2019-06-16,934,-100,834,66,900,0,900,0
23042,2019-06-16,371,0,371,29,400,400,0,0
23043,2019-06-16,399,0,399,31,430,430,0,0
23044,2019-06-16,982,0,982,78,1060,1060,0,0
23045,2019-06-16,112,0,112,8,120,120,0,0
23046,2019-06-16,473,0,473,37,510,510,0,0
23047,2019-06-16,269,0,269,21,290,290,0,0
23048,2019-06-16,1038,0,1038,82,1120,1120,0,0
23049,2019-06-16,686,0,686,54,740,740,0,0
23050,2019-06-16,676,0,676,54,730,730,0,0
23051,2019-06-16,940,0,940,75,1015,1015,0,0
23052,2019-06-16,880,0,880,70,950,950,0,0
23053,2019-06-16,834,0,834,66,900,900,0,0
23054,2019-06-16,593,0,593,47,640,640,0,0
23055,2019-06-16,1297,0,1297,103,1400,1400,0,0
23056,2019-06-16,1259,0,1259,91,1350,1350,0,0
23057,2019-06-16,871,0,871,69,940,940,0,0
23058,2019-06-16,241,0,241,19,260,260,0,0
23059,2019-06-16,260,0,260,20,280,280,0,0
23060,2019-06-16,1686,0,1686,134,1820,1820,0,0
23061,2019-06-16,612,0,612,48,660,660,0,0
23062,2019-06-16,149,0,149,11,160,160,0,0
23063,2019-06-16,1278,0,1278,102,1380,1380,0,0
23064,2019-06-16,1158,0,1158,92,1250,1250,0,0
23065,2019-06-16,246,0,246,19,265,265,0,0
23066,2019-06-16,283,0,283,22,305,305,0,0
23067,2019-06-16,167,0,167,13,180,180,0,0
23068,2019-06-16,704,0,704,56,760,760,0,0
23069,2019-06-16,1297,0,1297,103,1400,1400,0,0
23070,2019-06-16,269,0,269,21,290,290,0,0
23071,2019-06-16,741,0,741,59,800,800,0,0
23072,2019-06-16,649,0,649,51,700,700,0,0
23073,2019-06-16,343,0,343,27,370,370,0,0
23074,2019-06-16,486,-52,434,34,468,468,0,0
23075,2019-06-16,305,0,305,15,320,320,0,0
23076,2019-06-16,691,-74,617,49,666,666,0,0
23077,2019-06-16,1575,0,1575,125,1700,1700,0,0
23078,2019-06-16,362,0,362,28,390,390,0,0
23079,2019-06-16,501,0,501,39,540,540,0,0
23080,2019-06-16,167,0,167,13,180,180,0,0
23081,2019-06-16,1852,0,1852,148,2000,0,2000,0
23082,2019-06-16,1751,0,1751,139,1890,1890,0,0
23083,2019-06-16,788,0,788,62,850,850,0,0
23084,2019-06-16,553,0,553,17,570,570,0,0
23085,2019-06-16,-195,0,-195,-15,-210,0,0,-210
23086,2019-06-16,1575,0,1575,125,1700,1700,0,0
23087,2019-06-16,232,0,232,18,250,250,0,0
23088,2019-06-16,1575,0,1575,125,1700,1700,0,0
23089,2019-06-16,277,0,277,13,290,290,0,0
23090,2019-06-16,139,0,139,11,150,150,0,0
23091,2019-06-16,788,0,788,62,850,850,0,0
23092,2019-06-16,510,0,510,40,550,550,0,0
23093,2019-06-16,-686,0,-686,-54,-740,-740,0,0
23094,2019-06-16,286,0,286,14,300,300,0,0
23095,2019-06-16,788,0,788,62,850,850,0,0
23096,2019-06-16,195,0,195,15,210,0,0,210
23097,2019-06-16,788,0,788,62,850,850,0,0
23098,2019-06-16,1575,0,1575,125,1700,1700,0,0
23099,2019-06-16,223,0,223,17,240,240,0,0
23100,2019-06-16,593,0,593,47,640,640,0,0
23101,2019-06-16,269,0,269,21,290,290,0,0
23102,2019-06-16,852,0,852,68,920,920,0,0
23103,2019-06-16,630,0,630,50,680,680,0,0
23104,2019-06-16,306,0,306,24,330,330,0,0
23105,2019-06-16,510,0,510,40,550,550,0,0
23106,2019-06-16,371,0,371,29,400,400,0,0
23107,2019-06-16,945,0,945,75,1020,1020,0,0
23108,2019-06-16,584,0,584,46,630,630,0,0
23109,2019-06-16,269,0,269,21,290,290,0,0
23110,2019-06-16,751,0,751,59,810,810,0,0
23111,2019-06-16,926,0,926,74,1000,1000,0,0
23112,2019-06-16,473,0,473,37,510,510,0,0
23113,2019-06-16,417,0,417,33,450,450,0,0
23114,2019-06-16,1779,-378,1401,111,1512,1512,0,0
23115,2019-06-16,426,0,426,34,460,460,0,0
23116,2019-06-16,676,0,676,54,730,730,0,0
23117,2019-06-16,1260,0,1260,100,1360,1360,0,0
23118,2019-06-17,2204,0,2204,176,2380,2380,0,0
23119,2019-06-17,899,0,899,71,970,970,0,0
23120,2019-06-17,908,0,908,72,980,980,0,0
23121,2019-06-17,908,0,908,72,980,980,0,0
23122,2019-06-17,2630,0,2630,210,2840,0,2840,0
23123,2019-06-17,110,0,110,0,110,110,0,0
23124,2019-06-17,343,0,343,27,370,370,0,0
23125,2019-06-17,713,0,713,57,770,770,0,0
23126,2019-06-17,871,0,871,69,940,940,0,0
23127,2019-06-17,908,0,908,72,980,980,0,0
23128,2019-06-17,510,0,510,40,550,550,0,0
23129,2019-06-17,908,0,908,72,980,980,0,0
23130,2019-06-17,501,0,501,39,540,540,0,0
23131,2019-06-17,399,0,399,31,430,430,0,0
23132,2019-06-17,852,0,852,68,920,920,0,0
23133,2019-06-17,564,0,564,36,600,600,0,0
23134,2019-06-17,825,0,825,65,890,890,0,0
23135,2019-06-17,426,0,426,34,460,460,0,0
23136,2019-06-17,732,0,732,58,790,790,0,0
23137,2019-06-17,528,0,528,42,570,570,0,0
23138,2019-06-17,362,0,362,28,390,390,0,0
23139,2019-06-17,445,0,445,35,480,480,0,0
23140,2019-06-17,463,0,463,37,500,500,0,0
23141,2019-06-17,1130,0,1130,90,1220,1220,0,0
23142,2019-06-17,788,0,788,62,850,850,0,0
23143,2019-06-17,473,0,473,37,510,510,0,0
23144,2019-06-17,1139,-122,1017,81,1098,1098,0,0
23145,2019-06-17,2834,0,2834,226,3060,3060,0,0
23146,2019-06-17,1070,-113,957,60,1017,1017,0,0
23147,2019-06-17,315,0,315,25,340,340,0,0
23148,2019-06-17,1815,0,1815,145,1960,1960,0,0
23149,2019-06-17,1075,0,1075,85,1160,1160,0,0
23150,2019-06-17,399,0,399,31,430,430,0,0
23151,2019-06-17,445,0,445,35,480,480,0,0
23152,2019-06-17,880,0,880,70,950,950,0,0
23153,2019-06-17,1010,0,1010,80,1090,1090,0,0
23154,2019-06-17,704,0,704,56,760,760,0,0
23155,2019-06-17,751,0,751,59,810,810,0,0
23156,2019-06-17,380,0,380,30,410,410,0,0
23157,2019-06-17,417,0,417,33,450,450,0,0
23158,2019-06-17,538,0,538,42,580,580,0,0
23159,2019-06-17,556,0,556,44,600,600,0,0
23160,2019-06-17,588,-63,525,42,567,567,0,0
23161,2019-06-17,926,0,926,74,1000,1000,0,0
23162,2019-06-17,1473,0,1473,117,1590,0,1590,0
23163,2019-06-17,788,0,788,62,850,850,0,0
23164,2019-06-17,491,0,491,39,530,530,0,0
23165,2019-06-17,981,0,981,69,1050,1050,0,0
23166,2019-06-17,889,0,889,71,960,960,0,0
23167,2019-06-17,343,0,343,27,370,370,0,0
23168,2019-06-17,553,0,553,17,570,570,0,0
23169,2019-06-17,306,0,306,24,330,330,0,0
23170,2019-06-17,954,0,954,76,1030,1030,0,0
23171,2019-06-17,908,0,908,72,980,980,0,0
23172,2019-06-17,241,0,241,19,260,260,0,0
23173,2019-06-17,621,0,621,49,670,670,0,0
23174,2019-06-17,1532,0,1532,113,1645,1645,0,0
23175,2019-06-17,371,0,371,29,400,400,0,0
23176,2019-06-17,389,0,389,31,420,420,0,0
23177,2019-06-17,389,0,389,31,420,420,0,0
23178,2019-06-17,602,0,602,48,650,650,0,0
23179,2019-06-17,785,0,785,45,830,830,0,0
23180,2019-06-17,1251,0,1251,99,1350,1350,0,0
23181,2019-06-17,815,0,815,65,880,880,0,0
23182,2019-06-17,565,0,565,45,610,610,0,0
23183,2019-06-17,139,0,139,11,150,150,0,0
23184,2019-06-17,408,0,408,32,440,440,0,0
23185,2019-06-17,588,0,588,47,635,635,0,0
23186,2019-06-17,1686,0,1686,134,1820,1820,0,0
23187,2019-06-17,426,0,426,34,460,460,0,0
23188,2019-06-17,815,0,815,65,880,880,0,0
23189,2019-06-17,426,0,426,34,460,460,0,0
23190,2019-06-17,260,0,260,20,280,280,0,0
23191,2019-06-17,501,0,501,39,540,540,0,0
23192,2019-06-17,297,0,297,23,320,320,0,0
23193,2019-06-17,963,0,963,77,1040,1040,0,0
23194,2019-06-17,723,0,723,57,780,780,0,0
23195,2019-06-17,241,0,241,19,260,260,0,0
23196,2019-06-17,806,0,806,64,870,870,0,0
23197,2019-06-17,757,-81,676,53,729,729,0,0
23198,2019-06-17,676,0,676,54,730,730,0,0
23199,2019-06-17,575,0,575,45,620,620,0,0
23200,2019-06-17,862,0,862,68,930,930,0,0
23201,2019-06-17,371,0,371,29,400,400,0,0
23202,2019-06-17,501,0,501,39,540,540,0,0
23203,2019-06-17,491,0,491,39,530,530,0,0
23204,2019-06-17,621,0,621,49,670,670,0,0
23205,2019-06-17,1862,0,1862,148,2010,2010,0,0
23206,2019-06-17,596,-63,533,34,567,567,0,0
23207,2019-06-17,343,0,343,27,370,370,0,0
23208,2019-06-17,1288,0,1288,102,1390,1390,0,0
23209,2019-06-17,269,0,269,21,290,290,0,0
23210,2019-06-17,223,0,223,17,240,240,0,0
23211,2019-06-17,139,0,139,11,150,150,0,0
23212,2019-06-17,1575,0,1575,125,1700,1700,0,0
23213,2019-06-17,889,0,889,71,960,960,0,0
23214,2019-06-17,426,0,426,34,460,460,0,0
23215,2019-06-17,1575,0,1575,125,1700,1700,0,0
23216,2019-06-17,898,0,898,62,960,960,0,0
23217,2019-06-17,1084,0,1084,86,1170,1170,0,0
23218,2019-06-17,1278,0,1278,102,1380,1380,0,0
23219,2019-06-17,448,-48,400,32,432,432,0,0
23220,2019-06-17,852,0,852,68,920,920,0,0
23221,2019-06-17,371,0,371,29,400,400,0,0
23222,2019-06-17,1149,-123,1026,81,1107,1107,0,0
23223,2019-06-17,306,0,306,24,330,330,0,0
23224,2019-06-17,1575,0,1575,125,1700,1700,0,0
23225,2019-06-17,306,0,306,24,330,330,0,0
23226,2019-06-17,538,0,538,42,580,580,0,0
23227,2019-06-18,223,0,223,17,240,240,0,0
23228,2019-06-18,667,0,667,53,720,720,0,0
23229,2019-06-18,260,0,260,20,280,280,0,0
23230,2019-06-18,1242,-133,1109,88,1197,1197,0,0
23231,2019-06-18,311,-66,245,19,264,264,0,0
23232,2019-06-18,1621,0,1621,129,1750,1750,0,0
23233,2019-06-18,139,0,139,11,150,150,0,0
23234,2019-06-18,371,0,371,29,400,400,0,0
23235,2019-06-18,334,0,334,26,360,360,0,0
23236,2019-06-18,297,0,297,23,320,320,0,0
23237,2019-06-18,102,0,102,8,110,110,0,0
23238,2019-06-18,473,0,473,37,510,510,0,0
23239,2019-06-18,1018,0,1018,72,1090,1090,0,0
23240,2019-06-18,167,0,167,13,180,180,0,0
23241,2019-06-18,602,0,602,48,650,650,0,0
23242,2019-06-18,250,0,250,20,270,270,0,0
23243,2019-06-18,871,0,871,69,940,940,0,0
23244,2019-06-18,139,0,139,11,150,150,0,0
23245,2019-06-18,445,0,445,35,480,480,0,0
23246,2019-06-18,380,0,380,30,410,410,0,0
23247,2019-06-18,843,0,843,67,910,910,0,0
23248,2019-06-18,630,0,630,50,680,680,0,0
23249,2019-06-18,374,-40,334,26,360,360,0,0
23250,2019-06-18,1102,0,1102,88,1190,1190,0,0
23251,2019-06-18,371,0,371,29,400,0,400,0
23252,2019-06-18,538,0,538,42,580,580,0,0
23253,2019-06-18,1251,-134,1117,89,1206,1206,0,0
23254,2019-06-18,1065,0,1065,85,1150,1150,0,0
23255,2019-06-18,426,0,426,34,460,460,0,0
23256,2019-06-18,547,0,547,43,590,590,0,0
23257,2019-06-18,1473,0,1473,117,1590,1590,0,0
23258,2019-06-18,538,0,538,42,580,580,0,0
23259,2019-06-19,584,0,584,46,630,630,0,0
23260,2019-06-19,463,0,463,37,500,500,0,0
23261,2019-06-19,945,0,945,75,1020,1020,0,0
23262,2019-06-19,232,0,232,18,250,250,0,0
23263,2019-06-19,349,-74,275,21,296,296,0,0
23264,2019-06-19,2454,0,2454,196,2650,2650,0,0
23265,2019-06-19,269,0,269,21,290,290,0,0
23266,2019-06-19,1703,0,1703,127,1830,1830,0,0
23267,2019-06-19,299,-32,267,21,288,0,288,0
23268,2019-06-19,676,0,676,54,730,730,0,0
23269,2019-06-19,612,0,612,48,660,660,0,0
23270,2019-06-19,593,0,593,47,640,640,0,0
23271,2019-06-19,195,0,195,15,210,210,0,0
23272,2019-06-19,784,-84,700,56,756,756,0,0
23273,2019-06-19,388,0,388,22,410,410,0,0
23274,2019-06-19,389,0,389,31,420,420,0,0
23275,2019-06-19,306,0,306,24,330,0,0,330
23276,2019-06-19,1269,0,1269,101,1370,1370,0,0
23277,2019-06-19,991,0,991,79,1070,1070,0,0
23278,2019-06-19,2954,0,2954,236,3190,3190,0,0
23279,2019-06-19,553,0,553,17,570,570,0,0
23280,2019-06-19,139,0,139,11,150,150,0,0
23281,2019-06-19,593,0,593,47,640,640,0,0
23282,2019-06-19,658,0,658,52,710,710,0,0
23283,2019-06-19,491,0,491,39,530,530,0,0
23284,2019-06-19,371,0,371,29,400,400,0,0
23285,2019-06-19,612,0,612,48,660,660,0,0
23286,2019-06-19,1158,0,1158,92,1250,1250,0,0
23287,2019-06-19,463,0,463,37,500,500,0,0
23288,2019-06-19,1260,0,1260,100,1360,1360,0,0
23289,2019-06-19,751,0,751,59,810,810,0,0
23290,2019-06-19,454,0,454,36,490,490,0,0
23291,2019-06-19,834,0,834,66,900,900,0,0
23292,2019-06-19,1241,0,1241,99,1340,1340,0,0
23293,2019-06-19,1880,0,1880,150,2030,2030,0,0
23294,2019-06-19,538,0,538,42,580,580,0,0
23295,2019-06-19,917,0,917,73,990,990,0,0
23296,2019-06-19,232,0,232,18,250,250,0,0
23297,2019-06-19,1999,0,1999,151,2150,2150,0,0
23298,2019-06-19,343,0,343,27,370,370,0,0
23299,2019-06-19,649,0,649,51,700,700,0,0
23300,2019-06-19,1112,0,1112,88,1200,1200,0,0
23301,2019-06-19,167,0,167,13,180,180,0,0
23302,2019-06-19,56,0,56,4,60,60,0,0
23303,2019-06-19,306,0,306,24,330,330,0,0
23304,2019-06-19,602,0,602,48,650,650,0,0
23305,2019-06-19,297,0,297,23,320,320,0,0
23306,2019-06-19,1575,0,1575,125,1700,1700,0,0
23307,2019-06-19,1795,0,1795,125,1920,1920,0,0
23308,2019-06-19,1121,0,1121,89,1210,1210,0,0
23309,2019-06-19,788,0,788,62,850,850,0,0
23310,2019-06-19,1575,0,1575,125,1700,1700,0,0
23311,2019-06-19,346,-37,309,24,333,333,0,0
23312,2019-06-19,963,0,963,77,1040,1040,0,0
23313,2019-06-19,2149,0,2149,171,2320,2320,0,0
23314,2019-06-19,1288,0,1288,102,1390,1390,0,0
23315,2019-06-19,1510,0,1510,120,1630,1630,0,0
23316,2019-06-19,472,0,472,28,500,500,0,0
23317,2019-06-19,139,0,139,11,150,150,0,0
23318,2019-06-19,565,0,565,45,610,610,0,0
23319,2019-06-19,954,0,954,76,1030,1030,0,0
23320,2019-06-19,2065,0,2065,165,2230,2230,0,0
23321,2019-06-19,602,0,602,48,650,650,0,0
23322,2019-06-19,788,0,788,62,850,850,0,0
23323,2019-06-19,760,0,760,60,820,820,0,0
23324,2019-06-19,167,0,167,13,180,180,0,0
23325,2019-06-19,926,0,926,74,1000,1000,0,0
23326,2019-06-19,371,0,371,29,400,400,0,0
23327,2019-06-19,834,0,834,66,900,900,0,0
23328,2019-06-19,234,-25,209,16,225,225,0,0
23329,2019-06-19,278,0,278,22,300,300,0,0
23330,2019-06-19,556,0,556,44,600,600,0,0
23331,2019-06-19,327,-35,292,23,315,315,0,0
23332,2019-06-19,1028,0,1028,82,1110,0,1110,0
23333,2019-06-19,426,0,426,34,460,460,0,0
23334,2019-06-19,334,0,334,26,360,360,0,0
23335,2019-06-19,362,0,362,28,390,390,0,0
23336,2019-06-20,1306,0,1306,104,1410,0,1410,0
23337,2019-06-20,1951,-209,1742,139,1881,0,1881,0
23338,2019-06-20,278,0,278,22,300,0,0,300
23339,2019-06-20,112,0,112,8,120,120,0,0
23340,2019-06-20,232,0,232,18,250,250,0,0
23341,2019-06-20,538,0,538,42,580,580,0,0
23342,2019-06-20,954,0,954,76,1030,1030,0,0
23343,2019-06-20,389,0,389,31,420,0,420,0
23344,2019-06-20,1481,0,1481,109,1590,1590,0,0
23345,2019-06-20,805,0,805,55,860,860,0,0
23346,2019-06-20,1047,0,1047,83,1130,1130,0,0
23347,2019-06-20,768,0,768,52,820,820,0,0
23348,2019-06-20,426,0,426,34,460,460,0,0
23349,2019-06-20,565,0,565,45,610,610,0,0
23350,2019-06-20,389,0,389,31,420,420,0,0
23351,2019-06-20,408,0,408,32,440,440,0,0
23352,2019-06-20,473,0,473,37,510,510,0,0
23353,2019-06-20,712,0,712,48,760,760,0,0
23354,2019-06-20,1343,0,1343,107,1450,1450,0,0
23355,2019-06-20,704,0,704,56,760,760,0,0
23356,2019-06-20,436,0,436,34,470,470,0,0
23357,2019-06-20,306,0,306,24,330,330,0,0
23358,2019-06-20,1046,-112,934,74,1008,1008,0,0
23359,2019-06-20,621,0,621,49,670,670,0,0
23360,2019-06-20,482,0,482,38,520,520,0,0
23361,2019-06-20,621,0,621,49,670,670,0,0
23362,2019-06-20,607,-65,542,43,585,585,0,0
23363,2019-06-20,519,0,519,41,560,560,0,0
23364,2019-06-20,917,0,917,73,990,990,0,0
23365,2019-06-20,547,0,547,43,590,0,590,0
23366,2019-06-20,547,0,547,43,590,590,0,0
23367,2019-06-20,251,0,251,19,270,270,0,0
23368,2019-06-20,621,0,621,49,670,670,0,0
23369,2019-06-20,649,0,649,51,700,700,0,0
23370,2019-06-20,843,0,843,67,910,910,0,0
23371,2019-06-20,315,0,315,25,340,340,0,0
23372,2019-06-20,797,0,797,63,860,860,0,0
23373,2019-06-20,803,-86,717,57,774,774,0,0
23374,2019-06-20,399,0,399,31,430,0,430,0
23375,2019-06-20,325,0,325,25,350,350,0,0
23376,2019-06-20,750,0,750,60,810,810,0,0
23377,2019-06-20,491,0,491,39,530,530,0,0
23378,2019-06-20,399,0,399,31,430,430,0,0
23379,2019-06-20,399,0,399,31,430,430,0,0
23380,2019-06-20,399,0,399,31,430,430,0,0
23381,2019-06-20,399,0,399,31,430,430,0,0
23382,2019-06-20,814,0,814,56,870,870,0,0
23383,2019-06-20,908,0,908,72,980,980,0,0
23384,2019-06-20,602,0,602,48,650,650,0,0
23385,2019-06-20,1501,0,1501,119,1620,1620,0,0
23386,2019-06-20,269,0,269,21,290,290,0,0
23387,2019-06-20,760,0,760,60,820,0,820,0
23388,2019-06-20,2260,0,2260,180,2440,2440,0,0
23389,2019-06-20,249,0,249,11,260,260,0,0
23390,2019-06-20,234,-25,209,16,225,225,0,0
23391,2019-06-20,1454,0,1454,116,1570,1570,0,0
23392,2019-06-20,908,0,908,72,980,980,0,0
23393,2019-06-20,1575,0,1575,125,1700,1700,0,0
23394,2019-06-20,519,0,519,41,560,560,0,0
23395,2019-06-20,1167,0,1167,93,1260,1260,0,0
23396,2019-06-20,533,0,533,42,575,575,0,0
23397,2019-06-20,306,0,306,24,330,330,0,0
23398,2019-06-20,658,0,658,52,710,710,0,0
23399,2019-06-20,546,-116,430,34,464,464,0,0
23400,2019-06-20,963,0,963,77,1040,1040,0,0
23401,2019-06-20,167,0,167,13,180,180,0,0
23402,2019-06-20,1389,0,1389,111,1500,1500,0,0
23403,2019-06-20,785,-84,701,55,756,756,0,0
23404,2019-06-20,315,0,315,25,340,340,0,0
23405,2019-06-20,176,0,176,14,190,190,0,0
23406,2019-06-20,482,0,482,38,520,520,0,0
23407,2019-06-20,1889,0,1889,151,2040,2040,0,0
23408,2019-06-20,825,0,825,65,890,890,0,0
23409,2019-06-20,489,0,489,21,510,510,0,0
23410,2019-06-20,519,0,519,41,560,560,0,0
23411,2019-06-20,849,0,849,41,890,890,0,0
23412,2019-06-20,135,0,135,10,145,145,0,0
23413,2019-06-20,436,0,436,34,470,470,0,0
23414,2019-06-20,436,0,436,34,470,470,0,0
23415,2019-06-20,334,0,334,26,360,360,0,0
23416,2019-06-20,908,0,908,72,980,980,0,0
23417,2019-06-20,1278,0,1278,102,1380,1380,0,0
23418,2019-06-20,1575,0,1575,125,1700,1700,0,0
23419,2019-06-20,3149,0,3149,251,3400,3400,0,0
23420,2019-06-20,602,0,602,48,650,650,0,0
23421,2019-06-20,788,0,788,62,850,850,0,0
23422,2019-06-20,343,0,343,27,370,370,0,0
23423,2019-06-20,1834,0,1834,146,1980,0,0,1980
23424,2019-06-20,788,0,788,62,850,850,0,0
23425,2019-06-20,556,0,556,44,600,600,0,0
23426,2019-06-20,778,0,778,62,840,840,0,0
23427,2019-06-20,1056,0,1056,84,1140,1140,0,0
23428,2019-06-20,560,-60,500,40,540,540,0,0
23429,2019-06-20,834,0,834,66,900,900,0,0
23430,2019-06-20,797,0,797,63,860,860,0,0
23431,2019-06-20,399,0,399,31,430,0,430,0
23432,2019-06-20,260,0,260,20,280,280,0,0
23433,2019-06-20,732,0,732,58,790,790,0,0
23434,2019-06-20,908,0,908,72,980,980,0,0
23435,2019-06-20,346,-37,309,24,333,333,0,0
23436,2019-06-20,1575,0,1575,125,1700,1700,0,0
23437,2019-06-20,612,0,612,48,660,660,0,0
23438,2019-06-20,556,0,556,44,600,600,0,0
23439,2019-06-20,408,0,408,32,440,440,0,0
23440,2019-06-20,760,0,760,60,820,820,0,0
23441,2019-06-20,249,0,249,11,260,260,0,0
23442,2019-06-20,788,0,788,62,850,850,0,0
23443,2019-06-20,797,0,797,63,860,860,0,0
23444,2019-06-20,538,0,538,42,580,580,0,0
23445,2019-06-20,788,0,788,62,850,850,0,0
23446,2019-06-20,417,0,417,33,450,450,0,0
23447,2019-06-21,936,0,936,74,1010,1010,0,0
23448,2019-06-21,1204,0,1204,96,1300,1300,0,0
23449,2019-06-21,738,-79,659,52,711,711,0,0
23450,2019-06-21,139,0,139,11,150,150,0,0
23451,2019-06-21,908,0,908,72,980,980,0,0
23452,2019-06-21,1213,0,1213,97,1310,1310,0,0
23453,2019-06-21,490,0,490,30,520,0,520,0
23454,2019-06-21,176,0,176,14,190,190,0,0
23455,2019-06-21,176,0,176,14,190,190,0,0
23456,2019-06-21,1389,0,1389,111,1500,1500,0,0
23457,2019-06-21,75,0,75,5,80,80,0,0
23458,2019-06-21,1815,0,1815,145,1960,1960,0,0
23459,2019-06-21,831,-89,742,59,801,801,0,0
23460,2019-06-21,834,0,834,66,900,900,0,0
23461,2019-06-21,176,0,176,14,190,190,0,0
23462,2019-06-21,936,0,936,74,1010,1010,0,0
23463,2019-06-21,139,0,139,11,150,150,0,0
23464,2019-06-21,454,0,454,36,490,490,0,0
23465,2019-06-21,1815,0,1815,145,1960,1960,0,0
23466,2019-06-21,908,0,908,72,980,980,0,0
23467,2019-06-21,908,0,908,72,980,980,0,0
23468,2019-06-21,908,0,908,72,980,980,0,0
23469,2019-06-21,908,0,908,72,980,980,0,0
23470,2019-06-21,899,0,899,71,970,970,0,0
23471,2019-06-21,1473,0,1473,117,1590,1590,0,0
23472,2019-06-21,528,0,528,42,570,570,0,0
23473,2019-06-21,1417,0,1417,113,1530,1530,0,0
23474,2019-06-21,325,0,325,25,350,350,0,0
23475,2019-06-21,676,0,676,54,730,730,0,0
23476,2019-06-21,2342,0,2342,178,2520,2520,0,0
23477,2019-06-21,1815,0,1815,145,1960,1960,0,0
23478,2019-06-21,2130,0,2130,170,2300,2300,0,0
23479,2019-06-21,1815,0,1815,145,1960,1960,0,0
23480,2019-06-21,741,0,741,59,800,800,0,0
23481,2019-06-21,315,0,315,25,340,340,0,0
23482,2019-06-21,575,0,575,45,620,620,0,0
23483,2019-06-21,667,0,667,53,720,720,0,0
23484,2019-06-21,1815,0,1815,145,1960,1960,0,0
23485,2019-06-21,556,0,556,44,600,600,0,0
23486,2019-06-21,352,0,352,28,380,380,0,0
23487,2019-06-21,269,0,269,21,290,290,0,0
23488,2019-06-21,871,0,871,69,940,940,0,0
23489,2019-06-21,1713,0,1713,137,1850,1850,0,0
23490,2019-06-21,352,0,352,28,380,380,0,0
23491,2019-06-21,1186,0,1186,94,1280,1280,0,0
23492,2019-06-21,565,0,565,45,610,610,0,0
23493,2019-06-21,584,-124,460,36,496,496,0,0
23494,2019-06-21,176,0,176,14,190,190,0,0
23495,2019-06-21,139,0,139,11,150,150,0,0
23496,2019-06-21,1056,0,1056,84,1140,1140,0,0
23497,2019-06-21,1723,0,1723,137,1860,1860,0,0
23498,2019-06-21,519,0,519,41,560,560,0,0
23499,2019-06-21,204,0,204,16,220,220,0,0
23500,2019-06-21,778,0,778,62,840,840,0,0
23501,2019-06-21,473,0,473,37,510,510,0,0
23502,2019-06-21,1223,0,1223,97,1320,1320,0,0
23503,2019-06-21,1028,0,1028,82,1110,1110,0,0
23504,2019-06-21,176,0,176,14,190,190,0,0
23505,2019-06-21,482,0,482,38,520,520,0,0
23506,2019-06-21,778,0,778,62,840,840,0,0
23507,2019-06-21,926,0,926,74,1000,1000,0,0
23508,2019-06-21,639,0,639,51,690,690,0,0
23509,2019-06-21,176,0,176,14,190,190,0,0
23510,2019-06-21,1815,0,1815,145,1960,1960,0,0
23511,2019-06-21,297,0,297,23,320,320,0,0
23512,2019-06-21,704,0,704,56,760,760,0,0
23513,2019-06-21,612,0,612,48,660,660,0,0
23514,2019-06-21,600,-126,474,30,504,0,504,0
23515,2019-06-21,973,0,973,77,1050,1050,0,0
23516,2019-06-21,1797,0,1797,143,1940,1940,0,0
23517,2019-06-21,575,0,575,45,620,620,0,0
23518,2019-06-21,880,0,880,70,950,950,0,0
23519,2019-06-21,973,0,973,77,1050,1050,0,0
23520,2019-06-21,528,0,528,42,570,570,0,0
23521,2019-06-21,1815,0,1815,145,1960,1960,0,0
23522,2019-06-21,908,0,908,72,980,980,0,0
23523,2019-06-21,602,0,602,48,650,650,0,0
23524,2019-06-21,130,0,130,10,140,140,0,0
23525,2019-06-21,1297,0,1297,103,1400,1400,0,0
23526,2019-06-21,149,0,149,11,160,160,0,0
23527,2019-06-21,389,0,389,31,420,420,0,0
23528,2019-06-21,1857,0,1857,148,2005,2005,0,0
23529,2019-06-21,355,-38,317,25,342,342,0,0
23530,2019-06-21,269,0,269,21,290,290,0,0
23531,2019-06-21,241,0,241,19,260,260,0,0
23532,2019-06-21,630,0,630,50,680,680,0,0
23533,2019-06-21,463,0,463,37,500,500,0,0
23534,2019-06-21,778,0,778,62,840,840,0,0
23535,2019-06-21,649,0,649,51,700,700,0,0
23536,2019-06-21,676,0,676,54,730,730,0,0
23537,2019-06-21,1195,0,1195,95,1290,1290,0,0
23538,2019-06-21,982,0,982,78,1060,1060,0,0
23539,2019-06-21,2723,0,2723,217,2940,2940,0,0
23540,2019-06-21,417,0,417,33,450,450,0,0
23541,2019-06-21,926,0,926,74,1000,1000,0,0
23542,2019-06-21,1408,0,1408,112,1520,1520,0,0
23543,2019-06-21,139,0,139,11,150,150,0,0
23544,2019-06-21,815,0,815,65,880,880,0,0
23545,2019-06-21,721,0,721,39,760,760,0,0
23546,2019-06-21,1038,0,1038,82,1120,1120,0,0
23547,2019-06-21,663,-71,592,47,639,639,0,0
23548,2019-06-21,630,0,630,50,680,0,680,0
23549,2019-06-21,880,0,880,70,950,950,0,0
23550,2019-06-21,908,0,908,72,980,980,0,0
23551,2019-06-21,1223,-131,1092,87,1179,0,1179,0
23552,2019-06-21,392,-42,350,28,378,378,0,0
23553,2019-06-21,224,-24,200,16,216,216,0,0
23554,2019-06-21,176,0,176,14,190,190,0,0
23555,2019-06-21,1038,0,1038,82,1120,1120,0,0
23556,2019-06-21,269,0,269,21,290,290,0,0
23557,2019-06-21,1704,0,1704,136,1840,1840,0,0
23558,2019-06-21,510,0,510,40,550,550,0,0
23559,2019-06-21,639,0,639,51,690,690,0,0
23560,2019-06-21,1139,0,1139,91,1230,1230,0,0
23561,2019-06-21,176,0,176,14,190,190,0,0
23562,2019-06-21,334,0,334,26,360,360,0,0
23563,2019-06-21,362,0,362,28,390,390,0,0
23564,2019-06-21,612,0,612,48,660,660,0,0
23565,2019-06-21,2158,0,2158,172,2330,2330,0,0
23566,2019-06-21,908,0,908,72,980,980,0,0
23567,2019-06-21,756,-81,675,54,729,729,0,0
23568,2019-06-21,663,-71,592,47,639,639,0,0
23569,2019-06-21,991,0,991,79,1070,1070,0,0
23570,2019-06-21,788,0,788,62,850,850,0,0
23571,2019-06-21,352,0,352,28,380,380,0,0
23572,2019-06-21,1587,-170,1417,113,1530,1530,0,0
23573,2019-06-21,1575,0,1575,125,1700,1700,0,0
23574,2019-06-21,612,0,612,48,660,660,0,0
23575,2019-06-21,1575,0,1575,125,1700,1700,0,0
23576,2019-06-21,1575,0,1575,125,1700,1700,0,0
23577,2019-06-21,1510,0,1510,120,1630,1630,0,0
23578,2019-06-21,1575,0,1575,125,1700,1700,0,0
23579,2019-06-21,1621,0,1621,129,1750,1750,0,0
23580,2019-06-21,343,0,343,27,370,370,0,0
23581,2019-06-21,1036,0,1036,74,1110,1110,0,0
23582,2019-06-21,936,0,936,74,1010,1010,0,0
23583,2019-06-21,1575,0,1575,125,1700,0,0,1700
23584,2019-06-21,1130,0,1130,90,1220,1220,0,0
23585,2019-06-21,797,0,797,63,860,860,0,0
23586,2019-06-21,1269,0,1269,101,1370,1370,0,0
23587,2019-06-21,1027,0,1027,73,1100,1100,0,0
23588,2019-06-21,176,0,176,14,190,190,0,0
23589,2019-06-21,556,0,556,44,600,600,0,0
23590,2019-06-21,1575,0,1575,125,1700,1700,0,0
23591,2019-06-21,343,0,343,27,370,370,0,0
23592,2019-06-21,2362,0,2362,188,2550,2550,0,0
23593,2019-06-21,1575,0,1575,125,1700,1700,0,0
23594,2019-06-21,788,0,788,62,850,850,0,0
23595,2019-06-21,463,0,463,37,500,500,0,0
23596,2019-06-21,343,0,343,27,370,0,0,370
23597,2019-06-21,1575,0,1575,125,1700,1700,0,0
23598,2019-06-21,602,0,602,48,650,650,0,0
23599,2019-06-21,1575,0,1575,125,1700,1700,0,0
23600,2019-06-21,269,0,269,21,290,290,0,0
23601,2019-06-21,1815,0,1815,145,1960,1960,0,0
23602,2019-06-21,1759,0,1759,131,1890,1890,0,0
23603,2019-06-21,1445,0,1445,115,1560,1560,0,0
23604,2019-06-21,538,0,538,42,580,580,0,0
23605,2019-06-21,195,0,195,15,210,210,0,0
23606,2019-06-21,769,0,769,61,830,830,0,0
23607,2019-06-21,352,0,352,28,380,380,0,0
23608,2019-06-21,1538,0,1538,122,1660,1660,0,0
23609,2019-06-21,1498,0,1498,102,1600,1600,0,0
23610,2019-06-21,704,0,704,56,760,760,0,0
23611,2019-06-21,315,0,315,25,340,340,0,0
23612,2019-06-21,398,0,398,22,420,420,0,0
23613,2019-06-21,880,0,880,70,950,950,0,0
23614,2019-06-21,528,0,528,42,570,570,0,0
23615,2019-06-21,426,0,426,34,460,460,0,0
23616,2019-06-21,1082,0,1082,68,1150,0,1150,0
23617,2019-06-21,584,0,584,46,630,630,0,0
23618,2019-06-21,417,0,417,33,450,450,0,0
23619,2019-06-21,260,0,260,20,280,280,0,0
23620,2019-06-21,315,0,315,25,340,340,0,0
23621,2019-06-21,1194,0,1194,86,1280,1280,0,0
23622,2019-06-21,342,0,342,18,360,360,0,0
23623,2019-06-21,936,0,936,74,1010,1010,0,0
23624,2019-06-21,778,0,778,62,840,840,0,0
23625,2019-06-21,278,0,278,22,300,300,0,0
23626,2019-06-21,621,0,621,49,670,670,0,0
23627,2019-06-21,1788,0,1788,142,1930,1930,0,0
23628,2019-06-21,1056,0,1056,84,1140,1140,0,0
23629,2019-06-21,788,0,788,62,850,850,0,0
23630,2019-06-21,908,0,908,72,980,980,0,0
23631,2019-06-21,232,0,232,18,250,250,0,0
23632,2019-06-21,223,0,223,17,240,240,0,0
23633,2019-06-21,269,0,269,21,290,290,0,0
23634,2019-06-21,658,0,658,52,710,710,0,0
23635,2019-06-21,973,0,973,77,1050,1050,0,0
23636,2019-06-21,1047,0,1047,83,1130,1130,0,0
23637,2019-06-21,1362,0,1362,108,1470,1470,0,0
23638,2019-06-21,741,0,741,59,800,800,0,0
23639,2019-06-21,778,0,778,62,840,840,0,0
23640,2019-06-21,149,0,149,11,160,160,0,0
23641,2019-06-21,695,0,695,55,750,750,0,0
23642,2019-06-21,1019,0,1019,81,1100,1100,0,0
23643,2019-06-21,769,0,769,61,830,830,0,0
23644,2019-06-21,556,0,556,44,600,600,0,0
23645,2019-06-21,1815,0,1815,145,1960,1960,0,0
23646,2019-06-21,2334,0,2334,186,2520,2520,0,0
23647,2019-06-21,908,0,908,72,980,980,0,0
23648,2019-06-21,769,0,769,61,830,830,0,0
23649,2019-06-21,814,0,814,56,870,870,0,0
23650,2019-06-21,454,0,454,36,490,490,0,0
23651,2019-06-21,2519,0,2519,201,2720,2720,0,0
23652,2019-06-21,731,0,731,49,780,780,0,0
23653,2019-06-21,695,0,695,55,750,750,0,0
23654,2019-06-21,2436,0,2436,194,2630,2630,0,0
23655,2019-06-21,899,0,899,71,970,970,0,0
23656,2019-06-21,1445,0,1445,115,1560,1560,0,0
23657,2019-06-21,519,0,519,41,560,560,0,0
23658,2019-06-21,1102,0,1102,88,1190,1190,0,0
23659,2019-06-21,130,0,130,10,140,140,0,0
23660,2019-06-21,204,0,204,16,220,220,0,0
23661,2019-06-21,1815,0,1815,145,1960,1960,0,0
23662,2019-06-21,1334,0,1334,106,1440,1440,0,0
23663,2019-06-21,334,0,334,26,360,360,0,0
23664,2019-06-21,371,0,371,29,400,400,0,0
23665,2019-06-21,473,0,473,37,510,510,0,0
23666,2019-06-21,788,0,788,62,850,850,0,0
23667,2019-06-21,1510,0,1510,120,1630,0,1630,0
23668,2019-06-21,510,0,510,40,550,550,0,0
23669,2019-06-21,1112,0,1112,88,1200,1200,0,0
23670,2019-06-21,889,0,889,71,960,960,0,0
23671,2019-06-21,621,0,621,49,670,670,0,0
23672,2019-06-21,732,0,732,58,790,790,0,0
23673,2019-06-21,713,0,713,57,770,770,0,0
23674,2019-06-21,778,0,778,62,840,840,0,0
23675,2019-06-21,176,0,176,14,190,190,0,0
23676,2019-06-21,389,0,389,31,420,420,0,0
23677,2019-06-21,334,0,334,26,360,360,0,0
23678,2019-06-21,1019,0,1019,81,1100,1100,0,0
23679,2019-06-21,454,0,454,36,490,490,0,0
23680,2019-06-21,139,0,139,11,150,150,0,0
23681,2019-06-21,1639,0,1639,131,1770,1770,0,0
23682,2019-06-21,1587,-170,1417,113,1530,1530,0,0
23683,2019-06-21,352,0,352,28,380,380,0,0
23684,2019-06-21,399,0,399,31,430,430,0,0
23685,2019-06-21,1575,0,1575,125,1700,1700,0,0
23686,2019-06-21,788,0,788,62,850,850,0,0
23687,2019-06-21,420,-45,375,30,405,405,0,0
23688,2019-06-21,1065,0,1065,85,1150,1150,0,0
23689,2019-06-21,936,0,936,74,1010,1010,0,0
23690,2019-06-21,862,0,862,68,930,930,0,0
23691,2019-06-21,880,0,880,70,950,950,0,0
23692,2019-06-22,1815,0,1815,145,1960,1960,0,0
23693,2019-06-22,1065,0,1065,85,1150,1150,0,0
23694,2019-06-22,1167,0,1167,93,1260,1260,0,0
23695,2019-06-22,352,0,352,28,380,380,0,0
23696,2019-06-22,1852,0,1852,148,2000,2000,0,0
23697,2019-06-22,2723,0,2723,217,2940,2940,0,0
23698,2019-06-22,1426,0,1426,114,1540,1540,0,0
23699,2019-06-22,195,0,195,15,210,210,0,0
23700,2019-06-22,1639,0,1639,131,1770,1770,0,0
23701,2019-06-22,954,0,954,76,1030,1030,0,0
23702,2019-06-22,176,0,176,14,190,190,0,0
23703,2019-06-22,565,0,565,45,610,610,0,0
23704,2019-06-22,352,0,352,28,380,380,0,0
23705,2019-06-22,1112,0,1112,88,1200,1200,0,0
23706,2019-06-22,519,0,519,41,560,560,0,0
23707,2019-06-22,778,0,778,62,840,840,0,0
23708,2019-06-22,834,0,834,66,900,900,0,0
23709,2019-06-22,1815,0,1815,145,1960,1960,0,0
23710,2019-06-22,371,0,371,29,400,400,0,0
23711,2019-06-22,2176,0,2176,174,2350,2350,0,0
23712,2019-06-22,889,0,889,71,960,960,0,0
23713,2019-06-22,2260,0,2260,180,2440,2440,0,0
23714,2019-06-22,249,0,249,11,260,260,0,0
23715,2019-06-22,815,0,815,65,880,0,880,0
23716,2019-06-22,1065,0,1065,85,1150,1150,0,0
23717,2019-06-22,1227,0,1227,98,1325,1325,0,0
23718,2019-06-22,547,0,547,43,590,590,0,0
23719,2019-06-22,593,0,593,47,640,640,0,0
23720,2019-06-22,2260,0,2260,180,2440,2440,0,0
23721,2019-06-22,1556,0,1556,124,1680,1680,0,0
23722,2019-06-22,962,-103,859,68,927,0,0,927
23723,2019-06-22,1001,0,1001,79,1080,1080,0,0
23724,2019-06-22,1788,0,1788,142,1930,1930,0,0
23725,2019-06-22,704,0,704,56,760,760,0,0
23726,2019-06-22,352,0,352,28,380,380,0,0
23727,2019-06-22,1538,0,1538,122,1660,1660,0,0
23728,2019-06-22,991,0,991,79,1070,1070,0,0
23729,2019-06-22,778,0,778,62,840,840,0,0
23730,2019-06-22,269,0,269,21,290,290,0,0
23731,2019-06-22,1621,0,1621,129,1750,1750,0,0
23732,2019-06-22,788,0,788,62,850,850,0,0
23733,2019-06-22,528,0,528,42,570,570,0,0
23734,2019-06-22,2362,0,2362,188,2550,2550,0,0
23735,2019-06-22,343,0,343,27,370,370,0,0
23736,2019-06-22,1815,0,1815,145,1960,1960,0,0
23737,2019-06-22,306,0,306,24,330,330,0,0
23738,2019-06-22,320,0,320,25,345,345,0,0
23739,2019-06-22,797,0,797,63,860,860,0,0
23740,2019-06-22,178,-19,159,12,171,171,0,0
23741,2019-06-22,362,0,362,28,390,390,0,0
23742,2019-06-22,288,0,288,22,310,310,0,0
23743,2019-06-22,501,0,501,39,540,540,0,0
23744,2019-06-22,1575,0,1575,125,1700,1700,0,0
23745,2019-06-22,241,0,241,19,260,260,0,0
23746,2019-06-22,417,0,417,33,450,450,0,0
23747,2019-06-22,1019,0,1019,81,1100,1100,0,0
23748,2019-06-22,825,0,825,65,890,890,0,0
23749,2019-06-22,1352,0,1352,108,1460,1460,0,0
23750,2019-06-22,468,0,468,37,505,505,0,0
23751,2019-06-22,176,0,176,14,190,190,0,0
23752,2019-06-22,732,0,732,58,790,790,0,0
23753,2019-06-22,176,0,176,14,190,190,0,0
23754,2019-06-22,908,0,908,72,980,980,0,0
23755,2019-06-22,788,0,788,62,850,850,0,0
23756,2019-06-22,917,0,917,73,990,990,0,0
23757,2019-06-22,1176,0,1176,94,1270,1270,0,0
23758,2019-06-22,1800,-192,1608,120,1728,1728,0,0
23759,2019-06-22,454,0,454,36,490,490,0,0
23760,2019-06-22,778,0,778,62,840,840,0,0
23761,2019-06-22,667,0,667,53,720,720,0,0
23762,2019-06-22,1815,0,1815,145,1960,1960,0,0
23763,2019-06-22,704,0,704,56,760,760,0,0
23764,2019-06-22,565,0,565,45,610,610,0,0
23765,2019-06-22,473,0,473,37,510,510,0,0
23766,2019-06-22,346,-37,309,24,333,333,0,0
23767,2019-06-22,176,0,176,14,190,190,0,0
23768,2019-06-22,278,0,278,22,300,300,0,0
23769,2019-06-22,982,0,982,78,1060,1060,0,0
23770,2019-06-22,999,0,999,71,1070,1070,0,0
23771,2019-06-22,315,0,315,25,340,340,0,0
23772,2019-06-22,1908,0,1908,152,2060,2060,0,0
23773,2019-06-22,1602,0,1602,128,1730,1730,0,0
23774,2019-06-22,649,0,649,51,700,700,0,0
23775,2019-06-22,1973,0,1973,157,2130,2130,0,0
23776,2019-06-22,704,0,704,56,760,760,0,0
23777,2019-06-22,176,0,176,14,190,190,0,0
23778,2019-06-22,1288,0,1288,102,1390,1390,0,0
23779,2019-06-22,1482,0,1482,118,1600,1600,0,0
23780,2019-06-22,260,0,260,20,280,280,0,0
23781,2019-06-22,981,0,981,69,1050,1050,0,0
23782,2019-06-22,1528,0,1528,122,1650,1650,0,0
23783,2019-06-22,871,0,871,69,940,940,0,0
23784,2019-06-22,954,0,954,76,1030,1030,0,0
23785,2019-06-22,426,0,426,34,460,460,0,0
23786,2019-06-22,593,0,593,47,640,640,0,0
23787,2019-06-22,315,0,315,25,340,340,0,0
23788,2019-06-22,426,0,426,34,460,460,0,0
23789,2019-06-22,1231,0,1231,89,1320,1320,0,0
23790,2019-06-22,168,-18,150,12,162,162,0,0
23791,2019-06-22,639,0,639,51,690,690,0,0
23792,2019-06-22,491,0,491,39,530,530,0,0
23793,2019-06-22,352,0,352,28,380,380,0,0
23794,2019-06-22,1815,0,1815,145,1960,1960,0,0
23795,2019-06-22,1436,0,1436,114,1550,1550,0,0
23796,2019-06-22,1010,0,1010,80,1090,1090,0,0
23797,2019-06-22,176,0,176,14,190,190,0,0
23798,2019-06-22,1158,-124,1034,82,1116,1116,0,0
23799,2019-06-22,2723,0,2723,217,2940,2940,0,0
23800,2019-06-22,1760,0,1760,140,1900,1900,0,0
23801,2019-06-22,362,0,362,28,390,390,0,0
23802,2019-06-22,538,0,538,42,580,580,0,0
23803,2019-06-22,2491,0,2491,199,2690,2690,0,0
23804,2019-06-22,1047,0,1047,83,1130,1130,0,0
23805,2019-06-22,806,0,806,64,870,870,0,0
23806,2019-06-22,1593,0,1593,127,1720,1720,0,0
23807,2019-06-22,538,0,538,42,580,580,0,0
23808,2019-06-22,2723,0,2723,217,2940,2940,0,0
23809,2019-06-22,176,0,176,14,190,190,0,0
23810,2019-06-22,528,0,528,42,570,570,0,0
23811,2019-06-22,260,0,260,20,280,280,0,0
23812,2019-06-22,1667,0,1667,133,1800,1800,0,0
23813,2019-06-22,584,0,584,46,630,630,0,0
23814,2019-06-22,1057,-1000,57,3,60,60,0,0
23815,2019-06-22,1186,0,1186,94,1280,1280,0,0
23816,2019-06-22,223,0,223,17,240,240,0,0
23817,2019-06-22,408,0,408,32,440,440,0,0
23818,2019-06-22,908,0,908,72,980,980,0,0
23819,2019-06-22,908,0,908,72,980,980,0,0
23820,2019-06-22,639,0,639,51,690,690,0,0
23821,2019-06-22,260,0,260,20,280,280,0,0
23822,2019-06-22,538,0,538,42,580,580,0,0
23823,2019-06-22,352,0,352,28,380,380,0,0
23824,2019-06-22,3630,0,3630,290,3920,3920,0,0
23825,2019-06-22,264,0,264,21,285,285,0,0
23826,2019-06-22,1121,0,1121,89,1210,0,1210,0
23827,2019-06-22,1815,0,1815,145,1960,1960,0,0
23828,2019-06-22,751,0,751,59,810,810,0,0
23829,2019-06-22,686,0,686,54,740,740,0,0
23830,2019-06-22,565,0,565,45,610,610,0,0
23831,2019-06-22,2723,0,2723,217,2940,2940,0,0
23832,2019-06-22,352,0,352,28,380,380,0,0
23833,2019-06-22,751,0,751,59,810,810,0,0
23834,2019-06-22,346,-37,309,24,333,333,0,0
23835,2019-06-22,286,0,286,14,300,300,0,0
23836,2019-06-22,501,0,501,39,540,540,0,0
23837,2019-06-22,343,0,343,27,370,370,0,0
23838,2019-06-22,519,0,519,41,560,560,0,0
23839,2019-06-22,232,0,232,18,250,250,0,0
23840,2019-06-22,630,0,630,50,680,680,0,0
23841,2019-06-22,982,0,982,78,1060,1060,0,0
23842,2019-06-22,1667,0,1667,133,1800,1800,0,0
23843,2019-06-22,112,0,112,8,120,120,0,0
23844,2019-06-22,371,0,371,29,400,400,0,0
23845,2019-06-22,788,0,788,62,850,850,0,0
23846,2019-06-22,260,0,260,20,280,280,0,0
23847,2019-06-22,2204,0,2204,176,2380,2380,0,0
23848,2019-06-22,917,0,917,73,990,990,0,0
23849,2019-06-22,778,0,778,62,840,0,840,0
23850,2019-06-22,825,0,825,65,890,890,0,0
23851,2019-06-22,667,0,667,53,720,720,0,0
23852,2019-06-22,389,0,389,31,420,420,0,0
23853,2019-06-22,223,0,223,17,240,240,0,0
23854,2019-06-22,1426,0,1426,114,1540,1540,0,0
23855,2019-06-22,463,0,463,37,500,500,0,0
23856,2019-06-22,1075,0,1075,85,1160,1160,0,0
23857,2019-06-22,334,0,334,26,360,360,0,0
23858,2019-06-22,232,0,232,18,250,250,0,0
23859,2019-06-22,232,0,232,18,250,250,0,0
23860,2019-06-22,389,0,389,31,420,420,0,0
23861,2019-06-22,982,0,982,78,1060,1060,0,0
23862,2019-06-22,399,0,399,31,430,430,0,0
23863,2019-06-22,389,0,389,31,420,0,0,420
23864,2019-06-22,389,0,389,31,420,420,0,0
23865,2019-06-22,491,0,491,39,530,530,0,0
23866,2019-06-22,371,0,371,29,400,400,0,0
23867,2019-06-22,501,0,501,39,540,540,0,0
23868,2019-06-22,713,0,713,57,770,770,0,0
23869,2019-06-22,389,0,389,31,420,420,0,0
23870,2019-06-22,2908,0,2908,232,3140,3140,0,0
23871,2019-06-22,528,0,528,42,570,570,0,0
23872,2019-06-22,389,0,389,31,420,420,0,0
23873,2019-06-22,195,0,195,15,210,210,0,0
23874,2019-06-22,306,0,306,24,330,330,0,0
23875,2019-06-22,329,0,329,26,355,355,0,0
23876,2019-06-22,334,0,334,26,360,360,0,0
23877,2019-06-22,315,0,315,25,340,0,0,340
23878,2019-06-22,741,0,741,59,800,800,0,0
23879,2019-06-22,2176,0,2176,174,2350,0,2350,0
23880,2019-06-22,2371,0,2371,189,2560,2560,0,0
23881,2019-06-22,426,0,426,34,460,460,0,0
23882,2019-06-22,1075,0,1075,85,1160,1160,0,0
23883,2019-06-22,1815,0,1815,145,1960,1960,0,0
23884,2019-06-22,306,0,306,24,330,330,0,0
23885,2019-06-22,528,0,528,42,570,570,0,0
23886,2019-06-22,1016,-216,800,64,864,864,0,0
23887,2019-06-22,934,-100,834,66,900,900,0,0
23888,2019-06-22,1563,0,1563,107,1670,0,1670,0
23889,2019-06-22,1473,0,1473,117,1590,1590,0,0
23890,2019-06-22,1223,0,1223,97,1320,1320,0,0
23891,2019-06-22,2139,0,2139,171,2310,2310,0,0
23892,2019-06-22,990,0,990,70,1060,1060,0,0
23893,2019-06-22,1260,0,1260,100,1360,1360,0,0
23894,2019-06-22,1538,0,1538,122,1660,1660,0,0
23895,2019-06-22,788,0,788,62,850,850,0,0
23896,2019-06-22,547,0,547,43,590,590,0,0
23897,2019-06-22,602,0,602,48,650,650,0,0
23898,2019-06-22,472,0,472,28,500,500,0,0
23899,2019-06-22,704,0,704,56,760,760,0,0
23900,2019-06-22,176,0,176,14,190,190,0,0
23901,2019-06-22,56,0,56,4,60,60,0,0
23902,2019-06-22,278,0,278,22,300,300,0,0
23903,2019-06-22,232,0,232,18,250,250,0,0
23904,2019-06-22,778,0,778,62,840,840,0,0
23905,2019-06-22,1112,0,1112,88,1200,0,1200,0
23906,2019-06-22,232,0,232,18,250,250,0,0
23907,2019-06-22,232,0,232,18,250,250,0,0
23908,2019-06-22,1093,0,1093,87,1180,0,1180,0
23909,2019-06-22,788,0,788,62,850,850,0,0
23910,2019-06-22,251,0,251,19,270,270,0,0
23911,2019-06-22,1575,0,1575,125,1700,1700,0,0
23912,2019-06-22,423,0,423,7,430,430,0,0
23913,2019-06-22,278,0,278,22,300,300,0,0
23914,2019-06-22,788,0,788,62,850,850,0,0
23915,2019-06-22,352,0,352,28,380,380,0,0
23916,2019-06-22,280,-30,250,20,270,270,0,0
23917,2019-06-22,1575,0,1575,125,1700,1700,0,0
23918,2019-06-22,1436,0,1436,114,1550,0,1550,0
23919,2019-06-22,501,0,501,39,540,540,0,0
23920,2019-06-22,1825,0,1825,145,1970,0,1970,0
23921,2019-06-22,2760,0,2760,220,2980,2980,0,0
23922,2019-06-22,899,0,899,71,970,970,0,0
23923,2019-06-22,879,0,879,61,940,940,0,0
23924,2019-06-22,1575,0,1575,125,1700,1700,0,0
23925,2019-06-22,723,0,723,57,780,780,0,0
23926,2019-06-22,501,0,501,39,540,540,0,0
23927,2019-06-22,1788,0,1788,142,1930,1930,0,0
23928,2019-06-22,954,0,954,76,1030,1030,0,0
23929,2019-06-22,232,0,232,18,250,0,0,250
23930,2019-06-22,741,0,741,59,800,800,0,0
23931,2019-06-22,908,0,908,72,980,980,0,0
23932,2019-06-22,612,0,612,48,660,660,0,0
23933,2019-06-22,445,0,445,35,480,480,0,0
23934,2019-06-22,269,0,269,21,290,290,0,0
23935,2019-06-22,528,0,528,42,570,0,570,0
23936,2019-06-22,139,0,139,11,150,150,0,0
23937,2019-06-22,897,-96,801,63,864,864,0,0
23938,2019-06-22,-889,0,-889,-71,-960,-960,0,0
23939,2019-06-22,178,-19,159,12,171,171,0,0
23940,2019-06-22,815,0,815,65,880,880,0,0
23941,2019-06-22,889,0,889,71,960,960,0,0
23942,2019-06-22,1575,0,1575,125,1700,0,1700,0
23943,2019-06-22,621,0,621,49,670,670,0,0
23944,2019-06-22,769,0,769,61,830,830,0,0
23945,2019-06-22,1121,0,1121,89,1210,1210,0,0
23946,2019-06-22,898,0,898,62,960,960,0,0
23947,2019-06-22,732,0,732,58,790,790,0,0
23948,2019-06-22,2315,0,2315,185,2500,2500,0,0
23949,2019-06-22,1575,0,1575,125,1700,1700,0,0
23950,2019-06-22,2362,0,2362,188,2550,2550,0,0
23951,2019-06-22,454,0,454,36,490,490,0,0
23952,2019-06-22,1741,0,1741,139,1880,1880,0,0
23953,2019-06-22,649,0,649,51,700,700,0,0
23954,2019-06-22,102,0,102,8,110,110,0,0
23955,2019-06-22,174,0,174,13,187,187,0,0
23956,2019-06-22,463,0,463,37,500,500,0,0
23957,2019-06-22,269,0,269,21,290,290,0,0
23958,2019-06-22,269,0,269,21,290,290,0,0
23959,2019-06-22,584,0,584,46,630,630,0,0
23960,2019-06-22,1167,0,1167,93,1260,1260,0,0
23961,2019-06-22,223,0,223,17,240,240,0,0
23962,2019-06-22,852,0,852,68,920,0,920,0
23963,2019-06-22,269,0,269,21,290,290,0,0
23964,2019-06-22,788,0,788,62,850,850,0,0
23965,2019-06-22,2639,0,2639,211,2850,2850,0,0
23966,2019-06-22,788,0,788,62,850,0,850,0
23967,2019-06-22,788,0,788,62,850,850,0,0
23968,2019-06-22,1575,0,1575,125,1700,1700,0,0
23969,2019-06-22,1186,0,1186,94,1280,1280,0,0
23970,2019-06-22,1158,0,1158,92,1250,1250,0,0
23971,2019-06-22,1482,0,1482,118,1600,1600,0,0
23972,2019-06-22,788,0,788,62,850,850,0,0
23973,2019-06-22,556,0,556,44,600,600,0,0
23974,2019-06-22,1575,0,1575,125,1700,1700,0,0
23975,2019-06-22,788,0,788,62,850,850,0,0
23976,2019-06-22,380,0,380,30,410,410,0,0
23977,2019-06-22,463,0,463,37,500,500,0,0
23978,2019-06-22,1065,0,1065,85,1150,1150,0,0
23979,2019-06-22,297,0,297,23,320,320,0,0
23980,2019-06-23,871,0,871,69,940,940,0,0
23981,2019-06-23,908,0,908,72,980,980,0,0
23982,2019-06-23,306,0,306,24,330,330,0,0
23983,2019-06-23,334,0,334,26,360,360,0,0
23984,2019-06-23,1815,0,1815,145,1960,1960,0,0
23985,2019-06-23,658,0,658,52,710,710,0,0
23986,2019-06-23,1815,0,1815,145,1960,1960,0,0
23987,2019-06-23,1518,0,1518,112,1630,1630,0,0
23988,2019-06-23,908,0,908,72,980,980,0,0
23989,2019-06-23,908,0,908,72,980,980,0,0
23990,2019-06-23,981,0,981,69,1050,1050,0,0
23991,2019-06-23,278,0,278,22,300,300,0,0
23992,2019-06-23,176,0,176,14,190,190,0,0
23993,2019-06-23,908,0,908,72,980,980,0,0
23994,2019-06-23,222,0,222,8,230,230,0,0
23995,2019-06-23,519,0,519,41,560,560,0,0
23996,2019-06-23,260,0,260,20,280,280,0,0
23997,2019-06-23,121,0,121,9,130,130,0,0
23998,2019-06-23,556,0,556,44,600,600,0,0
23999,2019-06-23,1149,0,1149,91,1240,1240,0,0
24000,2019-06-23,1075,0,1075,85,1160,1160,0,0
24001,2019-06-23,269,0,269,21,290,290,0,0
24002,2019-06-23,288,0,288,22,310,310,0,0
24003,2019-06-23,1306,0,1306,104,1410,1410,0,0
24004,2019-06-23,936,0,936,74,1010,1010,0,0
24005,2019-06-23,467,-50,417,33,450,450,0,0
24006,2019-06-23,1597,-171,1426,113,1539,1539,0,0
24007,2019-06-23,1139,0,1139,91,1230,1230,0,0
24008,2019-06-23,667,0,667,53,720,720,0,0
24009,2019-06-23,3149,0,3149,251,3400,0,3400,0
24010,2019-06-23,658,0,658,52,710,710,0,0
24011,2019-06-23,538,0,538,42,580,580,0,0
24012,2019-06-23,167,0,167,13,180,180,0,0
24013,2019-06-23,269,0,269,21,290,290,0,0
24014,2019-06-23,260,0,260,20,280,280,0,0
24015,2019-06-23,713,0,713,57,770,770,0,0
24016,2019-06-23,749,0,749,51,800,800,0,0
24017,2019-06-23,657,0,657,43,700,700,0,0
24018,2019-06-23,667,0,667,53,720,720,0,0
24019,2019-06-23,1130,0,1130,90,1220,1220,0,0
24020,2019-06-23,1269,0,1269,101,1370,1370,0,0
24021,2019-06-23,658,0,658,52,710,710,0,0
24022,2019-06-23,288,0,288,22,310,310,0,0
24023,2019-06-23,602,0,602,48,650,650,0,0
24024,2019-06-23,741,0,741,59,800,800,0,0
24025,2019-06-23,315,0,315,25,340,340,0,0
24026,2019-06-23,167,0,167,13,180,180,0,0
24027,2019-06-23,315,0,315,25,340,340,0,0
24028,2019-06-23,556,0,556,44,600,600,0,0
24029,2019-06-23,667,0,667,53,720,720,0,0
24030,2019-06-23,797,0,797,63,860,860,0,0
24031,2019-06-23,565,0,565,45,610,610,0,0
24032,2019-06-23,908,0,908,72,980,980,0,0
24033,2019-06-23,501,0,501,39,540,540,0,0
24034,2019-06-23,297,0,297,23,320,0,0,320
24035,2019-06-23,908,0,908,72,980,980,0,0
24036,2019-06-23,584,0,584,46,630,630,0,0
24037,2019-06-23,491,0,491,39,530,530,0,0
24038,2019-06-23,612,0,612,48,660,660,0,0
24039,2019-06-23,686,0,686,54,740,740,0,0
24040,2019-06-23,130,0,130,10,140,140,0,0
24041,2019-06-23,1815,0,1815,145,1960,0,1960,0
24042,2019-06-23,1815,0,1815,145,1960,1960,0,0
24043,2019-06-23,797,0,797,63,860,860,0,0
24044,2019-06-23,343,0,343,27,370,370,0,0
24045,2019-06-23,1251,0,1251,99,1350,1350,0,0
24046,2019-06-23,584,0,584,46,630,630,0,0
24047,2019-06-23,2723,0,2723,217,2940,2940,0,0
24048,2019-06-23,334,0,334,26,360,360,0,0
24049,2019-06-23,1815,0,1815,145,1960,1960,0,0
24050,2019-06-23,788,0,788,62,850,850,0,0
24051,2019-06-23,760,0,760,60,820,820,0,0
24052,2019-06-23,389,0,389,31,420,420,0,0
24053,2019-06-23,-778,0,-778,-62,-840,-840,0,0
24054,2019-06-23,426,0,426,34,460,460,0,0
24055,2019-06-23,723,0,723,57,780,780,0,0
24056,2019-06-23,473,0,473,37,510,510,0,0
24057,2019-06-23,778,0,778,62,840,840,0,0
24058,2019-06-23,1056,0,1056,84,1140,1140,0,0
24059,2019-06-23,491,0,491,39,530,530,0,0
24060,2019-06-23,334,0,334,26,360,360,0,0
24061,2019-06-23,389,0,389,31,420,420,0,0
24062,2019-06-23,501,0,501,39,540,540,0,0
24063,2019-06-23,899,0,899,71,970,970,0,0
24064,2019-06-23,834,0,834,66,900,900,0,0
24065,2019-06-23,1112,0,1112,88,1200,1200,0,0
24066,2019-06-23,788,0,788,62,850,850,0,0
24067,2019-06-23,649,0,649,51,700,700,0,0
24068,2019-06-23,167,0,167,13,180,180,0,0
24069,2019-06-23,482,0,482,38,520,520,0,0
24070,2019-06-23,607,-65,542,43,585,585,0,0
24071,2019-06-23,2075,0,2075,165,2240,2240,0,0
24072,2019-06-23,871,0,871,69,940,940,0,0
24073,2019-06-23,445,0,445,35,480,480,0,0
24074,2019-06-23,862,0,862,68,930,930,0,0
24075,2019-06-23,299,-32,267,21,288,288,0,0
24076,2019-06-23,334,0,334,26,360,360,0,0
24077,2019-06-23,982,0,982,78,1060,1060,0,0
24078,2019-06-23,639,0,639,51,690,0,690,0
24079,2019-06-23,343,0,343,27,370,0,0,370
24080,2019-06-23,510,0,510,40,550,550,0,0
24081,2019-06-23,1269,0,1269,101,1370,1370,0,0
24082,2019-06-23,445,0,445,35,480,480,0,0
24083,2019-06-23,584,0,584,46,630,630,0,0
24084,2019-06-23,1204,0,1204,96,1300,1300,0,0
24085,2019-06-23,556,0,556,44,600,600,0,0
24086,2019-06-23,954,0,954,76,1030,1030,0,0
24087,2019-06-23,769,0,769,61,830,830,0,0
24088,2019-06-23,352,0,352,28,380,380,0,0
24089,2019-06-23,232,0,232,18,250,250,0,0
24090,2019-06-23,260,0,260,20,280,280,0,0
24091,2019-06-23,121,0,121,9,130,130,0,0
24092,2019-06-23,167,0,167,13,180,180,0,0
24093,2019-06-23,1575,0,1575,125,1700,1700,0,0
24094,2019-06-23,491,0,491,39,530,530,0,0
24095,2019-06-23,362,0,362,28,390,390,0,0
24096,2019-06-23,1575,0,1575,125,1700,1700,0,0
24097,2019-06-23,601,0,601,39,640,640,0,0
24098,2019-06-23,1065,0,1065,85,1150,1150,0,0
24099,2019-06-23,473,0,473,37,510,510,0,0
24100,2019-06-23,139,0,139,11,150,150,0,0
24101,2019-06-23,232,0,232,18,250,250,0,0
24102,2019-06-23,334,0,334,26,360,360,0,0
24103,2019-06-23,769,0,769,61,830,830,0,0
24104,2019-06-23,1852,0,1852,148,2000,2000,0,0
24105,2019-06-23,139,0,139,11,150,150,0,0
24106,2019-06-23,926,0,926,74,1000,1000,0,0
24107,2019-06-23,1019,0,1019,81,1100,1100,0,0
24108,2019-06-23,408,0,408,32,440,0,0,440
24109,2019-06-23,556,0,556,44,600,600,0,0
24110,2019-06-23,204,0,204,16,220,220,0,0
24111,2019-06-23,334,0,334,26,360,360,0,0
24112,2019-06-23,389,0,389,31,420,420,0,0
24113,2019-06-23,130,0,130,10,140,140,0,0
24114,2019-06-23,1010,0,1010,80,1090,1090,0,0
24115,2019-06-23,1010,0,1010,80,1090,1090,0,0
24116,2019-06-23,1445,0,1445,115,1560,1560,0,0
24117,2019-06-23,880,0,880,70,950,950,0,0
24118,2019-06-23,288,0,288,22,310,310,0,0
24119,2019-06-23,463,0,463,37,500,500,0,0
24120,2019-06-23,278,0,278,22,300,300,0,0
24121,2019-06-24,2075,0,2075,165,2240,2240,0,0
24122,2019-06-24,788,0,788,62,850,850,0,0
24123,2019-06-24,278,0,278,22,300,300,0,0
24124,2019-06-24,751,0,751,59,810,810,0,0
24125,2019-06-24,1830,-196,1634,130,1764,1764,0,0
24126,2019-06-24,436,0,436,34,470,470,0,0
24127,2019-06-24,288,0,288,22,310,0,0,310
24128,2019-06-24,751,0,751,59,810,810,0,0
24129,2019-06-24,463,0,463,37,500,500,0,0
24130,2019-06-24,825,0,825,65,890,890,0,0
24131,2019-06-24,1075,0,1075,85,1160,1160,0,0
24132,2019-06-24,945,0,945,75,1020,1020,0,0
24133,2019-06-24,973,0,973,77,1050,1050,0,0
24134,2019-06-24,908,0,908,72,980,980,0,0
24135,2019-06-24,1695,0,1695,135,1830,1830,0,0
24136,2019-06-24,445,0,445,35,480,480,0,0
24137,2019-06-24,1417,0,1417,113,1530,1530,0,0
24138,2019-06-24,723,0,723,57,780,780,0,0
24139,2019-06-24,649,0,649,51,700,700,0,0
24140,2019-06-24,694,0,694,46,740,740,0,0
24141,2019-06-24,676,0,676,54,730,730,0,0
24142,2019-06-24,445,0,445,35,480,480,0,0
24143,2019-06-24,297,0,297,23,320,320,0,0
24144,2019-06-24,908,0,908,72,980,980,0,0
24145,2019-06-24,1167,0,1167,93,1260,1260,0,0
24146,2019-06-24,519,0,519,41,560,560,0,0
24147,2019-06-24,2056,0,2056,164,2220,2220,0,0
24148,2019-06-24,454,0,454,36,490,490,0,0
24149,2019-06-24,334,0,334,26,360,360,0,0
24150,2019-06-24,575,0,575,45,620,620,0,0
24151,2019-06-24,491,0,491,39,530,530,0,0
24152,2019-06-24,399,0,399,31,430,430,0,0
24153,2019-06-24,334,0,334,26,360,360,0,0
24154,2019-06-24,423,0,423,7,430,430,0,0
24155,2019-06-24,149,0,149,11,160,160,0,0
24156,2019-06-24,232,0,232,18,250,250,0,0
24157,2019-06-24,723,0,723,57,780,780,0,0
24158,2019-06-24,112,0,112,8,120,120,0,0
24159,2019-06-24,963,0,963,77,1040,1040,0,0
24160,2019-06-24,2065,0,2065,165,2230,2230,0,0
24161,2019-06-24,575,0,575,45,620,620,0,0
24162,2019-06-24,908,0,908,72,980,980,0,0
24163,2019-06-24,204,0,204,16,220,220,0,0
24164,2019-06-24,204,0,204,16,220,220,0,0
24165,2019-06-24,565,0,565,45,610,610,0,0
24166,2019-06-24,232,0,232,18,250,250,0,0
24167,2019-06-24,862,0,862,68,930,930,0,0
24168,2019-06-24,2723,0,2723,217,2940,2940,0,0
24169,2019-06-24,1414,0,1414,86,1500,1500,0,0
24170,2019-06-24,306,0,306,24,330,330,0,0
24171,2019-06-24,593,0,593,47,640,640,0,0
24172,2019-06-24,584,0,584,46,630,630,0,0
24173,2019-06-24,343,0,343,27,370,370,0,0
24174,2019-06-24,417,0,417,33,450,450,0,0
24175,2019-06-24,621,0,621,49,670,670,0,0
24176,2019-06-24,732,0,732,58,790,790,0,0
24177,2019-06-24,371,0,371,29,400,400,0,0
24178,2019-06-24,467,-50,417,33,450,450,0,0
24179,2019-06-24,630,0,630,50,680,680,0,0
24180,2019-06-24,426,0,426,34,460,460,0,0
24181,2019-06-24,417,0,417,33,450,450,0,0
24182,2019-06-24,1018,0,1018,72,1090,1090,0,0
24183,2019-06-24,547,0,547,43,590,590,0,0
24184,2019-06-24,1056,0,1056,84,1140,1140,0,0
24185,2019-06-24,1519,0,1519,121,1640,1640,0,0
24186,2019-06-24,723,0,723,57,780,780,0,0
24187,2019-06-24,491,0,491,39,530,530,0,0
24188,2019-06-24,1936,0,1936,154,2090,2090,0,0
24189,2019-06-24,260,0,260,20,280,280,0,0
24190,2019-06-24,3953,0,3953,307,4260,4260,0,0
24191,2019-06-24,213,0,213,17,230,230,0,0
24192,2019-06-24,454,0,454,36,490,0,490,0
24193,2019-06-24,371,0,371,29,400,400,0,0
24194,2019-06-24,260,0,260,20,280,280,0,0
24195,2019-06-24,167,0,167,13,180,180,0,0
24196,2019-06-24,389,0,389,31,420,420,0,0
24197,2019-06-24,278,0,278,22,300,300,0,0
24198,2019-06-24,408,0,408,32,440,440,0,0
24199,2019-06-24,176,0,176,14,190,190,0,0
24200,2019-06-24,112,0,112,8,120,120,0,0
24201,2019-06-24,491,0,491,39,530,530,0,0
24202,2019-06-24,260,0,260,20,280,280,0,0
24203,2019-06-24,1019,0,1019,81,1100,1100,0,0
24204,2019-06-24,362,0,362,28,390,390,0,0
24205,2019-06-24,241,0,241,19,260,260,0,0
24206,2019-06-24,806,0,806,64,870,870,0,0
24207,2019-06-24,278,0,278,22,300,300,0,0
24208,2019-06-24,371,0,371,29,400,400,0,0
24209,2019-06-24,1862,0,1862,148,2010,2010,0,0
24210,2019-06-24,1695,0,1695,135,1830,1830,0,0
24211,2019-06-24,621,0,621,49,670,670,0,0
24212,2019-06-24,510,0,510,40,550,550,0,0
24213,2019-06-24,436,0,436,34,470,470,0,0
24214,2019-06-24,973,0,973,77,1050,1050,0,0
24215,2019-06-24,315,0,315,25,340,340,0,0
24216,2019-06-24,769,0,769,61,830,830,0,0
24217,2019-06-24,269,0,269,21,290,290,0,0
24218,2019-06-24,701,0,701,29,730,730,0,0
24219,2019-06-24,815,0,815,65,880,880,0,0
24220,2019-06-24,269,0,269,21,290,290,0,0
24221,2019-06-24,491,0,491,39,530,530,0,0
24222,2019-06-24,1026,-218,808,64,872,872,0,0
24223,2019-06-24,982,0,982,78,1060,1060,0,0
24224,2019-06-24,2788,0,2788,222,3010,3010,0,0
24225,2019-06-24,926,0,926,74,1000,0,1000,0
24226,2019-06-24,212,0,212,8,220,220,0,0
24227,2019-06-24,575,0,575,45,620,620,0,0
24228,2019-06-24,288,0,288,22,310,310,0,0
24229,2019-06-24,500,0,500,40,540,540,0,0
24230,2019-06-24,399,0,399,31,430,430,0,0
24231,2019-06-24,1010,0,1010,80,1090,1090,0,0
24232,2019-06-24,852,0,852,68,920,920,0,0
24233,2019-06-24,519,0,519,41,560,560,0,0
24234,2019-06-24,269,0,269,21,290,290,0,0
24235,2019-06-24,788,0,788,62,850,850,0,0
24236,2019-06-24,788,0,788,62,850,850,0,0
24237,2019-06-24,334,0,334,26,360,360,0,0
24238,2019-06-24,575,0,575,45,620,620,0,0
24239,2019-06-25,151,-32,119,9,128,128,0,0
24240,2019-06-25,954,0,954,76,1030,1030,0,0
24241,2019-06-25,343,0,343,27,370,370,0,0
24242,2019-06-25,399,0,399,31,430,430,0,0
24243,2019-06-25,380,0,380,30,410,410,0,0
24244,2019-06-25,519,0,519,41,560,560,0,0
24245,2019-06-25,1010,0,1010,80,1090,1090,0,0
24246,2019-06-25,565,0,565,45,610,610,0,0
24247,2019-06-25,306,0,306,24,330,330,0,0
24248,2019-06-25,362,0,362,28,390,390,0,0
24249,2019-06-25,1195,0,1195,95,1290,1290,0,0
24250,2019-06-25,666,0,666,44,710,710,0,0
24251,2019-06-25,704,0,704,56,760,760,0,0
24252,2019-06-25,936,0,936,74,1010,0,1010,0
24253,2019-06-25,1186,0,1186,94,1280,1280,0,0
24254,2019-06-25,1288,0,1288,102,1390,1390,0,0
24255,2019-06-25,232,0,232,18,250,250,0,0
24256,2019-06-25,1491,0,1491,119,1610,1610,0,0
24257,2019-06-25,667,0,667,53,720,720,0,0
24258,2019-06-25,2963,0,2963,237,3200,3200,0,0
24259,2019-06-25,417,0,417,33,450,450,0,0
24260,2019-06-25,612,0,612,48,660,660,0,0
24261,2019-06-25,260,0,260,20,280,280,0,0
24262,2019-06-25,139,0,139,11,150,150,0,0
24263,2019-06-25,1130,0,1130,90,1220,1220,0,0
24264,2019-06-25,510,0,510,40,550,550,0,0
24265,2019-06-25,1223,0,1223,97,1320,1320,0,0
24266,2019-06-26,445,0,445,35,480,480,0,0
24267,2019-06-26,962,0,962,68,1030,1030,0,0
24268,2019-06-26,440,0,440,0,440,440,0,0
24269,2019-06-26,575,0,575,45,620,620,0,0
24270,2019-06-26,3362,0,3362,268,3630,3630,0,0
24271,2019-06-26,593,0,593,47,640,640,0,0
24272,2019-06-26,482,0,482,38,520,520,0,0
24273,2019-06-26,362,0,362,28,390,390,0,0
24274,2019-06-26,639,0,639,51,690,690,0,0
24275,2019-06-26,825,0,825,65,890,890,0,0
24276,2019-06-26,565,0,565,45,610,610,0,0
24277,2019-06-26,639,0,639,51,690,690,0,0
24278,2019-06-26,527,0,527,33,560,560,0,0
24279,2019-06-26,232,0,232,18,250,250,0,0
24280,2019-06-26,1815,0,1815,145,1960,1960,0,0
24281,2019-06-26,593,0,593,47,640,640,0,0
24282,2019-06-26,167,0,167,13,180,180,0,0
24283,2019-06-26,915,-98,817,65,882,882,0,0
24284,2019-06-26,445,0,445,35,480,480,0,0
24285,2019-06-26,602,0,602,48,650,650,0,0
24286,2019-06-26,1380,0,1380,110,1490,1490,0,0
24287,2019-06-26,667,0,667,53,720,0,720,0
24288,2019-06-26,362,0,362,28,390,390,0,0
24289,2019-06-26,1231,0,1231,89,1320,0,1320,0
24290,2019-06-26,1676,0,1676,134,1810,1810,0,0
24291,2019-06-26,223,0,223,17,240,240,0,0
24292,2019-06-26,167,0,167,13,180,180,0,0
24293,2019-06-26,371,0,371,29,400,400,0,0
24294,2019-06-26,741,0,741,59,800,800,0,0
24295,2019-06-26,538,0,538,42,580,580,0,0
24296,2019-06-26,491,0,491,39,530,530,0,0
24297,2019-06-26,760,0,760,60,820,820,0,0
24298,2019-06-26,458,-49,409,32,441,441,0,0
24299,2019-06-26,797,0,797,63,860,860,0,0
24300,2019-06-26,1047,0,1047,83,1130,1130,0,0
24301,2019-06-26,686,0,686,54,740,740,0,0
24302,2019-06-26,408,0,408,32,440,440,0,0
24303,2019-06-26,519,0,519,41,560,560,0,0
24304,2019-06-26,612,0,612,48,660,660,0,0
24305,2019-06-26,607,-65,542,43,585,0,0,585
24306,2019-06-26,139,0,139,11,150,150,0,0
24307,2019-06-26,908,0,908,72,980,980,0,0
24308,2019-06-26,445,0,445,35,480,480,0,0
24309,2019-06-26,945,0,945,75,1020,1020,0,0
24310,2019-06-26,1047,0,1047,83,1130,1130,0,0
24311,2019-06-26,1565,0,1565,125,1690,1690,0,0
24312,2019-06-26,519,0,519,41,560,560,0,0
24313,2019-06-26,713,0,713,57,770,770,0,0
24314,2019-06-26,269,0,269,21,290,290,0,0
24315,2019-06-26,1973,0,1973,157,2130,2130,0,0
24316,2019-06-26,741,0,741,59,800,800,0,0
24317,2019-06-26,926,0,926,74,1000,1000,0,0
24318,2019-06-26,565,0,565,45,610,610,0,0
24319,2019-06-26,1436,0,1436,114,1550,1550,0,0
24320,2019-06-26,371,0,371,29,400,400,0,0
24321,2019-06-26,1018,0,1018,72,1090,1090,0,0
24322,2019-06-26,399,0,399,31,430,430,0,0
24323,2019-06-26,1342,0,1342,98,1440,0,1440,0
24324,2019-06-26,788,0,788,62,850,850,0,0
24325,2019-06-26,1575,0,1575,125,1700,1700,0,0
24326,2019-06-26,454,0,454,36,490,490,0,0
24327,2019-06-26,1269,0,1269,101,1370,1370,0,0
24328,2019-06-26,612,0,612,48,660,660,0,0
24329,2019-06-26,454,0,454,36,490,490,0,0
24330,2019-06-26,899,0,899,71,970,970,0,0
24331,2019-06-26,602,0,602,48,650,650,0,0
24332,2019-06-26,1815,0,1815,145,1960,1960,0,0
24333,2019-06-26,704,0,704,56,760,760,0,0
24334,2019-06-26,723,0,723,57,780,780,0,0
24335,2019-06-26,741,0,741,59,800,800,0,0
24336,2019-06-26,343,0,343,27,370,370,0,0
24337,2019-06-26,1047,0,1047,83,1130,1130,0,0
24338,2019-06-26,149,0,149,11,160,160,0,0
24339,2019-06-26,676,0,676,54,730,730,0,0
24340,2019-06-26,2195,0,2195,175,2370,2370,0,0
24341,2019-06-26,788,0,788,62,850,850,0,0
24342,2019-06-26,277,0,277,13,290,0,290,0
24343,2019-06-26,389,0,389,31,420,420,0,0
24344,2019-06-26,176,0,176,14,190,190,0,0
24345,2019-06-26,3149,0,3149,251,3400,3400,0,0
24346,2019-06-26,1146,0,1146,74,1220,1220,0,0
24347,2019-06-26,473,0,473,37,510,510,0,0
24348,2019-06-26,556,0,556,44,600,600,0,0
24349,2019-06-26,1325,0,1325,105,1430,1430,0,0
24350,2019-06-26,1075,0,1075,85,1160,1160,0,0
24351,2019-06-27,232,0,232,18,250,250,0,0
24352,2019-06-27,1010,0,1010,80,1090,1090,0,0
24353,2019-06-27,713,0,713,57,770,770,0,0
24354,2019-06-27,426,0,426,34,460,460,0,0
24355,2019-06-27,644,0,644,51,695,695,0,0
24356,2019-06-27,306,0,306,24,330,330,0,0
24357,2019-06-27,420,-45,375,30,405,405,0,0
24358,2019-06-27,383,-41,342,27,369,369,0,0
24359,2019-06-27,556,0,556,44,600,600,0,0
24360,2019-06-27,510,0,510,40,550,550,0,0
24361,2019-06-27,760,0,760,60,820,820,0,0
24362,2019-06-27,760,0,760,60,820,820,0,0
24363,2019-06-27,741,0,741,59,800,800,0,0
24364,2019-06-27,612,0,612,48,660,660,0,0
24365,2019-06-27,426,0,426,34,460,460,0,0
24366,2019-06-27,334,0,334,26,360,360,0,0
24367,2019-06-27,399,0,399,31,430,430,0,0
24368,2019-06-27,945,0,945,75,1020,1020,0,0
24369,2019-06-27,425,-45,380,30,410,410,0,0
24370,2019-06-27,269,0,269,21,290,290,0,0
24371,2019-06-27,908,0,908,72,980,980,0,0
24372,2019-06-27,852,0,852,68,920,920,0,0
24373,2019-06-27,288,0,288,22,310,310,0,0
24374,2019-06-27,399,0,399,31,430,430,0,0
24375,2019-06-27,519,0,519,41,560,560,0,0
24376,2019-06-27,963,0,963,77,1040,1040,0,0
24377,2019-06-27,713,0,713,57,770,770,0,0
24378,2019-06-27,1905,-204,1701,135,1836,1836,0,0
24379,2019-06-27,371,0,371,29,400,400,0,0
24380,2019-06-27,1325,0,1325,105,1430,1430,0,0
24381,2019-06-27,260,0,260,20,280,280,0,0
24382,2019-06-27,473,0,473,37,510,510,0,0
24383,2019-06-27,1815,0,1815,145,1960,1960,0,0
24384,2019-06-27,834,0,834,66,900,900,0,0
24385,2019-06-27,343,0,343,27,370,370,0,0
24386,2019-06-27,306,0,306,24,330,330,0,0
24387,2019-06-27,686,0,686,54,740,740,0,0
24388,2019-06-27,380,0,380,30,410,410,0,0
24389,2019-06-27,1084,0,1084,86,1170,1170,0,0
24390,2019-06-27,139,0,139,11,150,150,0,0
24391,2019-06-27,686,0,686,54,740,740,0,0
24392,2019-06-27,584,0,584,46,630,630,0,0
24393,2019-06-27,336,-36,300,24,324,324,0,0
24394,2019-06-27,908,0,908,72,980,980,0,0
24395,2019-06-27,1815,0,1815,145,1960,1960,0,0
24396,2019-06-27,575,0,575,45,620,620,0,0
24397,2019-06-27,232,0,232,18,250,250,0,0
24398,2019-06-27,426,0,426,34,460,460,0,0
24399,2019-06-27,1223,0,1223,97,1320,1320,0,0
24400,2019-06-27,501,0,501,39,540,540,0,0
24401,2019-06-27,1129,0,1129,81,1210,1210,0,0
24402,2019-06-27,325,0,325,25,350,350,0,0
24403,2019-06-27,510,0,510,40,550,550,0,0
24404,2019-06-27,454,0,454,36,490,490,0,0
24405,2019-06-27,2723,0,2723,217,2940,2940,0,0
24406,2019-06-27,1018,-109,909,72,981,981,0,0
24407,2019-06-27,899,0,899,71,970,970,0,0
24408,2019-06-27,149,0,149,11,160,160,0,0
24409,2019-06-27,788,0,788,62,850,850,0,0
24410,2019-06-27,862,0,862,68,930,930,0,0
24411,2019-06-27,491,0,491,39,530,530,0,0
24412,2019-06-27,991,0,991,79,1070,1070,0,0
24413,2019-06-27,362,0,362,28,390,390,0,0
24414,2019-06-27,1232,0,1232,98,1330,1330,0,0
24415,2019-06-27,908,0,908,72,980,980,0,0
24416,2019-06-27,598,-64,534,42,576,576,0,0
24417,2019-06-27,330,0,330,0,330,330,0,0
24418,2019-06-27,908,0,908,72,980,980,0,0
24419,2019-06-27,528,0,528,42,570,570,0,0
24420,2019-06-27,1852,0,1852,148,2000,2000,0,0
24421,2019-06-27,362,0,362,28,390,390,0,0
24422,2019-06-27,371,0,371,29,400,400,0,0
24423,2019-06-27,788,0,788,62,850,850,0,0
24424,2019-06-27,473,0,473,37,510,510,0,0
24425,2019-06-27,1047,0,1047,83,1130,1130,0,0
24426,2019-06-27,788,0,788,62,850,850,0,0
24427,2019-06-27,306,0,306,24,330,330,0,0
24428,2019-06-27,130,0,130,10,140,140,0,0
24429,2019-06-27,794,-85,709,56,765,0,765,0
24430,2019-06-27,436,0,436,34,470,470,0,0
24431,2019-06-27,444,0,444,26,470,470,0,0
24432,2019-06-27,788,0,788,62,850,850,0,0
24433,2019-06-27,167,0,167,13,180,180,0,0
24434,2019-06-27,538,0,538,42,580,580,0,0
24435,2019-06-27,501,0,501,39,540,540,0,0
24436,2019-06-27,195,0,195,15,210,210,0,0
24437,2019-06-27,1334,0,1334,106,1440,1440,0,0
24438,2019-06-27,1093,0,1093,87,1180,1180,0,0
24439,2019-06-27,2362,0,2362,188,2550,2550,0,0
24440,2019-06-27,649,0,649,51,700,700,0,0
24441,2019-06-27,334,0,334,26,360,360,0,0
24442,2019-06-27,436,0,436,34,470,470,0,0
24443,2019-06-27,889,0,889,71,960,960,0,0
24444,2019-06-27,232,0,232,18,250,250,0,0
24445,2019-06-27,908,0,908,72,980,980,0,0
24446,2019-06-27,269,0,269,21,290,290,0,0
24447,2019-06-27,343,0,343,27,370,370,0,0
24448,2019-06-27,2112,0,2112,168,2280,2280,0,0
24449,2019-06-27,315,0,315,25,340,340,0,0
24450,2019-06-27,306,0,306,24,330,330,0,0
24451,2019-06-27,528,0,528,42,570,570,0,0
24452,2019-06-27,732,0,732,58,790,790,0,0
24453,2019-06-27,1362,0,1362,108,1470,1470,0,0
24454,2019-06-27,454,0,454,36,490,490,0,0
24455,2019-06-27,4704,0,4704,376,5080,5080,0,0
24456,2019-06-27,2149,0,2149,171,2320,2320,0,0
24457,2019-06-27,408,0,408,32,440,440,0,0
24458,2019-06-27,815,0,815,65,880,880,0,0
24459,2019-06-27,979,-104,875,61,936,936,0,0
24460,2019-06-27,1175,0,1175,85,1260,1260,0,0
24461,2019-06-27,760,0,760,60,820,820,0,0
24462,2019-06-27,788,0,788,62,850,850,0,0
24463,2019-06-28,278,0,278,22,300,300,0,0
24464,2019-06-28,448,-48,400,32,432,432,0,0
24465,2019-06-28,797,0,797,63,860,860,0,0
24466,2019-06-28,448,-48,400,32,432,432,0,0
24467,2019-06-28,1815,0,1815,145,1960,1960,0,0
24468,2019-06-28,473,0,473,37,510,510,0,0
24469,2019-06-28,565,0,565,45,610,610,0,0
24470,2019-06-28,1482,0,1482,118,1600,1600,0,0
24471,2019-06-28,908,0,908,72,980,980,0,0
24472,2019-06-28,1565,0,1565,125,1690,1690,0,0
24473,2019-06-28,482,0,482,38,520,0,0,520
24474,2019-06-28,2408,0,2408,192,2600,2600,0,0
24475,2019-06-28,288,0,288,22,310,310,0,0
24476,2019-06-28,1842,0,1842,138,1980,1980,0,0
24477,2019-06-28,1093,0,1093,87,1180,1180,0,0
24478,2019-06-28,1223,0,1223,97,1320,1320,0,0
24479,2019-06-28,704,0,704,56,760,760,0,0
24480,2019-06-28,417,0,417,33,450,450,0,0
24481,2019-06-28,223,0,223,17,240,240,0,0
24482,2019-06-28,232,0,232,18,250,250,0,0
24483,2019-06-28,1602,0,1602,128,1730,1730,0,0
24484,2019-06-28,728,-78,650,52,702,702,0,0
24485,2019-06-28,402,-43,359,28,387,387,0,0
24486,2019-06-28,1723,0,1723,137,1860,1860,0,0
24487,2019-06-28,519,0,519,41,560,560,0,0
24488,2019-06-28,565,0,565,45,610,610,0,0
24489,2019-06-28,1830,-196,1634,130,1764,1764,0,0
24490,2019-06-28,1547,0,1547,123,1670,1670,0,0
24491,2019-06-28,139,0,139,11,150,150,0,0
24492,2019-06-28,1010,0,1010,80,1090,1090,0,0
24493,2019-06-28,278,-29,249,12,261,261,0,0
24494,2019-06-28,1019,0,1019,81,1100,1100,0,0
24495,2019-06-28,1261,-135,1126,89,1215,1215,0,0
24496,2019-06-28,556,0,556,44,600,600,0,0
24497,2019-06-28,806,0,806,64,870,870,0,0
24498,2019-06-28,769,0,769,61,830,830,0,0
24499,2019-06-28,167,0,167,13,180,180,0,0
24500,2019-06-28,1056,0,1056,84,1140,1140,0,0
24501,2019-06-28,806,0,806,64,870,870,0,0
24502,2019-06-28,2056,0,2056,164,2220,2220,0,0
24503,2019-06-28,223,0,223,17,240,240,0,0
24504,2019-06-28,176,0,176,14,190,190,0,0
24505,2019-06-28,501,0,501,39,540,540,0,0
24506,2019-06-28,454,0,454,36,490,490,0,0
24507,2019-06-28,1001,0,1001,79,1080,1080,0,0
24508,2019-06-28,501,0,501,39,540,540,0,0
24509,2019-06-28,362,0,362,28,390,390,0,0
24510,2019-06-28,315,0,315,25,340,340,0,0
24511,2019-06-28,3630,0,3630,290,3920,3920,0,0
24512,2019-06-28,630,0,630,50,680,680,0,0
24513,2019-06-28,501,0,501,39,540,540,0,0
24514,2019-06-28,1815,0,1815,145,1960,1960,0,0
24515,2019-06-28,139,0,139,11,150,150,0,0
24516,2019-06-28,1815,0,1815,145,1960,1960,0,0
24517,2019-06-28,889,0,889,71,960,960,0,0
24518,2019-06-28,908,0,908,72,980,980,0,0
24519,2019-06-28,1704,0,1704,136,1840,1840,0,0
24520,2019-06-28,862,0,862,68,930,930,0,0
24521,2019-06-28,1093,0,1093,87,1180,1180,0,0
24522,2019-06-28,315,0,315,25,340,340,0,0
24523,2019-06-28,519,0,519,41,560,560,0,0
24524,2019-06-28,963,0,963,77,1040,1040,0,0
24525,2019-06-28,3436,0,3436,274,3710,3710,0,0
24526,2019-06-28,1957,-208,1749,123,1872,1872,0,0
24527,2019-06-28,982,0,982,78,1060,1060,0,0
24528,2019-06-28,158,0,158,12,170,170,0,0
24529,2019-06-28,982,0,982,78,1060,1060,0,0
24530,2019-06-28,871,0,871,69,940,940,0,0
24531,2019-06-28,899,0,899,71,970,970,0,0
24532,2019-06-28,482,0,482,38,520,520,0,0
24533,2019-06-28,1130,0,1130,90,1220,1220,0,0
24534,2019-06-28,1638,0,1638,122,1760,1760,0,0
24535,2019-06-28,1972,0,1972,148,2120,2120,0,0
24536,2019-06-28,588,-63,525,42,567,567,0,0
24537,2019-06-28,917,0,917,73,990,990,0,0
24538,2019-06-28,936,0,936,74,1010,1010,0,0
24539,2019-06-28,2073,0,2073,157,2230,2230,0,0
24540,2019-06-28,556,0,556,44,600,600,0,0
24541,2019-06-28,941,-100,841,59,900,900,0,0
24542,2019-06-28,1889,0,1889,151,2040,2040,0,0
24543,2019-06-28,528,0,528,42,570,570,0,0
24544,2019-06-28,491,0,491,39,530,530,0,0
24545,2019-06-28,491,0,491,39,530,530,0,0
24546,2019-06-28,676,0,676,54,730,730,0,0
24547,2019-06-28,1195,0,1195,95,1290,1290,0,0
24548,2019-06-28,973,0,973,77,1050,1050,0,0
24549,2019-06-28,788,0,788,62,850,850,0,0
24550,2019-06-28,371,0,371,29,400,400,0,0
24551,2019-06-28,306,0,306,24,330,330,0,0
24552,2019-06-28,519,0,519,41,560,560,0,0
24553,2019-06-28,399,0,399,31,430,430,0,0
24554,2019-06-28,658,0,658,52,710,710,0,0
24555,2019-06-28,232,0,232,18,250,250,0,0
24556,2019-06-28,417,0,417,33,450,450,0,0
24557,2019-06-28,565,0,565,45,610,610,0,0
24558,2019-06-28,701,-75,626,49,675,675,0,0
24559,2019-06-28,741,0,741,59,800,800,0,0
24560,2019-06-28,1028,0,1028,82,1110,1110,0,0
24561,2019-06-28,445,0,445,35,480,480,0,0
24562,2019-06-28,1186,0,1186,94,1280,1280,0,0
24563,2019-06-28,306,0,306,24,330,330,0,0
24564,2019-06-28,621,0,621,49,670,670,0,0
24565,2019-06-28,232,0,232,18,250,250,0,0
24566,2019-06-28,269,0,269,21,290,290,0,0
24567,2019-06-28,2499,0,2499,191,2690,2690,0,0
24568,2019-06-28,584,0,584,46,630,630,0,0
24569,2019-06-28,797,0,797,63,860,860,0,0
24570,2019-06-28,288,0,288,22,310,310,0,0
24571,2019-06-28,315,0,315,25,340,340,0,0
24572,2019-06-28,519,0,519,41,560,560,0,0
24573,2019-06-28,1019,0,1019,81,1100,1100,0,0
24574,2019-06-28,387,0,387,13,400,400,0,0
24575,2019-06-28,1028,0,1028,82,1110,1110,0,0
24576,2019-06-28,315,0,315,25,340,340,0,0
24577,2019-06-28,778,0,778,62,840,840,0,0
24578,2019-06-28,1575,0,1575,125,1700,1700,0,0
24579,2019-06-28,1149,0,1149,91,1240,1240,0,0
24580,2019-06-28,306,0,306,24,330,330,0,0
24581,2019-06-28,686,0,686,54,740,740,0,0
24582,2019-06-28,1575,0,1575,125,1700,1700,0,0
24583,2019-06-28,612,0,612,48,660,660,0,0
24584,2019-06-28,1575,0,1575,125,1700,1700,0,0
24585,2019-06-28,982,0,982,78,1060,1060,0,0
24586,2019-06-28,870,0,870,60,930,930,0,0
24587,2019-06-28,1297,0,1297,103,1400,1400,0,0
24588,2019-06-28,519,0,519,41,560,560,0,0
24589,2019-06-28,1417,0,1417,113,1530,1530,0,0
24590,2019-06-28,278,0,278,22,300,300,0,0
24591,2019-06-28,1482,0,1482,118,1600,1600,0,0
24592,2019-06-28,445,0,445,35,480,480,0,0
24593,2019-06-28,1852,0,1852,148,2000,2000,0,0
24594,2019-06-28,232,0,232,18,250,250,0,0
24595,2019-06-28,1917,0,1917,153,2070,2070,0,0
24596,2019-06-28,362,0,362,28,390,390,0,0
24597,2019-06-28,1194,0,1194,86,1280,0,1280,0
24598,2019-06-28,676,0,676,54,730,730,0,0
24599,2019-06-28,676,0,676,54,730,730,0,0
24600,2019-06-28,1575,0,1575,125,1700,1700,0,0
24601,2019-06-28,1723,0,1723,137,1860,1860,0,0
24602,2019-06-28,3149,0,3149,251,3400,3400,0,0
24603,2019-06-28,704,0,704,56,760,760,0,0
24604,2019-06-28,788,0,788,62,850,850,0,0
24605,2019-06-28,963,0,963,77,1040,1040,0,0
24606,2019-06-28,389,0,389,31,420,420,0,0
24607,2019-06-28,1473,0,1473,117,1590,1590,0,0
24608,2019-06-28,788,0,788,62,850,850,0,0
24609,2019-06-28,788,0,788,62,850,0,850,0
24610,2019-06-28,658,0,658,52,710,710,0,0
24611,2019-06-28,2093,0,2093,167,2260,2260,0,0
24612,2019-06-28,926,0,926,74,1000,1000,0,0
24613,2019-06-28,389,0,389,31,420,420,0,0
24614,2019-06-28,1001,0,1001,79,1080,1080,0,0
24615,2019-06-29,612,0,612,48,660,660,0,0
24616,2019-06-29,2112,0,2112,168,2280,2280,0,0
24617,2019-06-29,1575,0,1575,125,1700,1700,0,0
24618,2019-06-29,1362,0,1362,108,1470,1470,0,0
24619,2019-06-29,232,0,232,18,250,250,0,0
24620,2019-06-29,501,0,501,39,540,540,0,0
24621,2019-06-29,1809,-193,1616,121,1737,1737,0,0
24622,2019-06-29,769,0,769,61,830,830,0,0
24623,2019-06-29,908,0,908,72,980,980,0,0
24624,2019-06-29,2723,0,2723,217,2940,2940,0,0
24625,2019-06-29,915,-98,817,65,882,882,0,0
24626,2019-06-29,519,0,519,41,560,560,0,0
24627,2019-06-29,2723,0,2723,217,2940,2940,0,0
24628,2019-06-29,1149,0,1149,91,1240,1240,0,0
24629,2019-06-29,269,0,269,21,290,290,0,0
24630,2019-06-29,1815,0,1815,145,1960,0,1960,0
24631,2019-06-29,751,0,751,59,810,810,0,0
24632,2019-06-29,1815,0,1815,145,1960,1960,0,0
24633,2019-06-29,1852,0,1852,148,2000,2000,0,0
24634,2019-06-29,2325,0,2325,185,2510,2510,0,0
24635,2019-06-29,1417,0,1417,113,1530,1530,0,0
24636,2019-06-29,371,0,371,29,400,400,0,0
24637,2019-06-29,1426,0,1426,114,1540,1540,0,0
24638,2019-06-29,223,0,223,17,240,240,0,0
24639,2019-06-29,1768,0,1768,132,1900,1900,0,0
24640,2019-06-29,788,0,788,62,850,850,0,0
24641,2019-06-29,788,0,788,62,850,850,0,0
24642,2019-06-29,788,0,788,62,850,850,0,0
24643,2019-06-29,788,0,788,62,850,850,0,0
24644,2019-06-29,3093,0,3093,247,3340,3340,0,0
24645,2019-06-29,1166,0,1166,84,1250,1250,0,0
24646,2019-06-29,3149,0,3149,251,3400,3400,0,0
24647,2019-06-29,325,0,325,25,350,350,0,0
24648,2019-06-29,1417,0,1417,113,1530,0,0,1530
24649,2019-06-29,1084,0,1084,86,1170,1170,0,0
24650,2019-06-29,842,0,842,58,900,900,0,0
24651,2019-06-29,843,0,843,67,910,910,0,0
24652,2019-06-29,408,0,408,32,440,440,0,0
24653,2019-06-29,954,0,954,76,1030,1030,0,0
24654,2019-06-29,1445,0,1445,115,1560,1560,0,0
24655,2019-06-29,251,0,251,19,270,270,0,0
24656,2019-06-29,473,0,473,37,510,510,0,0
24657,2019-06-29,797,0,797,63,860,860,0,0
24658,2019-06-29,686,0,686,54,740,740,0,0
24659,2019-06-29,760,0,760,60,820,820,0,0
24660,2019-06-29,1343,0,1343,107,1450,1450,0,0
24661,2019-06-29,658,0,658,52,710,710,0,0
24662,2019-06-29,491,0,491,39,530,530,0,0
24663,2019-06-29,2723,0,2723,217,2940,2940,0,0
24664,2019-06-29,1602,0,1602,128,1730,1730,0,0
24665,2019-06-29,306,0,306,24,330,330,0,0
24666,2019-06-29,565,0,565,45,610,610,0,0
24667,2019-06-29,1880,0,1880,150,2030,2030,0,0
24668,2019-06-29,686,0,686,54,740,740,0,0
24669,2019-06-29,2593,0,2593,207,2800,2800,0,0
24670,2019-06-29,649,0,649,51,700,700,0,0
24671,2019-06-29,334,0,334,26,360,360,0,0
24672,2019-06-29,4538,0,4538,362,4900,4900,0,0
24673,2019-06-29,3186,0,3186,254,3440,0,3440,0
24674,2019-06-29,510,0,510,40,550,550,0,0
24675,2019-06-29,380,0,380,30,410,410,0,0
24676,2019-06-29,723,0,723,57,780,780,0,0
24677,2019-06-29,1408,0,1408,112,1520,1520,0,0
24678,2019-06-29,602,0,602,48,650,650,0,0
24679,2019-06-29,685,0,685,45,730,730,0,0
24680,2019-06-29,3630,0,3630,290,3920,3920,0,0
24681,2019-06-29,612,0,612,48,660,660,0,0
24682,2019-06-29,445,0,445,35,480,480,0,0
24683,2019-06-29,9815,0,9815,785,10600,10600,0,0
24684,2019-06-29,463,0,463,37,500,500,0,0
24685,2019-06-29,269,0,269,21,290,290,0,0
24686,2019-06-29,760,0,760,60,820,820,0,0
24687,2019-06-29,639,0,639,51,690,690,0,0
24688,2019-06-29,937,0,937,66,1003,1003,0,0
24689,2019-06-29,2751,0,2751,219,2970,2970,0,0
24690,2019-06-29,741,0,741,59,800,800,0,0
24691,2019-06-29,2593,0,2593,207,2800,2800,0,0
24692,2019-06-29,2297,-246,2051,163,2214,0,2214,0
24693,2019-06-29,1167,0,1167,93,1260,1260,0,0
24694,2019-06-29,602,0,602,48,650,650,0,0
24695,2019-06-29,1954,0,1954,156,2110,2110,0,0
24696,2019-06-29,556,0,556,44,600,600,0,0
24697,2019-06-29,234,-25,209,16,225,225,0,0
24698,2019-06-29,889,0,889,71,960,960,0,0
24699,2019-06-29,167,0,167,13,180,0,0,180
24700,2019-06-29,649,0,649,51,700,700,0,0
24701,2019-06-29,778,0,778,62,840,840,0,0
24702,2019-06-29,638,0,638,42,680,680,0,0
24703,2019-06-29,686,0,686,54,740,740,0,0
24704,2019-06-29,278,0,278,22,300,300,0,0
24705,2019-06-29,297,0,297,23,320,320,0,0
24706,2019-06-29,269,0,269,21,290,290,0,0
24707,2019-06-29,408,0,408,32,440,440,0,0
24708,2019-06-29,1204,0,1204,96,1300,1300,0,0
24709,2019-06-29,630,0,630,50,680,680,0,0
24710,2019-06-29,250,0,250,20,270,270,0,0
24711,2019-06-29,1112,0,1112,88,1200,1200,0,0
24712,2019-06-29,1121,0,1121,89,1210,0,0,1210
24713,2019-06-29,288,0,288,22,310,310,0,0
24714,2019-06-29,1240,0,1240,90,1330,1330,0,0
24715,2019-06-29,426,0,426,34,460,460,0,0
24716,2019-06-29,501,0,501,39,540,540,0,0
24717,2019-06-29,510,0,510,40,550,550,0,0
24718,2019-06-29,1297,0,1297,103,1400,1400,0,0
24719,2019-06-29,399,0,399,31,430,430,0,0
24720,2019-06-29,1010,0,1010,80,1090,1090,0,0
24721,2019-06-29,1010,0,1010,80,1090,1090,0,0
24722,2019-06-29,1018,-109,909,72,981,981,0,0
24723,2019-06-29,921,0,921,64,985,985,0,0
24724,2019-06-29,741,0,741,59,800,800,0,0
24725,2019-06-29,1249,0,1249,91,1340,0,1340,0
24726,2019-06-29,491,0,491,39,530,530,0,0
24727,2019-06-29,538,0,538,42,580,580,0,0
24728,2019-06-29,426,0,426,34,460,460,0,0
24729,2019-06-29,556,0,556,44,600,600,0,0
24730,2019-06-29,732,0,732,58,790,790,0,0
24731,2019-06-29,213,0,213,17,230,230,0,0
24732,2019-06-29,491,0,491,39,530,530,0,0
24733,2019-06-29,538,0,538,42,580,580,0,0
24734,2019-06-29,1998,-214,1784,142,1926,1926,0,0
24735,2019-06-29,306,0,306,24,330,330,0,0
24736,2019-06-29,367,-78,289,23,312,312,0,0
24737,2019-06-29,1575,0,1575,125,1700,1700,0,0
24738,2019-06-29,510,0,510,40,550,550,0,0
24739,2019-06-29,788,0,788,62,850,850,0,0
24740,2019-06-29,788,0,788,62,850,850,0,0
24741,2019-06-29,112,0,112,8,120,120,0,0
24742,2019-06-29,797,0,797,63,860,0,0,860
24743,2019-06-29,1575,0,1575,125,1700,1700,0,0
24744,2019-06-29,351,0,351,19,370,370,0,0
24745,2019-06-29,760,0,760,60,820,820,0,0
24746,2019-06-29,1889,0,1889,151,2040,2040,0,0
24747,2019-06-29,786,0,786,54,840,840,0,0
24748,2019-06-29,1390,0,1390,111,1501,1501,0,0
24749,2019-06-29,102,0,102,8,110,110,0,0
24750,2019-06-29,621,0,621,49,670,670,0,0
24751,2019-06-29,371,0,371,29,400,400,0,0
24752,2019-06-29,788,0,788,62,850,850,0,0
24753,2019-06-29,769,0,769,61,830,830,0,0
24754,2019-06-29,1213,0,1213,97,1310,1310,0,0
24755,2019-06-29,269,0,269,21,290,290,0,0
24756,2019-06-29,612,0,612,48,660,660,0,0
24757,2019-06-29,399,0,399,31,430,430,0,0
24758,2019-06-29,713,0,713,57,770,770,0,0
24759,2019-06-29,612,0,612,48,660,660,0,0
24760,2019-06-29,813,-87,726,57,783,783,0,0
24761,2019-06-29,667,0,667,53,720,720,0,0
24762,2019-06-29,334,0,334,26,360,360,0,0
24763,2019-06-29,611,0,611,39,650,650,0,0
24764,2019-06-29,260,0,260,20,280,280,0,0
24765,2019-06-29,612,0,612,48,660,660,0,0
24766,2019-06-29,630,-67,563,45,608,608,0,0
24767,2019-06-29,436,0,436,34,470,0,470,0
24768,2019-06-29,463,0,463,37,500,500,0,0
24769,2019-06-29,2380,0,2380,190,2570,0,2570,0
24770,2019-06-29,269,0,269,21,290,290,0,0
24771,2019-06-30,306,0,306,24,330,330,0,0
24772,2019-06-30,926,0,926,74,1000,1000,0,0
24773,2019-06-30,399,0,399,31,430,430,0,0
24774,2019-06-30,1815,0,1815,145,1960,0,1960,0
24775,2019-06-30,908,0,908,72,980,980,0,0
24776,2019-06-30,908,0,908,72,980,980,0,0
24777,2019-06-30,1102,0,1102,88,1190,1190,0,0
24778,2019-06-30,306,0,306,24,330,330,0,0
24779,2019-06-30,556,0,556,44,600,600,0,0
24780,2019-06-30,1176,0,1176,94,1270,1270,0,0
24781,2019-06-30,982,0,982,78,1060,1060,0,0
24782,2019-06-30,843,0,843,67,910,910,0,0
24783,2019-06-30,945,0,945,75,1020,1020,0,0
24784,2019-06-30,1269,0,1269,101,1370,1370,0,0
24785,2019-06-30,473,0,473,37,510,510,0,0
24786,2019-06-30,269,0,269,21,290,290,0,0
24787,2019-06-30,1075,0,1075,85,1160,1160,0,0
24788,2019-06-30,843,0,843,67,910,910,0,0
24789,2019-06-30,612,0,612,48,660,660,0,0
24790,2019-06-30,260,0,260,20,280,280,0,0
24791,2019-06-30,362,0,362,28,390,390,0,0
24792,2019-06-30,1232,0,1232,98,1330,1330,0,0
24793,2019-06-30,676,0,676,54,730,730,0,0
24794,2019-06-30,1380,0,1380,110,1490,1490,0,0
24795,2019-06-30,167,0,167,13,180,180,0,0
24796,2019-06-30,-1232,0,-1232,-98,-1330,-1330,0,0
24797,2019-06-30,1241,0,1241,99,1340,1340,0,0
24798,2019-06-30,1269,0,1269,101,1370,1370,0,0
24799,2019-06-30,473,0,473,37,510,510,0,0
24800,2019-06-30,1343,0,1343,107,1450,1450,0,0
24801,2019-06-30,1149,0,1149,91,1240,1240,0,0
24802,2019-06-30,1139,0,1139,91,1230,1230,0,0
24803,2019-06-30,2112,0,2112,168,2280,2280,0,0
24804,2019-06-30,584,0,584,46,630,630,0,0
24805,2019-06-30,334,0,334,26,360,360,0,0
24806,2019-06-30,473,0,473,37,510,510,0,0
24807,2019-06-30,2380,0,2380,190,2570,2570,0,0
24808,2019-06-30,1223,0,1223,97,1320,1320,0,0
24809,2019-06-30,306,0,306,24,330,330,0,0
24810,2019-06-30,426,0,426,34,460,460,0,0
24811,2019-06-30,2723,0,2723,217,2940,2940,0,0
24812,2019-06-30,260,0,260,20,280,280,0,0
24813,2019-06-30,639,0,639,51,690,690,0,0
24814,2019-06-30,926,0,926,74,1000,1000,0,0
24815,2019-06-30,1084,0,1084,86,1170,1170,0,0
24816,2019-06-30,843,0,843,67,910,910,0,0
24817,2019-06-30,1408,0,1408,112,1520,1520,0,0
24818,2019-06-30,1241,0,1241,99,1340,1340,0,0
24819,2019-06-30,1334,0,1334,106,1440,1440,0,0
24820,2019-06-30,436,0,436,34,470,470,0,0
24821,2019-06-30,445,0,445,35,480,480,0,0
24822,2019-06-30,547,0,547,43,590,590,0,0
24823,2019-06-30,666,0,666,44,710,710,0,0
24824,2019-06-30,315,0,315,25,340,340,0,0
24825,2019-06-30,334,0,334,26,360,360,0,0
24826,2019-06-30,436,0,436,34,470,470,0,0
24827,2019-06-30,1510,0,1510,120,1630,1630,0,0
24828,2019-06-30,898,0,898,62,960,960,0,0
24829,2019-06-30,334,0,334,26,360,360,0,0
24830,2019-06-30,1630,0,1630,130,1760,1760,0,0
24831,2019-06-30,1815,0,1815,145,1960,1960,0,0
24832,2019-06-30,899,0,899,71,970,970,0,0
24833,2019-06-30,417,0,417,33,450,450,0,0
24834,2019-06-30,1815,0,1815,145,1960,1960,0,0
24835,2019-06-30,251,0,251,19,270,270,0,0
24836,2019-06-30,473,0,473,37,510,510,0,0
24837,2019-06-30,1815,0,1815,145,1960,0,0,1960
24838,2019-06-30,501,0,501,39,540,540,0,0
24839,2019-06-30,963,0,963,77,1040,1040,0,0
24840,2019-06-30,741,0,741,59,800,800,0,0
24841,2019-06-30,121,0,121,9,130,130,0,0
24842,2019-06-30,408,0,408,32,440,440,0,0
24843,2019-06-30,306,0,306,24,330,330,0,0
24844,2019-06-30,426,0,426,34,460,460,0,0
24845,2019-06-30,908,0,908,72,980,980,0,0
24846,2019-06-30,538,0,538,42,580,580,0,0
24847,2019-06-30,797,0,797,63,860,860,0,0
24848,2019-06-30,908,0,908,72,980,980,0,0
24849,2019-06-30,417,0,417,33,450,450,0,0
24850,2019-06-30,1278,0,1278,102,1380,1380,0,0
24851,2019-06-30,769,0,769,61,830,830,0,0
24852,2019-06-30,593,0,593,47,640,640,0,0
24853,2019-06-30,1408,0,1408,112,1520,1520,0,0
24854,2019-06-30,343,0,343,27,370,370,0,0
24855,2019-06-30,2343,0,2343,187,2530,2530,0,0
24856,2019-06-30,565,0,565,45,610,610,0,0
24857,2019-06-30,3204,0,3204,256,3460,3460,0,0
24858,2019-06-30,3204,0,3204,256,3460,3460,0,0
24859,2019-06-30,-3204,0,-3204,-256,-3460,-3460,0,0
24860,2019-06-30,963,0,963,77,1040,1040,0,0
24861,2019-06-30,389,0,389,31,420,420,0,0
24862,2019-06-30,519,0,519,41,560,560,0,0
24863,2019-06-30,612,0,612,48,660,660,0,0
24864,2019-06-30,288,0,288,22,310,310,0,0
24865,2019-06-30,1084,0,1084,86,1170,1170,0,0
24866,2019-06-30,371,0,371,29,400,400,0,0
24867,2019-06-30,269,0,269,21,290,290,0,0
24868,2019-06-30,1112,0,1112,88,1200,1200,0,0
24869,2019-06-30,362,0,362,28,390,390,0,0
24870,2019-06-30,852,0,852,68,920,920,0,0
24871,2019-06-30,556,0,556,44,600,600,0,0
24872,2019-06-30,519,0,519,41,560,560,0,0
24873,2019-06-30,176,0,176,14,190,190,0,0
24874,2019-06-30,889,0,889,71,960,960,0,0
24875,2019-06-30,1139,0,1139,91,1230,1230,0,0
24876,2019-06-30,741,0,741,59,800,800,0,0
24877,2019-06-30,556,0,556,44,600,600,0,0
24878,2019-06-30,343,0,343,27,370,370,0,0
24879,2019-06-30,1093,0,1093,87,1180,1180,0,0
24880,2019-06-30,297,0,297,23,320,320,0,0
24881,2019-06-30,639,0,639,51,690,690,0,0
24882,2019-06-30,399,0,399,31,430,430,0,0
24883,2019-06-30,389,0,389,31,420,420,0,0
24884,2019-06-30,370,0,370,20,390,390,0,0
24885,2019-06-30,362,0,362,28,390,390,0,0
24886,2019-06-30,991,0,991,79,1070,1070,0,0
24887,2019-06-30,510,0,510,40,550,550,0,0
24888,2019-06-30,343,0,343,27,370,370,0,0
24889,2019-06-30,1158,0,1158,92,1250,0,1250,0
24890,2019-06-30,760,0,760,60,820,820,0,0
24891,2019-06-30,2825,0,2825,225,3050,3050,0,0
24892,2019-06-30,834,0,834,66,900,900,0,0
24893,2019-06-30,389,0,389,31,420,420,0,0
24894,2019-06-30,139,0,139,11,150,150,0,0
24895,2019-06-30,149,0,149,11,160,160,0,0
24896,2019-06-30,899,0,899,71,970,970,0,0
24897,2019-06-30,1046,-112,934,74,1008,1008,0,0
24898,2019-06-30,788,0,788,62,850,850,0,0
24899,2019-06-30,306,0,306,24,330,330,0,0
24900,2019-06-30,794,-85,709,56,765,765,0,0
24901,2019-06-30,667,0,667,53,720,720,0,0
24902,2019-06-30,1056,0,1056,84,1140,1140,0,0
24903,2019-06-30,1075,0,1075,85,1160,1160,0,0
24904,2019-06-30,1769,0,1769,141,1910,1910,0,0
24905,2019-06-30,536,0,536,34,570,570,0,0
24906,2019-06-30,1667,0,1667,133,1800,1800,0,0
24907,2019-06-30,1575,0,1575,125,1700,1700,0,0
24908,2019-06-30,2315,0,2315,185,2500,2500,0,0
24909,2019-06-30,1186,0,1186,94,1280,1280,0,0
24910,2019-06-30,364,-39,325,26,351,351,0,0
24911,2019-06-30,1055,-113,942,75,1017,1017,0,0
24912,2019-06-30,334,0,334,26,360,360,0,0
24913,2019-06-30,794,-85,709,56,765,765,0,0
24914,2019-06-30,473,0,473,37,510,510,0,0
24915,2019-06-30,482,0,482,38,520,520,0,0
24916,2019-06-30,667,0,667,53,720,720,0,0
24917,2019-06-30,343,0,343,27,370,370,0,0
24918,2019-06-30,575,0,575,45,620,620,0,0
24919,2019-06-30,630,0,630,50,680,680,0,0
24920,2019-06-30,778,0,778,62,840,0,0,840
24921,2019-06-30,899,0,899,71,970,970,0,0
24922,2019-06-30,1065,0,1065,85,1150,1150,0,0
24923,2019-06-30,371,0,371,29,400,400,0,0
24924,2019-06-30,501,0,501,39,540,540,0,0
24925,2019-06-30,550,0,550,43,593,593,0,0
24926,2019-06-30,584,0,584,46,630,630,0,0
24927,2019-06-30,519,0,519,41,560,560,0,0
24928,2019-06-30,260,0,260,20,280,280,0,0
24929,2019-06-30,510,0,510,40,550,550,0,0
24930,2019-06-30,149,0,149,11,160,160,0,0
24931,2019-06-30,149,0,149,11,160,160,0,0
24932,2019-06-30,297,0,297,23,320,320,0,0
24933,2019-07-01,343,0,343,27,370,370,0,0
24934,2019-07-01,908,0,908,72,980,980,0,0
24935,2019-07-01,834,0,834,66,900,900,0,0
24936,2019-07-01,825,0,825,65,890,890,0,0
24937,2019-07-01,2723,0,2723,217,2940,2940,0,0
24938,2019-07-01,908,0,908,72,980,0,0,980
24939,2019-07-01,389,0,389,31,420,420,0,0
24940,2019-07-01,908,0,908,72,980,980,0,0
24941,2019-07-01,775,-83,692,55,747,747,0,0
24942,2019-07-01,269,0,269,21,290,290,0,0
24943,2019-07-01,612,0,612,48,660,660,0,0
24944,2019-07-01,1825,0,1825,145,1970,1970,0,0
24945,2019-07-01,204,0,204,16,220,220,0,0
24946,2019-07-01,1251,0,1251,99,1350,1350,0,0
24947,2019-07-01,908,0,908,72,980,980,0,0
24948,2019-07-01,691,-74,617,49,666,666,0,0
24949,2019-07-01,269,0,269,21,290,290,0,0
24950,2019-07-01,538,0,538,42,580,580,0,0
24951,2019-07-01,1482,0,1482,118,1600,1600,0,0
24952,2019-07-01,1028,0,1028,82,1110,1110,0,0
24953,2019-07-01,760,0,760,60,820,820,0,0
24954,2019-07-01,250,0,250,20,270,0,270,0
24955,2019-07-01,1389,0,1389,111,1500,1500,0,0
24956,2019-07-01,871,0,871,69,940,940,0,0
24957,2019-07-01,389,0,389,31,420,420,0,0
24958,2019-07-01,908,0,908,72,980,980,0,0
24959,2019-07-01,269,0,269,21,290,0,290,0
24960,2019-07-01,130,0,130,10,140,140,0,0
24961,2019-07-01,973,0,973,77,1050,1050,0,0
24962,2019-07-01,1038,0,1038,82,1120,1120,0,0
24963,2019-07-01,751,0,751,59,810,0,810,0
24964,2019-07-01,315,0,315,25,340,0,340,0
24965,2019-07-01,616,-66,550,44,594,594,0,0
24966,2019-07-01,288,0,288,22,310,0,310,0
24967,2019-07-01,297,0,297,23,320,320,0,0
24968,2019-07-01,555,0,555,35,590,590,0,0
24969,2019-07-01,852,0,852,68,920,920,0,0
24970,2019-07-01,621,0,621,49,670,670,0,0
24971,2019-07-01,565,0,565,45,610,610,0,0
24972,2019-07-01,704,0,704,56,760,760,0,0
24973,2019-07-01,343,0,343,27,370,370,0,0
24974,2019-07-01,889,0,889,71,960,960,0,0
24975,2019-07-01,251,0,251,19,270,0,0,270
24976,2019-07-01,232,0,232,18,250,250,0,0
24977,2019-07-01,2362,0,2362,188,2550,2550,0,0
24978,2019-07-01,1473,0,1473,117,1590,1590,0,0
24979,2019-07-01,556,0,556,44,600,600,0,0
24980,2019-07-01,584,0,584,46,630,630,0,0
24981,2019-07-01,269,0,269,21,290,290,0,0
24982,2019-07-01,278,0,278,22,300,300,0,0
24983,2019-07-01,713,0,713,57,770,770,0,0
24984,2019-07-01,583,0,583,37,620,620,0,0
24985,2019-07-01,1109,0,1109,71,1180,1180,0,0
24986,2019-07-01,609,0,609,31,640,640,0,0
24987,2019-07-01,371,0,371,29,400,400,0,0
24988,2019-07-01,575,0,575,45,620,620,0,0
24989,2019-07-01,694,0,694,46,740,740,0,0
24990,2019-07-01,584,0,584,46,630,630,0,0
24991,2019-07-01,408,0,408,32,440,440,0,0
24992,2019-07-01,538,0,538,42,580,580,0,0
24993,2019-07-01,314,0,314,16,330,330,0,0
24994,2019-07-01,538,0,538,42,580,580,0,0
24995,2019-07-01,1241,0,1241,99,1340,1340,0,0
24996,2019-07-01,575,0,575,45,620,620,0,0
24997,2019-07-01,371,0,371,29,400,400,0,0
24998,2019-07-01,501,0,501,39,540,540,0,0
24999,2019-07-01,362,0,362,28,390,390,0,0
25000,2019-07-01,1009,0,1009,71,1080,0,1080,0
25001,2019-07-01,723,0,723,57,780,780,0,0
25002,2019-07-01,769,0,769,61,830,830,0,0
25003,2019-07-01,806,0,806,64,870,870,0,0
25004,2019-07-01,899,0,899,71,970,970,0,0
25005,2019-07-01,796,0,796,54,850,850,0,0
25006,2019-07-01,760,0,760,60,820,820,0,0
25007,2019-07-01,-371,0,-371,-29,-400,-400,0,0
25008,2019-07-01,371,0,371,29,400,400,0,0
25009,2019-07-01,612,0,612,48,660,660,0,0
25010,2019-07-01,167,0,167,13,180,180,0,0
25011,2019-07-01,815,0,815,65,880,880,0,0
25012,2019-07-01,788,0,788,62,850,850,0,0
25013,2019-07-01,1343,0,1343,107,1450,1450,0,0
25014,2019-07-01,249,0,249,11,260,260,0,0
25015,2019-07-01,575,0,575,45,620,620,0,0
25016,2019-07-01,112,0,112,8,120,120,0,0
25017,2019-07-01,639,0,639,51,690,690,0,0
25018,2019-07-01,399,0,399,31,430,430,0,0
25019,2019-07-01,788,0,788,62,850,850,0,0
25020,2019-07-01,-2102,0,-2102,-168,-2270,-2270,0,0
25021,2019-07-01,2102,0,2102,168,2270,2270,0,0
25022,2019-07-01,2102,0,2102,168,2270,2270,0,0
25023,2019-07-01,1575,0,1575,125,1700,1700,0,0
25024,2019-07-01,887,-95,792,63,855,855,0,0
25025,2019-07-02,1028,0,1028,82,1110,1110,0,0
25026,2019-07-02,426,0,426,34,460,460,0,0
25027,2019-07-02,231,0,231,9,240,240,0,0
25028,2019-07-02,889,0,889,71,960,960,0,0
25029,2019-07-02,269,0,269,21,290,290,0,0
25030,2019-07-02,1426,0,1426,114,1540,1540,0,0
25031,2019-07-02,504,-54,450,36,486,486,0,0
25032,2019-07-02,695,0,695,55,750,750,0,0
25033,2019-07-02,1406,-296,1110,74,1184,1184,0,0
25034,2019-07-02,697,-148,549,43,592,592,0,0
25035,2019-07-02,362,0,362,28,390,390,0,0
25036,2019-07-02,547,0,547,43,590,590,0,0
25037,2019-07-02,501,0,501,39,540,540,0,0
25038,2019-07-02,621,0,621,49,670,670,0,0
25039,2019-07-02,834,0,834,66,900,900,0,0
25040,2019-07-02,908,0,908,72,980,980,0,0
25041,2019-07-02,908,0,908,72,980,980,0,0
25042,2019-07-02,362,0,362,28,390,390,0,0
25043,2019-07-02,389,0,389,31,420,420,0,0
25044,2019-07-02,709,0,709,56,765,765,0,0
25045,2019-07-02,362,0,362,28,390,390,0,0
25046,2019-07-02,1064,0,1064,76,1140,1140,0,0
25047,2019-07-02,926,0,926,74,1000,1000,0,0
25048,2019-07-02,-926,0,-926,-74,-1000,-1000,0,0
25049,2019-07-02,934,-100,834,66,900,900,0,0
25050,2019-07-02,262,-28,234,18,252,252,0,0
25051,2019-07-03,556,0,556,44,600,600,0,0
25052,2019-07-03,306,0,306,24,330,330,0,0
25053,2019-07-03,686,0,686,54,740,740,0,0
25054,2019-07-03,473,0,473,37,510,510,0,0
25055,2019-07-03,926,0,926,74,1000,1000,0,0
25056,2019-07-03,639,0,639,51,690,690,0,0
25057,2019-07-03,389,0,389,31,420,420,0,0
25058,2019-07-03,251,0,251,19,270,270,0,0
25059,2019-07-03,538,0,538,42,580,580,0,0
25060,2019-07-03,538,0,538,42,580,580,0,0
25061,2019-07-03,908,0,908,72,980,980,0,0
25062,2019-07-03,417,0,417,33,450,450,0,0
25063,2019-07-03,241,0,241,19,260,260,0,0
25064,2019-07-03,232,0,232,18,250,250,0,0
25065,2019-07-03,463,0,463,37,500,500,0,0
25066,2019-07-03,-538,0,-538,-42,-580,-580,0,0
25067,2019-07-03,593,0,593,47,640,640,0,0
25068,2019-07-03,2056,0,2056,164,2220,2220,0,0
25069,2019-07-03,499,0,499,31,530,530,0,0
25070,2019-07-03,1815,0,1815,145,1960,1960,0,0
25071,2019-07-03,723,0,723,57,780,780,0,0
25072,2019-07-03,260,0,260,20,280,280,0,0
25073,2019-07-03,806,0,806,64,870,870,0,0
25074,2019-07-03,973,0,973,77,1050,1050,0,0
25075,2019-07-03,1815,0,1815,145,1960,1960,0,0
25076,2019-07-03,519,0,519,41,560,560,0,0
25077,2019-07-03,439,-47,392,31,423,423,0,0
25078,2019-07-03,362,0,362,28,390,390,0,0
25079,2019-07-03,565,0,565,45,610,610,0,0
25080,2019-07-03,278,0,278,22,300,0,0,300
25081,2019-07-03,519,0,519,41,560,560,0,0
25082,2019-07-03,454,0,454,36,490,490,0,0
25083,2019-07-03,399,0,399,31,430,430,0,0
25084,2019-07-03,1815,0,1815,145,1960,1960,0,0
25085,2019-07-03,176,0,176,14,190,190,0,0
25086,2019-07-03,667,0,667,53,720,720,0,0
25087,2019-07-03,297,0,297,23,320,320,0,0
25088,2019-07-03,908,0,908,72,980,980,0,0
25089,2019-07-03,510,0,510,40,550,550,0,0
25090,2019-07-03,1454,0,1454,116,1570,1570,0,0
25091,2019-07-03,364,-39,325,26,351,351,0,0
25092,2019-07-03,-364,39,-325,-26,-351,-351,0,0
25093,2019-07-03,364,-39,325,26,351,351,0,0
25094,2019-07-03,1065,0,1065,85,1150,1150,0,0
25095,2019-07-03,1065,0,1065,85,1150,1150,0,0
25096,2019-07-03,269,0,269,21,290,290,0,0
25097,2019-07-03,234,-25,209,16,225,225,0,0
25098,2019-07-03,592,0,592,38,630,630,0,0
25099,2019-07-03,676,0,676,54,730,730,0,0
25100,2019-07-03,565,0,565,45,610,610,0,0
25101,2019-07-03,703,0,703,47,750,750,0,0
25102,2019-07-03,676,0,676,54,730,730,0,0
25103,2019-07-03,1575,0,1575,125,1700,1700,0,0
25104,2019-07-03,1593,0,1593,127,1720,1720,0,0
25105,2019-07-03,167,0,167,13,180,0,0,180
25106,2019-07-03,325,0,325,25,350,350,0,0
25107,2019-07-03,288,0,288,22,310,0,310,0
25108,2019-07-03,259,0,259,11,270,270,0,0
25109,2019-07-03,758,0,758,42,800,800,0,0
25110,2019-07-03,991,0,991,79,1070,1070,0,0
25111,2019-07-03,973,0,973,77,1050,1050,0,0
25112,2019-07-03,-908,0,-908,-72,-980,-980,0,0
25113,2019-07-03,908,0,908,72,980,980,0,0
25114,2019-07-03,751,0,751,59,810,810,0,0
25115,2019-07-03,528,0,528,42,570,570,0,0
25116,2019-07-03,908,0,908,72,980,980,0,0
25117,2019-07-03,908,0,908,72,980,980,0,0
25118,2019-07-03,695,0,695,55,750,750,0,0
25119,2019-07-03,1815,0,1815,145,1960,1960,0,0
25120,2019-07-03,639,0,639,51,690,690,0,0
25121,2019-07-03,473,0,473,37,510,510,0,0
25122,2019-07-03,417,0,417,33,450,450,0,0
25123,2019-07-03,788,0,788,62,850,850,0,0
25124,2019-07-03,1436,0,1436,114,1550,1550,0,0
25125,2019-07-03,704,0,704,56,760,760,0,0
25126,2019-07-03,176,0,176,14,190,190,0,0
25127,2019-07-03,433,-92,341,27,368,368,0,0
25128,2019-07-04,343,0,343,27,370,370,0,0
25129,2019-07-04,315,0,315,25,340,340,0,0
25130,2019-07-04,547,0,547,43,590,590,0,0
25131,2019-07-04,584,0,584,46,630,630,0,0
25132,2019-07-04,556,0,556,44,600,600,0,0
25133,2019-07-04,926,0,926,74,1000,1000,0,0
25134,2019-07-04,482,0,482,38,520,0,520,0
25135,2019-07-04,3001,0,3001,239,3240,3240,0,0
25136,2019-07-04,510,0,510,40,550,550,0,0
25137,2019-07-04,908,0,908,72,980,980,0,0
25138,2019-07-04,908,0,908,72,980,980,0,0
25139,2019-07-04,167,0,167,13,180,180,0,0
25140,2019-07-04,112,0,112,8,120,120,0,0
25141,2019-07-04,269,0,269,21,290,290,0,0
25142,2019-07-04,139,0,139,11,150,150,0,0
25143,2019-07-04,445,0,445,35,480,480,0,0
25144,2019-07-04,371,0,371,29,400,400,0,0
25145,2019-07-04,278,0,278,22,300,300,0,0
25146,2019-07-04,362,0,362,28,390,390,0,0
25147,2019-07-04,575,0,575,45,620,620,0,0
25148,2019-07-04,738,-79,659,52,711,711,0,0
25149,2019-07-04,352,0,352,28,380,380,0,0
25150,2019-07-04,908,0,908,72,980,980,0,0
25151,2019-07-04,315,0,315,25,340,340,0,0
25152,2019-07-04,639,0,639,51,690,690,0,0
25153,2019-07-04,1047,0,1047,83,1130,1130,0,0
25154,2019-07-04,112,0,112,8,120,120,0,0
25155,2019-07-04,232,0,232,18,250,250,0,0
25156,2019-07-04,667,0,667,53,720,720,0,0
25157,2019-07-04,251,0,251,19,270,270,0,0
25158,2019-07-04,315,0,315,25,340,340,0,0
25159,2019-07-04,306,0,306,24,330,330,0,0
25160,2019-07-04,1362,0,1362,108,1470,1470,0,0
25161,2019-07-04,330,0,330,0,330,330,0,0
25162,2019-07-04,719,-77,642,51,693,693,0,0
25163,2019-07-04,343,0,343,27,370,370,0,0
25164,2019-07-04,908,0,908,72,980,980,0,0
25165,2019-07-04,908,0,908,72,980,980,0,0
25166,2019-07-04,908,0,908,72,980,980,0,0
25167,2019-07-04,704,0,704,56,760,760,0,0
25168,2019-07-04,908,0,908,72,980,980,0,0
25169,2019-07-04,260,0,260,20,280,280,0,0
25170,2019-07-04,3685,0,3685,285,3970,3970,0,0
25171,2019-07-04,2038,0,2038,162,2200,2200,0,0
25172,2019-07-04,454,0,454,36,490,490,0,0
25173,2019-07-04,299,-32,267,21,288,288,0,0
25174,2019-07-04,908,0,908,72,980,980,0,0
25175,2019-07-04,732,0,732,58,790,790,0,0
25176,2019-07-04,866,0,866,69,935,935,0,0
25177,2019-07-04,278,0,278,22,300,300,0,0
25178,2019-07-04,972,0,972,68,1040,1040,0,0
25179,2019-07-04,408,0,408,32,440,440,0,0
25180,2019-07-04,417,0,417,33,450,450,0,0
25181,2019-07-04,1815,0,1815,145,1960,1960,0,0
25182,2019-07-04,1962,0,1962,148,2110,2110,0,0
25183,2019-07-04,1723,0,1723,137,1860,1860,0,0
25184,2019-07-04,565,0,565,45,610,610,0,0
25185,2019-07-04,1852,0,1852,148,2000,0,2000,0
25186,2019-07-04,510,0,510,40,550,550,0,0
25187,2019-07-04,389,0,389,31,420,420,0,0
25188,2019-07-04,343,0,343,27,370,370,0,0
25189,2019-07-04,212,0,212,8,220,220,0,0
25190,2019-07-04,151,-32,119,9,128,128,0,0
25191,2019-07-04,371,0,371,29,400,400,0,0
25192,2019-07-04,262,-28,234,18,252,252,0,0
25193,2019-07-04,1260,0,1260,100,1360,1360,0,0
25194,2019-07-04,593,0,593,47,640,640,0,0
25195,2019-07-04,1408,0,1408,112,1520,1520,0,0
25196,2019-07-04,380,0,380,30,410,410,0,0
25197,2019-07-04,436,0,436,34,470,470,0,0
25198,2019-07-04,269,0,269,21,290,290,0,0
25199,2019-07-04,264,0,264,21,285,285,0,0
25200,2019-07-04,259,0,259,11,270,270,0,0
25201,2019-07-04,649,0,649,51,700,700,0,0
25202,2019-07-04,899,0,899,71,970,970,0,0
25203,2019-07-04,593,0,593,47,640,640,0,0
25204,2019-07-04,663,-71,592,47,639,639,0,0
25205,2019-07-04,510,0,510,40,550,550,0,0
25206,2019-07-04,232,0,232,18,250,250,0,0
25207,2019-07-04,1056,0,1056,84,1140,1140,0,0
25208,2019-07-04,1047,0,1047,83,1130,1130,0,0
25209,2019-07-04,1047,0,1047,83,1130,1130,0,0
25210,2019-07-04,362,0,362,28,390,390,0,0
25211,2019-07-04,297,0,297,23,320,320,0,0
25212,2019-07-04,639,0,639,51,690,690,0,0
25213,2019-07-04,1528,0,1528,122,1650,1650,0,0
25214,2019-07-04,389,0,389,31,420,420,0,0
25215,2019-07-04,1343,0,1343,107,1450,1450,0,0
25216,2019-07-04,1028,0,1028,82,1110,1110,0,0
25217,2019-07-04,547,0,547,43,590,590,0,0
25218,2019-07-04,593,0,593,47,640,640,0,0
25219,2019-07-04,116,0,116,9,125,125,0,0
25220,2019-07-04,788,0,788,62,850,850,0,0
25221,2019-07-04,314,0,314,16,330,330,0,0
25222,2019-07-04,788,0,788,62,850,850,0,0
25223,2019-07-04,251,0,251,19,270,270,0,0
25224,2019-07-04,639,0,639,51,690,690,0,0
25225,2019-07-04,380,0,380,30,410,410,0,0
25226,2019-07-04,723,0,723,57,780,780,0,0
25227,2019-07-04,380,0,380,30,410,410,0,0
25228,2019-07-04,380,0,380,30,410,410,0,0
25229,2019-07-04,399,0,399,31,430,430,0,0
25230,2019-07-04,926,0,926,74,1000,1000,0,0
25231,2019-07-04,760,0,760,60,820,820,0,0
25232,2019-07-04,825,0,825,65,890,890,0,0
25233,2019-07-04,547,0,547,43,590,590,0,0
25234,2019-07-04,1815,0,1815,145,1960,1960,0,0
25235,2019-07-04,436,0,436,34,470,470,0,0
25236,2019-07-04,676,0,676,54,730,730,0,0
25237,2019-07-04,788,0,788,62,850,850,0,0
25238,2019-07-04,547,0,547,43,590,590,0,0
25239,2019-07-04,700,-75,625,50,675,675,0,0
25240,2019-07-04,1260,0,1260,100,1360,1360,0,0
25241,2019-07-04,788,0,788,62,850,850,0,0
25242,2019-07-04,778,0,778,62,840,840,0,0
25243,2019-07-04,713,0,713,57,770,770,0,0
25244,2019-07-04,1575,0,1575,125,1700,1700,0,0
25245,2019-07-04,1380,0,1380,110,1490,1490,0,0
25246,2019-07-04,278,0,278,22,300,300,0,0
25247,2019-07-04,491,0,491,39,530,530,0,0
25248,2019-07-04,1575,0,1575,125,1700,1700,0,0
25249,2019-07-05,1325,0,1325,105,1430,1430,0,0
25250,2019-07-05,380,0,380,30,410,410,0,0
25251,2019-07-05,1815,0,1815,145,1960,1960,0,0
25252,2019-07-05,908,0,908,72,980,980,0,0
25253,2019-07-05,1815,0,1815,145,1960,1960,0,0
25254,2019-07-05,723,0,723,57,780,780,0,0
25255,2019-07-05,862,0,862,68,930,930,0,0
25256,2019-07-05,908,0,908,72,980,980,0,0
25257,2019-07-05,371,0,371,29,400,400,0,0
25258,2019-07-05,538,0,538,42,580,580,0,0
25259,2019-07-05,1436,0,1436,114,1550,1550,0,0
25260,2019-07-05,741,0,741,59,800,800,0,0
25261,2019-07-05,1241,0,1241,99,1340,1340,0,0
25262,2019-07-05,908,0,908,72,980,980,0,0
25263,2019-07-05,778,0,778,62,840,840,0,0
25264,2019-07-05,278,0,278,22,300,300,0,0
25265,2019-07-05,908,0,908,72,980,980,0,0
25266,2019-07-05,408,0,408,32,440,440,0,0
25267,2019-07-05,-908,0,-908,-72,-980,-980,0,0
25268,2019-07-05,908,0,908,72,980,980,0,0
25269,2019-07-05,915,-98,817,65,882,882,0,0
25270,2019-07-05,915,-98,817,65,882,882,0,0
25271,2019-07-05,908,0,908,72,980,980,0,0
25272,2019-07-05,556,0,556,44,600,600,0,0
25273,2019-07-05,943,-101,842,67,909,909,0,0
25274,2019-07-05,908,0,908,72,980,980,0,0
25275,2019-07-05,463,0,463,37,500,500,0,0
25276,2019-07-05,982,0,982,78,1060,1060,0,0
25277,2019-07-05,871,0,871,69,940,940,0,0
25278,2019-07-05,2028,0,2028,162,2190,2190,0,0
25279,2019-07-05,1028,0,1028,82,1110,1110,0,0
25280,2019-07-05,501,0,501,39,540,540,0,0
25281,2019-07-05,2723,0,2723,217,2940,2940,0,0
25282,2019-07-05,806,0,806,64,870,870,0,0
25283,2019-07-05,908,0,908,72,980,0,0,980
25284,2019-07-05,880,0,880,70,950,950,0,0
25285,2019-07-05,602,0,602,48,650,650,0,0
25286,2019-07-05,954,0,954,76,1030,1030,0,0
25287,2019-07-05,908,0,908,72,980,980,0,0
25288,2019-07-05,463,0,463,37,500,500,0,0
25289,2019-07-05,408,0,408,32,440,440,0,0
25290,2019-07-05,1213,0,1213,97,1310,1310,0,0
25291,2019-07-05,426,0,426,34,460,460,0,0
25292,2019-07-05,908,0,908,72,980,980,0,0
25293,2019-07-05,445,0,445,35,480,480,0,0
25294,2019-07-05,593,0,593,47,640,640,0,0
25295,2019-07-05,472,0,472,28,500,500,0,0
25296,2019-07-05,1815,0,1815,145,1960,1960,0,0
25297,2019-07-05,1815,0,1815,145,1960,1960,0,0
25298,2019-07-05,2102,0,2102,168,2270,2270,0,0
25299,2019-07-05,908,0,908,72,980,980,0,0
25300,2019-07-05,1278,0,1278,102,1380,1380,0,0
25301,2019-07-05,482,0,482,38,520,520,0,0
25302,2019-07-05,371,0,371,29,400,400,0,0
25303,2019-07-05,1815,0,1815,145,1960,1960,0,0
25304,2019-07-05,1158,0,1158,92,1250,1250,0,0
25305,2019-07-05,1260,0,1260,100,1360,1360,0,0
25306,2019-07-05,1278,0,1278,102,1380,1380,0,0
25307,2019-07-05,1361,0,1361,99,1460,1460,0,0
25308,2019-07-05,686,0,686,54,740,740,0,0
25309,2019-07-05,2723,0,2723,217,2940,2940,0,0
25310,2019-07-05,1046,0,1046,74,1120,1120,0,0
25311,2019-07-05,362,0,362,28,390,390,0,0
25312,2019-07-05,426,0,426,34,460,460,0,0
25313,2019-07-05,621,0,621,49,670,670,0,0
25314,2019-07-05,1380,0,1380,110,1490,1490,0,0
25315,2019-07-05,788,0,788,62,850,850,0,0
25316,2019-07-05,546,0,546,34,580,580,0,0
25317,2019-07-05,112,0,112,8,120,120,0,0
25318,2019-07-05,1186,0,1186,94,1280,1280,0,0
25319,2019-07-05,445,0,445,35,480,480,0,0
25320,2019-07-05,1815,0,1815,145,1960,1960,0,0
25321,2019-07-05,1575,0,1575,125,1700,1700,0,0
25322,2019-07-05,1741,0,1741,139,1880,1880,0,0
25323,2019-07-05,547,0,547,43,590,590,0,0
25324,2019-07-05,880,0,880,70,950,950,0,0
25325,2019-07-05,278,0,278,22,300,300,0,0
25326,2019-07-05,278,0,278,22,300,300,0,0
25327,2019-07-05,371,0,371,29,400,400,0,0
25328,2019-07-05,954,0,954,76,1030,1030,0,0
25329,2019-07-05,260,0,260,20,280,280,0,0
25330,2019-07-05,223,0,223,17,240,240,0,0
25331,2019-07-05,170,-36,134,10,144,144,0,0
25332,2019-07-05,1575,0,1575,125,1700,0,1700,0
25333,2019-07-05,788,0,788,62,850,850,0,0
25334,2019-07-05,538,0,538,42,580,580,0,0
25335,2019-07-05,788,0,788,62,850,850,0,0
25336,2019-07-05,1575,0,1575,125,1700,1700,0,0
25337,2019-07-05,1093,0,1093,87,1180,1180,0,0
25338,2019-07-05,463,0,463,37,500,500,0,0
25339,2019-07-05,445,0,445,35,480,480,0,0
25340,2019-07-05,686,0,686,54,740,740,0,0
25341,2019-07-05,240,0,240,10,250,250,0,0
25342,2019-07-05,250,0,250,20,270,270,0,0
25343,2019-07-05,380,0,380,30,410,410,0,0
25344,2019-07-05,676,0,676,54,730,730,0,0
25345,2019-07-05,334,0,334,26,360,360,0,0
25346,2019-07-05,232,0,232,18,250,250,0,0
25347,2019-07-05,240,0,240,10,250,250,0,0
25348,2019-07-05,683,0,683,37,720,720,0,0
25349,2019-07-05,491,0,491,39,530,530,0,0
25350,2019-07-05,741,0,741,59,800,800,0,0
25351,2019-07-05,260,0,260,20,280,280,0,0
25352,2019-07-05,352,0,352,28,380,380,0,0
25353,2019-07-05,371,0,371,29,400,400,0,0
25354,2019-07-05,880,0,880,70,950,950,0,0
25355,2019-07-05,852,0,852,68,920,920,0,0
25356,2019-07-05,945,0,945,75,1020,1020,0,0
25357,2019-07-05,982,0,982,78,1060,1060,0,0
25358,2019-07-05,538,0,538,42,580,580,0,0
25359,2019-07-05,334,0,334,26,360,360,0,0
25360,2019-07-05,741,0,741,59,800,800,0,0
25361,2019-07-05,1186,0,1186,94,1280,0,1280,0
25362,2019-07-05,112,0,112,8,120,120,0,0
25363,2019-07-05,1038,0,1038,82,1120,1120,0,0
25364,2019-07-05,1889,0,1889,151,2040,2040,0,0
25365,2019-07-05,1547,0,1547,123,1670,1670,0,0
25366,2019-07-05,807,0,807,55,862,862,0,0
25367,2019-07-05,2842,0,2842,218,3060,0,3060,0
25368,2019-07-05,565,0,565,45,610,0,610,0
25369,2019-07-05,667,0,667,53,720,0,720,0
25370,2019-07-05,788,0,788,62,850,850,0,0
25371,2019-07-05,713,0,713,57,770,770,0,0
25372,2019-07-05,639,0,639,51,690,690,0,0
25373,2019-07-05,250,0,250,20,270,270,0,0
25374,2019-07-05,593,0,593,47,640,640,0,0
25375,2019-07-05,972,0,972,68,1040,0,1040,0
25376,2019-07-05,1823,0,1823,137,1960,1960,0,0
25377,2019-07-05,399,0,399,31,430,430,0,0
25378,2019-07-05,176,0,176,14,190,190,0,0
25379,2019-07-05,806,0,806,64,870,870,0,0
25380,2019-07-05,463,0,463,37,500,0,500,0
25381,2019-07-05,695,0,695,55,750,750,0,0
25382,2019-07-05,695,0,695,55,750,0,750,0
25383,2019-07-05,501,0,501,39,540,540,0,0
25384,2019-07-05,-269,0,-269,-21,-290,-290,0,0
25385,2019-07-05,667,0,667,53,720,720,0,0
25386,2019-07-05,223,0,223,17,240,240,0,0
25387,2019-07-05,249,0,249,11,260,260,0,0
25388,2019-07-05,204,0,204,16,220,220,0,0
25389,2019-07-05,139,0,139,11,150,150,0,0
25390,2019-07-05,667,0,667,53,720,720,0,0
25391,2019-07-05,565,0,565,45,610,610,0,0
25392,2019-07-05,778,0,778,62,840,840,0,0
25393,2019-07-05,1084,0,1084,86,1170,1170,0,0
25394,2019-07-05,1362,0,1362,108,1470,0,1470,0
25395,2019-07-06,676,0,676,54,730,730,0,0
25396,2019-07-06,306,0,306,24,330,330,0,0
25397,2019-07-06,139,0,139,11,150,150,0,0
25398,2019-07-06,417,0,417,33,450,450,0,0
25399,2019-07-06,926,0,926,74,1000,1000,0,0
25400,2019-07-06,399,0,399,31,430,430,0,0
25401,2019-07-06,1417,0,1417,113,1530,1530,0,0
25402,2019-07-06,1436,0,1436,114,1550,0,1550,0
25403,2019-07-06,2073,-222,1851,147,1998,1998,0,0
25404,2019-07-06,223,0,223,17,240,240,0,0
25405,2019-07-06,334,0,334,26,360,360,0,0
25406,2019-07-06,501,0,501,39,540,540,0,0
25407,2019-07-06,843,0,843,67,910,0,910,0
25408,2019-07-06,908,0,908,72,980,0,980,0
25409,2019-07-06,908,0,908,72,980,980,0,0
25410,2019-07-06,556,0,556,44,600,600,0,0
25411,2019-07-06,908,0,908,72,980,980,0,0
25412,2019-07-06,3630,0,3630,290,3920,3920,0,0
25413,2019-07-06,806,0,806,64,870,870,0,0
25414,2019-07-06,565,0,565,45,610,610,0,0
25415,2019-07-06,777,0,777,53,830,830,0,0
25416,2019-07-06,575,0,575,45,620,620,0,0
25417,2019-07-06,1649,0,1649,131,1780,1780,0,0
25418,2019-07-06,584,0,584,46,630,630,0,0
25419,2019-07-06,1575,0,1575,125,1700,1700,0,0
25420,2019-07-06,630,0,630,50,680,680,0,0
25421,2019-07-06,1371,0,1371,109,1480,1480,0,0
25422,2019-07-06,2371,0,2371,189,2560,2560,0,0
25423,2019-07-06,565,0,565,45,610,610,0,0
25424,2019-07-06,759,0,759,51,810,810,0,0
25425,2019-07-06,908,0,908,72,980,980,0,0
25426,2019-07-06,908,0,908,72,980,980,0,0
25427,2019-07-06,1815,0,1815,145,1960,1960,0,0
25428,2019-07-06,834,0,834,66,900,900,0,0
25429,2019-07-06,547,0,547,43,590,590,0,0
25430,2019-07-06,313,0,313,7,320,320,0,0
25431,2019-07-06,704,0,704,56,760,760,0,0
25432,2019-07-06,917,0,917,73,990,990,0,0
25433,2019-07-06,362,0,362,28,390,390,0,0
25434,2019-07-06,417,0,417,33,450,450,0,0
25435,2019-07-06,1010,0,1010,80,1090,0,1090,0
25436,2019-07-06,232,0,232,18,250,250,0,0
25437,2019-07-06,871,0,871,69,940,940,0,0
25438,2019-07-06,426,0,426,34,460,460,0,0
25439,2019-07-06,926,0,926,74,1000,1000,0,0
25440,2019-07-06,1325,0,1325,105,1430,1430,0,0
25441,2019-07-06,362,0,362,28,390,390,0,0
25442,2019-07-06,880,0,880,70,950,950,0,0
25443,2019-07-06,425,0,425,25,450,450,0,0
25444,2019-07-06,260,0,260,20,280,280,0,0
25445,2019-07-06,370,0,370,20,390,390,0,0
25446,2019-07-06,454,0,454,36,490,490,0,0
25447,2019-07-06,269,0,269,21,290,290,0,0
25448,2019-07-06,269,0,269,21,290,290,0,0
25449,2019-07-06,139,0,139,11,150,150,0,0
25450,2019-07-06,306,0,306,24,330,330,0,0
25451,2019-07-06,1149,0,1149,91,1240,1240,0,0
25452,2019-07-06,908,0,908,72,980,980,0,0
25453,2019-07-06,797,0,797,63,860,860,0,0
25454,2019-07-06,1167,0,1167,93,1260,1260,0,0
25455,2019-07-06,1519,0,1519,121,1640,1640,0,0
25456,2019-07-06,760,0,760,60,820,820,0,0
25457,2019-07-06,1010,0,1010,80,1090,1090,0,0
25458,2019-07-06,899,0,899,71,970,970,0,0
25459,2019-07-06,482,0,482,38,520,520,0,0
25460,2019-07-06,232,0,232,18,250,250,0,0
25461,2019-07-06,1815,0,1815,145,1960,1960,0,0
25462,2019-07-06,926,0,926,74,1000,1000,0,0
25463,2019-07-06,519,0,519,41,560,560,0,0
25464,2019-07-06,973,0,973,77,1050,1050,0,0
25465,2019-07-06,1676,0,1676,134,1810,1810,0,0
25466,2019-07-06,473,0,473,37,510,510,0,0
25467,2019-07-06,917,0,917,73,990,990,0,0
25468,2019-07-06,1380,0,1380,110,1490,1490,0,0
25469,2019-07-06,288,0,288,22,310,310,0,0
25470,2019-07-06,176,0,176,14,190,190,0,0
25471,2019-07-06,695,0,695,55,750,750,0,0
25472,2019-07-06,1334,0,1334,106,1440,1440,0,0
25473,2019-07-06,658,0,658,52,710,710,0,0
25474,2019-07-06,510,0,510,40,550,550,0,0
25475,2019-07-06,3149,0,3149,251,3400,3400,0,0
25476,2019-07-06,408,0,408,32,440,440,0,0
25477,2019-07-06,288,0,288,22,310,310,0,0
25478,2019-07-06,2093,0,2093,167,2260,2260,0,0
25479,2019-07-06,5010,0,5010,400,5410,5410,0,0
25480,2019-07-06,1167,0,1167,93,1260,1260,0,0
25481,2019-07-06,899,0,899,71,970,970,0,0
25482,2019-07-06,620,0,620,40,660,660,0,0
25483,2019-07-06,306,0,306,24,330,330,0,0
25484,2019-07-06,1213,0,1213,97,1310,1310,0,0
25485,2019-07-06,538,0,538,42,580,580,0,0
25486,2019-07-06,325,0,325,25,350,350,0,0
25487,2019-07-06,306,0,306,24,330,330,0,0
25488,2019-07-06,1084,0,1084,86,1170,1170,0,0
25489,2019-07-06,1630,0,1630,130,1760,1760,0,0
25490,2019-07-06,362,0,362,28,390,390,0,0
25491,2019-07-06,195,0,195,15,210,210,0,0
25492,2019-07-06,676,0,676,54,730,730,0,0
25493,2019-07-06,501,0,501,39,540,540,0,0
25494,2019-07-06,862,0,862,68,930,930,0,0
25495,2019-07-06,482,0,482,38,520,520,0,0
25496,2019-07-06,962,0,962,68,1030,1030,0,0
25497,2019-07-06,323,0,323,17,340,340,0,0
25498,2019-07-06,334,0,334,26,360,360,0,0
25499,2019-07-06,362,0,362,28,390,390,0,0
25500,2019-07-06,445,0,445,35,480,480,0,0
25501,2019-07-06,732,0,732,58,790,790,0,0
25502,2019-07-06,186,0,186,14,200,200,0,0
25503,2019-07-06,1426,0,1426,114,1540,1540,0,0
25504,2019-07-06,583,0,583,37,620,620,0,0
25505,2019-07-06,686,0,686,54,740,740,0,0
25506,2019-07-06,241,0,241,19,260,260,0,0
25507,2019-07-06,2075,0,2075,165,2240,2240,0,0
25508,2019-07-06,732,0,732,58,790,790,0,0
25509,2019-07-06,834,0,834,66,900,900,0,0
25510,2019-07-06,1010,0,1010,80,1090,1090,0,0
25511,2019-07-06,334,0,334,26,360,360,0,0
25512,2019-07-06,241,0,241,19,260,260,0,0
25513,2019-07-06,402,-43,359,28,387,387,0,0
25514,2019-07-06,686,0,686,54,740,740,0,0
25515,2019-07-06,102,0,102,8,110,110,0,0
25516,2019-07-06,889,0,889,71,960,960,0,0
25517,2019-07-06,166,0,166,4,170,170,0,0
25518,2019-07-06,223,0,223,17,240,240,0,0
25519,2019-07-06,612,0,612,48,660,660,0,0
25520,2019-07-06,1093,0,1093,87,1180,0,1180,0
25521,2019-07-06,130,0,130,10,140,140,0,0
25522,2019-07-06,788,0,788,62,850,850,0,0
25523,2019-07-06,1204,0,1204,96,1300,1300,0,0
25524,2019-07-06,269,0,269,21,290,290,0,0
25525,2019-07-06,1575,0,1575,125,1700,1700,0,0
25526,2019-07-06,1575,0,1575,125,1700,1700,0,0
25527,2019-07-06,575,0,575,45,620,620,0,0
25528,2019-07-06,630,0,630,50,680,680,0,0
25529,2019-07-06,945,0,945,75,1020,0,1020,0
25530,2019-07-06,1575,0,1575,125,1700,1700,0,0
25531,2019-07-06,371,0,371,29,400,0,400,0
25532,2019-07-06,639,0,639,51,690,690,0,0
25533,2019-07-06,1352,0,1352,108,1460,0,1460,0
25534,2019-07-06,1112,0,1112,88,1200,1200,0,0
25535,2019-07-06,278,0,278,22,300,300,0,0
25536,2019-07-06,788,0,788,62,850,850,0,0
25537,2019-07-06,371,0,371,29,400,400,0,0
25538,2019-07-06,1575,0,1575,125,1700,1700,0,0
25539,2019-07-06,3982,0,3982,318,4300,4300,0,0
25540,2019-07-06,547,0,547,43,590,590,0,0
25541,2019-07-06,602,0,602,48,650,650,0,0
25542,2019-07-06,325,0,325,25,350,350,0,0
25543,2019-07-06,112,0,112,8,120,120,0,0
25544,2019-07-06,732,0,732,58,790,790,0,0
25545,2019-07-06,445,0,445,35,480,480,0,0
25546,2019-07-06,1584,0,1584,126,1710,1710,0,0
25547,2019-07-06,945,0,945,75,1020,1020,0,0
25548,2019-07-06,788,0,788,62,850,0,850,0
25549,2019-07-06,926,0,926,74,1000,1000,0,0
25550,2019-07-06,556,0,556,44,600,0,600,0
25551,2019-07-06,908,0,908,72,980,980,0,0
25552,2019-07-06,1195,0,1195,95,1290,0,1290,0
25553,2019-07-06,1028,0,1028,82,1110,1110,0,0
25554,2019-07-06,1575,0,1575,125,1700,1700,0,0
25555,2019-07-06,1575,0,1575,125,1700,0,1700,0
25556,2019-07-06,1575,0,1575,125,1700,1700,0,0
25557,2019-07-07,908,0,908,72,980,980,0,0
25558,2019-07-07,510,0,510,40,550,550,0,0
25559,2019-07-07,1362,0,1362,108,1470,1470,0,0
25560,2019-07-07,2204,0,2204,176,2380,2380,0,0
25561,2019-07-07,269,0,269,21,290,290,0,0
25562,2019-07-07,1101,0,1101,79,1180,1180,0,0
25563,2019-07-07,1815,0,1815,145,1960,1960,0,0
25564,2019-07-07,815,0,815,65,880,880,0,0
25565,2019-07-07,1056,0,1056,84,1140,1140,0,0
25566,2019-07-07,445,0,445,35,480,480,0,0
25567,2019-07-07,649,0,649,51,700,700,0,0
25568,2019-07-07,584,0,584,46,630,630,0,0
25569,2019-07-07,1815,0,1815,145,1960,0,1960,0
25570,2019-07-07,1399,0,1399,111,1510,1510,0,0
25571,2019-07-07,575,0,575,45,620,620,0,0
25572,2019-07-07,1399,0,1399,111,1510,0,0,1510
25573,2019-07-07,915,-98,817,65,882,882,0,0
25574,2019-07-07,386,-82,304,24,328,328,0,0
25575,2019-07-07,915,-98,817,65,882,882,0,0
25576,2019-07-07,908,0,908,72,980,980,0,0
25577,2019-07-07,908,0,908,72,980,0,0,980
25578,2019-07-07,908,0,908,72,980,980,0,0
25579,2019-07-07,-908,0,-908,-72,-980,0,0,-980
25580,2019-07-07,1815,0,1815,145,1960,1960,0,0
25581,2019-07-07,908,0,908,72,980,980,0,0
25582,2019-07-07,908,0,908,72,980,980,0,0
25583,2019-07-07,556,0,556,44,600,600,0,0
25584,2019-07-07,315,0,315,25,340,340,0,0
25585,2019-07-07,852,0,852,68,920,920,0,0
25586,2019-07-07,1185,0,1185,85,1270,1270,0,0
25587,2019-07-07,1575,0,1575,125,1700,1700,0,0
25588,2019-07-07,1815,0,1815,145,1960,1960,0,0
25589,2019-07-07,908,0,908,72,980,980,0,0
25590,2019-07-07,915,-98,817,65,882,0,882,0
25591,2019-07-07,440,0,440,0,440,440,0,0
25592,2019-07-07,593,0,593,47,640,640,0,0
25593,2019-07-07,616,-66,550,44,594,594,0,0
25594,2019-07-07,788,0,788,62,850,850,0,0
25595,2019-07-07,343,0,343,27,370,370,0,0
25596,2019-07-07,297,0,297,23,320,320,0,0
25597,2019-07-07,926,0,926,74,1000,1000,0,0
25598,2019-07-07,991,0,991,79,1070,1070,0,0
25599,2019-07-07,1139,0,1139,91,1230,1230,0,0
25600,2019-07-07,704,0,704,56,760,760,0,0
25601,2019-07-07,602,0,602,48,650,650,0,0
25602,2019-07-07,1612,0,1612,128,1740,1740,0,0
25603,2019-07-07,315,0,315,25,340,340,0,0
25604,2019-07-07,306,0,306,24,330,330,0,0
25605,2019-07-07,778,0,778,62,840,840,0,0
25606,2019-07-07,584,0,584,46,630,630,0,0
25607,2019-07-07,973,0,973,77,1050,1050,0,0
25608,2019-07-07,871,0,871,69,940,940,0,0
25609,2019-07-07,501,0,501,39,540,540,0,0
25610,2019-07-07,334,0,334,26,360,360,0,0
25611,2019-07-07,1815,0,1815,145,1960,1960,0,0
25612,2019-07-07,908,0,908,72,980,980,0,0
25613,2019-07-07,500,0,500,40,540,540,0,0
25614,2019-07-07,2352,0,2352,188,2540,2540,0,0
25615,2019-07-07,260,0,260,20,280,280,0,0
25616,2019-07-07,908,0,908,72,980,980,0,0
25617,2019-07-07,380,0,380,30,410,410,0,0
25618,2019-07-07,172,0,172,13,185,185,0,0
25619,2019-07-07,3621,0,3621,289,3910,3910,0,0
25620,2019-07-07,1371,0,1371,109,1480,1480,0,0
25621,2019-07-07,658,0,658,52,710,710,0,0
25622,2019-07-07,482,0,482,38,520,520,0,0
25623,2019-07-07,713,0,713,57,770,770,0,0
25624,2019-07-07,121,0,121,9,130,130,0,0
25625,2019-07-07,1251,0,1251,99,1350,1350,0,0
25626,2019-07-07,445,0,445,35,480,480,0,0
25627,2019-07-07,1251,0,1251,99,1350,1350,0,0
25628,2019-07-07,288,0,288,22,310,310,0,0
25629,2019-07-07,1417,0,1417,113,1530,1530,0,0
25630,2019-07-07,1158,0,1158,92,1250,1250,0,0
25631,2019-07-07,269,0,269,21,290,0,0,290
25632,2019-07-07,621,0,621,49,670,670,0,0
25633,2019-07-07,297,0,297,23,320,320,0,0
25634,2019-07-07,797,0,797,63,860,860,0,0
25635,2019-07-07,501,0,501,39,540,540,0,0
25636,2019-07-07,223,0,223,17,240,240,0,0
25637,2019-07-07,602,0,602,48,650,0,650,0
25638,2019-07-07,1723,0,1723,137,1860,1860,0,0
25639,2019-07-07,426,0,426,34,460,460,0,0
25640,2019-07-07,334,0,334,26,360,360,0,0
25641,2019-07-07,204,0,204,16,220,220,0,0
25642,2019-07-07,417,0,417,33,450,450,0,0
25643,2019-07-07,232,0,232,18,250,250,0,0
25644,2019-07-07,769,0,769,61,830,830,0,0
25645,2019-07-07,436,0,436,34,470,470,0,0
25646,2019-07-07,269,0,269,21,290,290,0,0
25647,2019-07-07,1223,0,1223,97,1320,1320,0,0
25648,2019-07-07,1019,0,1019,81,1100,1100,0,0
25649,2019-07-07,288,0,288,22,310,310,0,0
25650,2019-07-07,778,0,778,62,840,840,0,0
25651,2019-07-07,139,0,139,11,150,150,0,0
25652,2019-07-07,889,0,889,71,960,960,0,0
25653,2019-07-07,463,0,463,37,500,500,0,0
25654,2019-07-07,565,0,565,45,610,610,0,0
25655,2019-07-07,1482,0,1482,118,1600,1600,0,0
25656,2019-07-07,269,0,269,21,290,290,0,0
25657,2019-07-07,297,0,297,23,320,320,0,0
25658,2019-07-07,926,0,926,74,1000,1000,0,0
25659,2019-07-07,1019,0,1019,81,1100,1100,0,0
25660,2019-07-07,1769,0,1769,141,1910,1910,0,0
25661,2019-07-07,871,0,871,69,940,0,0,940
25662,2019-07-07,945,0,945,75,1020,1020,0,0
25663,2019-07-07,751,0,751,59,810,810,0,0
25664,2019-07-07,528,0,528,42,570,570,0,0
25665,2019-07-07,389,0,389,31,420,420,0,0
25666,2019-07-07,315,0,315,25,340,340,0,0
25667,2019-07-07,1575,0,1575,125,1700,1700,0,0
25668,2019-07-07,843,0,843,67,910,910,0,0
25669,2019-07-07,825,0,825,65,890,890,0,0
25670,2019-07-07,1788,0,1788,142,1930,1930,0,0
25671,2019-07-07,223,0,223,17,240,240,0,0
25672,2019-07-07,639,0,639,51,690,690,0,0
25673,2019-07-07,315,0,315,25,340,340,0,0
25674,2019-07-07,723,0,723,57,780,780,0,0
25675,2019-07-07,288,0,288,22,310,310,0,0
25676,2019-07-07,899,0,899,71,970,970,0,0
25677,2019-07-07,806,0,806,64,870,870,0,0
25678,2019-07-07,510,0,510,40,550,550,0,0
25679,2019-07-07,963,0,963,77,1040,1040,0,0
25680,2019-07-07,963,0,963,77,1040,1040,0,0
25681,2019-07-07,394,0,394,31,425,0,425,0
25682,2019-07-07,1575,0,1575,125,1700,1700,0,0
25683,2019-07-07,889,0,889,71,960,960,0,0
25684,2019-07-07,278,0,278,22,300,300,0,0
25685,2019-07-07,167,0,167,13,180,180,0,0
25686,2019-07-07,232,0,232,18,250,250,0,0
25687,2019-07-07,334,0,334,26,360,360,0,0
25688,2019-07-07,788,0,788,62,850,850,0,0
25689,2019-07-07,788,0,788,62,850,850,0,0
25690,2019-07-07,1575,0,1575,125,1700,1700,0,0
25691,2019-07-07,788,0,788,62,850,0,850,0
25692,2019-07-07,288,0,288,22,310,310,0,0
25693,2019-07-07,2380,0,2380,190,2570,2570,0,0
25694,2019-07-07,362,0,362,28,390,390,0,0
25695,2019-07-07,1936,0,1936,154,2090,2090,0,0
25696,2019-07-07,167,0,167,13,180,180,0,0
25697,2019-07-07,843,0,843,67,910,910,0,0
25698,2019-07-07,788,0,788,62,850,850,0,0
25699,2019-07-07,788,0,788,62,850,850,0,0
25700,2019-07-07,788,0,788,62,850,850,0,0
25701,2019-07-08,167,0,167,13,180,180,0,0
25702,2019-07-08,278,0,278,22,300,0,0,300
25703,2019-07-08,1815,0,1815,145,1960,1960,0,0
25704,2019-07-08,1481,0,1481,109,1590,1590,0,0
25705,2019-07-08,251,0,251,19,270,270,0,0
25706,2019-07-08,806,0,806,64,870,870,0,0
25707,2019-07-08,1815,0,1815,145,1960,1960,0,0
25708,2019-07-08,908,0,908,72,980,980,0,0
25709,2019-07-08,908,0,908,72,980,980,0,0
25710,2019-07-08,908,0,908,72,980,980,0,0
25711,2019-07-08,630,0,630,50,680,680,0,0
25712,2019-07-08,482,0,482,38,520,520,0,0
25713,2019-07-08,538,0,538,42,580,580,0,0
25714,2019-07-08,352,0,352,28,380,380,0,0
25715,2019-07-08,251,0,251,19,270,0,270,0
25716,2019-07-08,704,0,704,56,760,760,0,0
25717,2019-07-08,1195,0,1195,95,1290,1290,0,0
25718,2019-07-08,1815,0,1815,145,1960,1960,0,0
25719,2019-07-08,565,0,565,45,610,610,0,0
25720,2019-07-08,306,0,306,24,330,330,0,0
25721,2019-07-08,746,0,746,59,805,805,0,0
25722,2019-07-08,686,0,686,54,740,740,0,0
25723,2019-07-08,812,-87,725,58,783,783,0,0
25724,2019-07-08,695,0,695,55,750,750,0,0
25725,2019-07-08,501,0,501,39,540,540,0,0
25726,2019-07-08,1278,0,1278,102,1380,1380,0,0
25727,2019-07-08,575,0,575,45,620,620,0,0
25728,2019-07-08,417,0,417,33,450,450,0,0
25729,2019-07-08,501,0,501,39,540,540,0,0
25730,2019-07-08,408,0,408,32,440,440,0,0
25731,2019-07-08,908,0,908,72,980,980,0,0
25732,2019-07-08,908,0,908,72,980,980,0,0
25733,2019-07-08,1158,-124,1034,82,1116,1116,0,0
25734,2019-07-08,658,0,658,52,710,710,0,0
25735,2019-07-08,519,0,519,41,560,560,0,0
25736,2019-07-08,538,0,538,42,580,580,0,0
25737,2019-07-08,260,0,260,20,280,280,0,0
25738,2019-07-08,426,0,426,34,460,460,0,0
25739,2019-07-08,1278,0,1278,102,1380,1380,0,0
25740,2019-07-08,306,0,306,24,330,330,0,0
25741,2019-07-08,852,0,852,68,920,920,0,0
25742,2019-07-08,408,0,408,32,440,440,0,0
25743,2019-07-08,862,0,862,68,930,930,0,0
25744,2019-07-08,315,0,315,25,340,340,0,0
25745,2019-07-08,510,0,510,40,550,550,0,0
25746,2019-07-08,538,0,538,42,580,580,0,0
25747,2019-07-08,389,0,389,31,420,420,0,0
25748,2019-07-08,1010,0,1010,80,1090,1090,0,0
25749,2019-07-08,2519,0,2519,201,2720,2720,0,0
25750,2019-07-08,250,0,250,20,270,0,0,270
25751,2019-07-08,871,0,871,69,940,940,0,0
25752,2019-07-08,695,0,695,55,750,0,750,0
25753,2019-07-08,1815,0,1815,145,1960,0,1960,0
25754,2019-07-08,1963,0,1963,157,2120,2120,0,0
25755,2019-07-08,1815,0,1815,145,1960,0,1960,0
25756,2019-07-08,501,0,501,39,540,540,0,0
25757,2019-07-08,1815,0,1815,145,1960,1960,0,0
25758,2019-07-08,723,0,723,57,780,780,0,0
25759,2019-07-08,908,0,908,72,980,980,0,0
25760,2019-07-08,658,0,658,52,710,710,0,0
25761,2019-07-08,908,0,908,72,980,980,0,0
25762,2019-07-08,593,0,593,47,640,640,0,0
25763,2019-07-08,1361,0,1361,99,1460,1460,0,0
25764,2019-07-08,463,0,463,37,500,500,0,0
25765,2019-07-08,1010,0,1010,80,1090,1090,0,0
25766,2019-07-08,1862,0,1862,148,2010,2010,0,0
25767,2019-07-08,334,0,334,26,360,360,0,0
25768,2019-07-08,806,0,806,64,870,870,0,0
25769,2019-07-08,1010,0,1010,80,1090,1090,0,0
25770,2019-07-08,797,0,797,63,860,860,0,0
25771,2019-07-08,334,0,334,26,360,360,0,0
25772,2019-07-08,519,0,519,41,560,560,0,0
25773,2019-07-08,528,0,528,42,570,570,0,0
25774,2019-07-08,695,0,695,55,750,750,0,0
25775,2019-07-08,193,0,193,15,208,208,0,0
25776,2019-07-08,396,0,396,22,418,0,0,418
25777,2019-07-08,234,-25,209,16,225,225,0,0
25778,2019-07-08,667,0,667,53,720,720,0,0
25779,2019-07-08,797,0,797,63,860,860,0,0
25780,2019-07-08,712,0,712,48,760,760,0,0
25781,2019-07-08,695,0,695,55,750,750,0,0
25782,2019-07-08,269,0,269,21,290,290,0,0
25783,2019-07-08,593,0,593,47,640,640,0,0
25784,2019-07-08,352,0,352,28,380,380,0,0
25785,2019-07-08,1371,0,1371,109,1480,1480,0,0
25786,2019-07-08,584,0,584,46,630,630,0,0
25787,2019-07-08,667,0,667,53,720,720,0,0
25788,2019-07-08,491,0,491,39,530,530,0,0
25789,2019-07-08,1065,0,1065,85,1150,1150,0,0
25790,2019-07-08,473,0,473,37,510,510,0,0
25791,2019-07-08,2269,0,2269,181,2450,2450,0,0
25792,2019-07-08,176,0,176,14,190,190,0,0
25793,2019-07-08,4075,0,4075,325,4400,4400,0,0
25794,2019-07-08,278,0,278,22,300,300,0,0
25795,2019-07-08,269,0,269,21,290,290,0,0
25796,2019-07-08,116,0,116,9,125,125,0,0
25797,2019-07-08,630,0,630,50,680,680,0,0
25798,2019-07-08,908,0,908,72,980,980,0,0
25799,2019-07-08,908,0,908,72,980,980,0,0
25800,2019-07-08,1833,0,1833,137,1970,1970,0,0
25801,2019-07-08,408,0,408,32,440,440,0,0
25802,2019-07-08,667,0,667,53,720,720,0,0
25803,2019-07-08,288,0,288,22,310,310,0,0
25804,2019-07-08,1056,0,1056,84,1140,1140,0,0
25805,2019-07-08,260,0,260,20,280,280,0,0
25806,2019-07-08,982,0,982,78,1060,1060,0,0
25807,2019-07-08,1619,0,1619,111,1730,1730,0,0
25808,2019-07-08,1565,0,1565,125,1690,1690,0,0
25809,2019-07-08,713,0,713,57,770,770,0,0
25810,2019-07-08,1343,0,1343,107,1450,1450,0,0
25811,2019-07-08,788,0,788,62,850,850,0,0
25812,2019-07-08,1149,0,1149,91,1240,1240,0,0
25813,2019-07-08,1334,0,1334,106,1440,0,1440,0
25814,2019-07-08,454,0,454,36,490,490,0,0
25815,2019-07-08,1575,0,1575,125,1700,1700,0,0
25816,2019-07-08,2130,0,2130,170,2300,2300,0,0
25817,2019-07-08,1575,0,1575,125,1700,1700,0,0
25818,2019-07-08,260,0,260,20,280,280,0,0
25819,2019-07-08,-389,0,-389,-31,-420,-420,0,0
25820,2019-07-08,788,0,788,62,850,850,0,0
25821,2019-07-08,-788,0,-788,-62,-850,-850,0,0
25822,2019-07-08,389,0,389,31,420,420,0,0
25823,2019-07-08,-389,0,-389,-31,-420,-420,0,0
25824,2019-07-08,389,0,389,31,420,420,0,0
25825,2019-07-09,389,0,389,31,420,420,0,0
25826,2019-07-09,454,0,454,36,490,490,0,0
25827,2019-07-09,306,0,306,24,330,330,0,0
25828,2019-07-09,1186,0,1186,94,1280,1280,0,0
25829,2019-07-09,649,0,649,51,700,700,0,0
25830,2019-07-09,325,0,325,25,350,350,0,0
25831,2019-07-09,241,0,241,19,260,260,0,0
25832,2019-07-09,365,-39,326,25,351,351,0,0
25833,2019-07-09,130,0,130,10,140,140,0,0
25834,2019-07-09,371,0,371,29,400,400,0,0
25835,2019-07-09,2139,0,2139,171,2310,2310,0,0
25836,2019-07-09,471,0,471,19,490,490,0,0
25837,2019-07-09,1278,0,1278,102,1380,0,1380,0
25838,2019-07-09,639,0,639,51,690,690,0,0
25839,2019-07-09,652,-69,583,38,621,621,0,0
25840,2019-07-09,241,0,241,19,260,260,0,0
25841,2019-07-09,149,0,149,11,160,160,0,0
25842,2019-07-09,204,0,204,16,220,220,0,0
25843,2019-07-09,343,0,343,27,370,370,0,0
25844,2019-07-09,686,0,686,54,740,740,0,0
25845,2019-07-09,1232,0,1232,98,1330,1330,0,0
25846,2019-07-09,501,0,501,39,540,540,0,0
25847,2019-07-10,908,0,908,72,980,980,0,0
25848,2019-07-10,908,0,908,72,980,980,0,0
25849,2019-07-10,908,0,908,72,980,980,0,0
25850,2019-07-10,1269,0,1269,101,1370,1370,0,0
25851,2019-07-10,1815,0,1815,145,1960,1960,0,0
25852,2019-07-10,1241,0,1241,99,1340,1340,0,0
25853,2019-07-10,519,0,519,41,560,560,0,0
25854,2019-07-10,991,0,991,79,1070,1070,0,0
25855,2019-07-10,436,0,436,34,470,470,0,0
25856,2019-07-10,945,0,945,75,1020,1020,0,0
25857,2019-07-10,908,0,908,72,980,980,0,0
25858,2019-07-10,1923,-206,1717,137,1854,1854,0,0
25859,2019-07-10,473,0,473,37,510,510,0,0
25860,2019-07-10,908,0,908,72,980,980,0,0
25861,2019-07-10,482,0,482,38,520,520,0,0
25862,2019-07-10,463,0,463,37,500,500,0,0
25863,2019-07-10,621,0,621,49,670,670,0,0
25864,2019-07-10,251,0,251,19,270,270,0,0
25865,2019-07-10,908,0,908,72,980,980,0,0
25866,2019-07-10,473,0,473,37,510,510,0,0
25867,2019-07-10,379,0,379,21,400,400,0,0
25868,2019-07-10,315,0,315,25,340,340,0,0
25869,2019-07-10,1038,0,1038,82,1120,1120,0,0
25870,2019-07-10,695,0,695,55,750,750,0,0
25871,2019-07-10,528,0,528,42,570,570,0,0
25872,2019-07-10,1288,0,1288,102,1390,1390,0,0
25873,2019-07-10,1084,0,1084,86,1170,1170,0,0
25874,2019-07-10,686,0,686,54,740,740,0,0
25875,2019-07-10,473,0,473,37,510,0,0,510
25876,2019-07-10,1121,-120,1001,79,1080,1080,0,0
25877,2019-07-10,297,0,297,23,320,320,0,0
25878,2019-07-10,371,0,371,29,400,400,0,0
25879,2019-07-10,936,0,936,74,1010,1010,0,0
25880,2019-07-10,444,0,444,26,470,470,0,0
25881,2019-07-10,315,0,315,25,340,340,0,0
25882,2019-07-10,315,0,315,25,340,340,0,0
25883,2019-07-10,963,0,963,77,1040,1040,0,0
25884,2019-07-10,380,0,380,30,410,410,0,0
25885,2019-07-10,3501,0,3501,279,3780,3780,0,0
25886,2019-07-10,306,0,306,24,330,330,0,0
25887,2019-07-10,473,0,473,37,510,510,0,0
25888,2019-07-10,491,0,491,39,530,530,0,0
25889,2019-07-10,1981,0,1981,149,2130,2130,0,0
25890,2019-07-10,658,0,658,52,710,710,0,0
25891,2019-07-10,149,0,149,11,160,160,0,0
25892,2019-07-10,760,0,760,60,820,820,0,0
25893,2019-07-10,630,0,630,50,680,0,680,0
25894,2019-07-10,1575,0,1575,125,1700,0,1700,0
25895,2019-07-10,371,0,371,29,400,0,400,0
25896,2019-07-10,1065,0,1065,85,1150,1150,0,0
25897,2019-07-10,908,0,908,72,980,980,0,0
25898,2019-07-10,908,0,908,72,980,980,0,0
25899,2019-07-10,288,0,288,22,310,310,0,0
25900,2019-07-10,797,0,797,63,860,860,0,0
25901,2019-07-10,2723,0,2723,217,2940,2940,0,0
25902,2019-07-10,436,0,436,34,470,470,0,0
25903,2019-07-10,343,0,343,27,370,370,0,0
25904,2019-07-10,607,-65,542,43,585,585,0,0
25905,2019-07-10,407,0,407,23,430,430,0,0
25906,2019-07-10,834,0,834,66,900,900,0,0
25907,2019-07-10,806,0,806,64,870,870,0,0
25908,2019-07-10,1575,0,1575,125,1700,1700,0,0
25909,2019-07-10,1575,0,1575,125,1700,0,1700,0
25910,2019-07-10,223,0,223,17,240,0,240,0
25911,2019-07-10,621,0,621,49,670,670,0,0
25912,2019-07-10,538,0,538,42,580,580,0,0
25913,2019-07-10,1575,0,1575,125,1700,1700,0,0
25914,2019-07-10,510,0,510,40,550,550,0,0
25915,2019-07-10,473,0,473,37,510,510,0,0
25916,2019-07-10,167,0,167,13,180,180,0,0
25917,2019-07-10,554,0,554,26,580,580,0,0
25918,2019-07-10,5278,0,5278,422,5700,0,5700,0
25919,2019-07-10,1825,0,1825,145,1970,1970,0,0
25920,2019-07-10,788,0,788,62,850,850,0,0
25921,2019-07-10,2362,0,2362,188,2550,2550,0,0
25922,2019-07-10,501,0,501,39,540,540,0,0
25923,2019-07-10,204,0,204,16,220,0,220,0
25924,2019-07-10,1575,0,1575,125,1700,1700,0,0
25925,2019-07-10,416,0,416,24,440,440,0,0
25926,2019-07-10,741,0,741,59,800,0,800,0
25927,2019-07-10,1417,0,1417,113,1530,0,1530,0
25928,2019-07-10,871,0,871,69,940,940,0,0
25929,2019-07-10,167,0,167,13,180,180,0,0
25930,2019-07-10,973,0,973,77,1050,1050,0,0
25931,2019-07-10,945,0,945,75,1020,1020,0,0
25932,2019-07-10,788,0,788,62,850,850,0,0
25933,2019-07-10,639,0,639,51,690,0,690,0
25934,2019-07-10,547,0,547,43,590,590,0,0
25935,2019-07-10,519,0,519,41,560,560,0,0
25936,2019-07-10,1575,0,1575,125,1700,1700,0,0
25937,2019-07-10,278,0,278,22,300,300,0,0
25938,2019-07-10,788,0,788,62,850,850,0,0
25939,2019-07-10,649,0,649,51,700,700,0,0
25940,2019-07-10,556,0,556,44,600,600,0,0
25941,2019-07-10,741,0,741,59,800,800,0,0
25942,2019-07-10,371,0,371,29,400,400,0,0
25943,2019-07-10,389,0,389,31,420,420,0,0
25944,2019-07-10,389,0,389,31,420,420,0,0
25945,2019-07-10,-1149,0,-1149,-91,-1240,-1240,0,0
25946,2019-07-10,1149,0,1149,91,1240,1240,0,0
25947,2019-07-10,751,0,751,59,810,810,0,0
25948,2019-07-10,277,0,277,13,290,290,0,0
25949,2019-07-10,778,0,778,62,840,840,0,0
25950,2019-07-10,334,0,334,26,360,360,0,0
25951,2019-07-10,815,0,815,65,880,880,0,0
25952,2019-07-10,482,0,482,38,520,520,0,0
25953,2019-07-10,1112,0,1112,88,1200,1200,0,0
25954,2019-07-10,769,0,769,61,830,830,0,0
25955,2019-07-10,1306,0,1306,104,1410,1410,0,0
25956,2019-07-10,343,0,343,27,370,370,0,0
25957,2019-07-10,388,0,388,22,410,410,0,0
25958,2019-07-10,260,0,260,20,280,280,0,0
25959,2019-07-10,260,0,260,20,280,0,280,0
25960,2019-07-10,871,0,871,69,940,940,0,0
25961,2019-07-10,167,0,167,13,180,180,0,0
25962,2019-07-10,593,0,593,47,640,640,0,0
25963,2019-07-10,565,0,565,45,610,610,0,0
25964,2019-07-10,260,0,260,20,280,280,0,0
25965,2019-07-10,2426,0,2426,194,2620,0,2620,0
25966,2019-07-10,538,0,538,42,580,580,0,0
25967,2019-07-10,1075,0,1075,85,1160,1160,0,0
25968,2019-07-11,908,0,908,72,980,980,0,0
25969,2019-07-11,1297,0,1297,103,1400,1400,0,0
25970,2019-07-11,297,0,297,23,320,320,0,0
25971,2019-07-11,2158,0,2158,172,2330,2330,0,0
25972,2019-07-11,908,0,908,72,980,980,0,0
25973,2019-07-11,417,0,417,33,450,450,0,0
25974,2019-07-11,889,0,889,71,960,960,0,0
25975,2019-07-11,346,-37,309,24,333,333,0,0
25976,2019-07-11,4213,0,4213,337,4550,4550,0,0
25977,2019-07-11,1797,0,1797,143,1940,0,1940,0
25978,2019-07-11,908,0,908,72,980,980,0,0
25979,2019-07-11,908,0,908,72,980,980,0,0
25980,2019-07-11,343,0,343,27,370,370,0,0
25981,2019-07-11,908,0,908,72,980,980,0,0
25982,2019-07-11,1343,0,1343,107,1450,1450,0,0
25983,2019-07-11,778,0,778,62,840,840,0,0
25984,2019-07-11,691,-74,617,49,666,666,0,0
25985,2019-07-11,223,0,223,17,240,240,0,0
25986,2019-07-11,556,0,556,44,600,600,0,0
25987,2019-07-11,547,0,547,43,590,590,0,0
25988,2019-07-11,315,0,315,25,340,340,0,0
25989,2019-07-11,553,0,553,17,570,570,0,0
25990,2019-07-11,362,0,362,28,390,390,0,0
25991,2019-07-11,991,0,991,79,1070,1070,0,0
25992,2019-07-11,1038,0,1038,82,1120,1120,0,0
25993,2019-07-11,602,0,602,48,650,0,650,0
25994,2019-07-11,1010,0,1010,80,1090,0,1090,0
25995,2019-07-11,880,0,880,70,950,950,0,0
25996,2019-07-11,519,0,519,41,560,560,0,0
25997,2019-07-11,954,0,954,76,1030,1030,0,0
25998,2019-07-11,1704,0,1704,136,1840,1840,0,0
25999,2019-07-11,491,0,491,39,530,530,0,0
26000,2019-07-11,362,0,362,28,390,390,0,0
26001,2019-07-11,769,0,769,61,830,830,0,0
26002,2019-07-11,612,0,612,48,660,660,0,0
26003,2019-07-11,436,0,436,34,470,470,0,0
26004,2019-07-11,908,0,908,72,980,980,0,0
26005,2019-07-11,139,0,139,11,150,150,0,0
26006,2019-07-11,315,0,315,25,340,340,0,0
26007,2019-07-11,-1297,0,-1297,-103,-1400,-1400,0,0
26008,2019-07-11,1297,0,1297,103,1400,1400,0,0
26009,2019-07-11,416,0,416,24,440,440,0,0
26010,2019-07-11,297,0,297,23,320,320,0,0
26011,2019-07-11,889,0,889,71,960,960,0,0
26012,2019-07-11,834,0,834,66,900,900,0,0
26013,2019-07-11,371,0,371,29,400,400,0,0
26014,2019-07-11,990,0,990,70,1060,1060,0,0
26015,2019-07-11,482,0,482,38,520,520,0,0
26016,2019-07-11,167,0,167,13,180,180,0,0
26017,2019-07-11,815,0,815,65,880,880,0,0
26018,2019-07-11,908,0,908,72,980,980,0,0
26019,2019-07-11,769,0,769,61,830,830,0,0
26020,2019-07-11,149,0,149,11,160,160,0,0
26021,2019-07-11,362,0,362,28,390,390,0,0
26022,2019-07-11,908,0,908,72,980,980,0,0
26023,2019-07-11,445,0,445,35,480,480,0,0
26024,2019-07-11,686,0,686,54,740,740,0,0
26025,2019-07-11,700,-75,625,50,675,675,0,0
26026,2019-07-11,1038,0,1038,82,1120,1120,0,0
26027,2019-07-11,388,0,388,22,410,410,0,0
26028,2019-07-11,232,0,232,18,250,250,0,0
26029,2019-07-11,362,0,362,28,390,390,0,0
26030,2019-07-11,472,0,472,28,500,500,0,0
26031,2019-07-11,639,0,639,51,690,690,0,0
26032,2019-07-11,389,0,389,31,420,420,0,0
26033,2019-07-11,1269,0,1269,101,1370,1370,0,0
26034,2019-07-11,908,0,908,72,980,980,0,0
26035,2019-07-11,908,0,908,72,980,980,0,0
26036,2019-07-11,546,0,546,34,580,580,0,0
26037,2019-07-11,1815,0,1815,145,1960,1960,0,0
26038,2019-07-11,760,0,760,60,820,820,0,0
26039,2019-07-11,788,0,788,62,850,850,0,0
26040,2019-07-11,371,0,371,29,400,400,0,0
26041,2019-07-11,778,0,778,62,840,840,0,0
26042,2019-07-11,389,0,389,31,420,420,0,0
26043,2019-07-11,371,0,371,29,400,400,0,0
26044,2019-07-11,269,0,269,21,290,290,0,0
26045,2019-07-11,315,0,315,25,340,340,0,0
26046,2019-07-11,315,0,315,25,340,340,0,0
26047,2019-07-11,1278,0,1278,102,1380,0,1380,0
26048,2019-07-11,260,0,260,20,280,280,0,0
26049,2019-07-11,519,0,519,41,560,560,0,0
26050,2019-07-11,24,0,24,1,25,25,0,0
26051,2019-07-11,667,0,667,53,720,0,0,720
26052,2019-07-11,667,0,667,53,720,720,0,0
26053,2019-07-11,584,0,584,46,630,630,0,0
26054,2019-07-11,278,0,278,22,300,300,0,0
26055,2019-07-11,186,0,186,14,200,200,0,0
26056,2019-07-11,621,0,621,49,670,0,670,0
26057,2019-07-11,899,0,899,71,970,970,0,0
26058,2019-07-11,862,0,862,68,930,930,0,0
26059,2019-07-11,1121,0,1121,89,1210,1210,0,0
26060,2019-07-11,408,0,408,32,440,440,0,0
26061,2019-07-11,593,0,593,47,640,640,0,0
26062,2019-07-11,1038,0,1038,82,1120,1120,0,0
26063,2019-07-11,815,0,815,65,880,880,0,0
26064,2019-07-11,343,0,343,27,370,370,0,0
26065,2019-07-11,519,0,519,41,560,560,0,0
26066,2019-07-11,1167,0,1167,93,1260,1260,0,0
26067,2019-07-11,482,0,482,38,520,520,0,0
26068,2019-07-11,195,0,195,15,210,210,0,0
26069,2019-07-11,467,0,467,37,504,504,0,0
26070,2019-07-11,639,0,639,51,690,690,0,0
26071,2019-07-11,575,0,575,45,620,620,0,0
26072,2019-07-11,602,0,602,48,650,650,0,0
26073,2019-07-11,371,0,371,29,400,400,0,0
26074,2019-07-11,269,0,269,21,290,290,0,0
26075,2019-07-11,501,0,501,39,540,540,0,0
26076,2019-07-11,417,0,417,33,450,450,0,0
26077,2019-07-11,371,0,371,29,400,400,0,0
26078,2019-07-11,436,0,436,34,470,470,0,0
26079,2019-07-11,232,0,232,18,250,250,0,0
26080,2019-07-11,1380,0,1380,110,1490,1490,0,0
26081,2019-07-11,616,0,616,49,665,665,0,0
26082,2019-07-11,269,0,269,21,290,290,0,0
26083,2019-07-11,788,0,788,62,850,850,0,0
26084,2019-07-11,788,0,788,62,850,0,0,850
26085,2019-07-11,1575,0,1575,125,1700,1700,0,0
26086,2019-07-11,917,0,917,73,990,990,0,0
26087,2019-07-11,314,0,314,16,330,330,0,0
26088,2019-07-11,1149,0,1149,91,1240,1240,0,0
26089,2019-07-11,788,0,788,62,850,850,0,0
26090,2019-07-11,741,0,741,59,800,800,0,0
26091,2019-07-11,495,-53,442,35,477,477,0,0
26092,2019-07-11,269,0,269,21,290,290,0,0
26093,2019-07-11,519,0,519,41,560,560,0,0
26094,2019-07-11,2362,0,2362,188,2550,2550,0,0
26095,2019-07-11,1028,0,1028,82,1110,1110,0,0
26096,2019-07-11,315,0,315,25,340,340,0,0
26097,2019-07-11,389,0,389,31,420,420,0,0
26098,2019-07-11,325,0,325,25,350,350,0,0
26099,2019-07-11,612,0,612,48,660,660,0,0
26100,2019-07-11,232,0,232,18,250,250,0,0
26101,2019-07-11,463,0,463,37,500,500,0,0
26102,2019-07-11,288,0,288,22,310,310,0,0
26103,2019-07-11,1575,0,1575,125,1700,1700,0,0
26104,2019-07-11,260,0,260,20,280,280,0,0
26105,2019-07-11,1575,0,1575,125,1700,1700,0,0
26106,2019-07-11,1223,0,1223,97,1320,1320,0,0
26107,2019-07-11,973,0,973,77,1050,1050,0,0
26108,2019-07-11,334,0,334,26,360,360,0,0
26109,2019-07-11,2130,0,2130,170,2300,2300,0,0
26110,2019-07-11,334,0,334,26,360,360,0,0
26111,2019-07-12,1075,0,1075,85,1160,1160,0,0
26112,2019-07-12,1278,0,1278,102,1380,1380,0,0
26113,2019-07-12,2454,0,2454,196,2650,2650,0,0
26114,2019-07-12,149,0,149,11,160,160,0,0
26115,2019-07-12,501,0,501,39,540,540,0,0
26116,2019-07-12,962,0,962,68,1030,1030,0,0
26117,2019-07-12,2121,0,2121,169,2290,0,2290,0
26118,2019-07-12,167,0,167,13,180,180,0,0
26119,2019-07-12,528,0,528,42,570,570,0,0
26120,2019-07-12,565,0,565,45,610,610,0,0
26121,2019-07-12,399,0,399,31,430,430,0,0
26122,2019-07-12,991,0,991,79,1070,1070,0,0
26123,2019-07-12,1185,0,1185,85,1270,1270,0,0
26124,2019-07-12,297,0,297,23,320,320,0,0
26125,2019-07-12,269,0,269,21,290,290,0,0
26126,2019-07-12,352,0,352,28,380,380,0,0
26127,2019-07-12,1815,0,1815,145,1960,1960,0,0
26128,2019-07-12,352,0,352,28,380,380,0,0
26129,2019-07-12,1175,0,1175,85,1260,1260,0,0
26130,2019-07-12,389,0,389,31,420,420,0,0
26131,2019-07-12,584,0,584,46,630,630,0,0
26132,2019-07-12,1751,0,1751,139,1890,0,1890,0
26133,2019-07-12,297,0,297,23,320,320,0,0
26134,2019-07-12,1848,-198,1650,132,1782,1782,0,0
26135,2019-07-12,556,0,556,44,600,600,0,0
26136,2019-07-12,445,0,445,35,480,480,0,0
26137,2019-07-12,667,0,667,53,720,720,0,0
26138,2019-07-12,1130,0,1130,90,1220,1220,0,0
26139,2019-07-12,2713,0,2713,217,2930,2930,0,0
26140,2019-07-12,713,0,713,57,770,770,0,0
26141,2019-07-12,908,0,908,72,980,0,980,0
26142,2019-07-12,1445,0,1445,115,1560,1560,0,0
26143,2019-07-12,1815,0,1815,145,1960,1960,0,0
26144,2019-07-12,639,0,639,51,690,690,0,0
26145,2019-07-12,-908,0,-908,-72,-980,-980,0,0
26146,2019-07-12,417,0,417,33,450,450,0,0
26147,2019-07-12,232,0,232,18,250,250,0,0
26148,2019-07-12,336,-36,300,24,324,324,0,0
26149,2019-07-12,167,0,167,13,180,180,0,0
26150,2019-07-12,1352,0,1352,108,1460,1460,0,0
26151,2019-07-12,297,0,297,23,320,320,0,0
26152,2019-07-12,880,0,880,70,950,950,0,0
26153,2019-07-12,686,0,686,54,740,740,0,0
26154,2019-07-12,1334,0,1334,106,1440,1440,0,0
26155,2019-07-12,2547,0,2547,203,2750,0,2750,0
26156,2019-07-12,1815,0,1815,145,1960,1960,0,0
26157,2019-07-12,420,-45,375,30,405,405,0,0
26158,2019-07-12,315,0,315,25,340,340,0,0
26159,2019-07-12,575,0,575,45,620,620,0,0
26160,2019-07-12,797,0,797,63,860,860,0,0
26161,2019-07-12,362,0,362,28,390,390,0,0
26162,2019-07-12,380,0,380,30,410,410,0,0
26163,2019-07-12,806,0,806,64,870,870,0,0
26164,2019-07-12,306,0,306,24,330,330,0,0
26165,2019-07-12,556,0,556,44,600,600,0,0
26166,2019-07-12,686,0,686,54,740,740,0,0
26167,2019-07-12,1167,0,1167,93,1260,1260,0,0
26168,2019-07-12,565,0,565,45,610,610,0,0
26169,2019-07-12,325,0,325,25,350,350,0,0
26170,2019-07-12,389,0,389,31,420,420,0,0
26171,2019-07-12,760,0,760,60,820,0,820,0
26172,2019-07-12,1463,0,1463,117,1580,1580,0,0
26173,2019-07-12,445,0,445,35,480,0,480,0
26174,2019-07-12,1036,0,1036,74,1110,1110,0,0
26175,2019-07-12,1075,0,1075,85,1160,1160,0,0
26176,2019-07-12,778,0,778,62,840,840,0,0
26177,2019-07-12,1278,0,1278,102,1380,1380,0,0
26178,2019-07-12,417,0,417,33,450,450,0,0
26179,2019-07-12,388,0,388,22,410,410,0,0
26180,2019-07-12,1815,0,1815,145,1960,1960,0,0
26181,2019-07-12,1260,0,1260,100,1360,1360,0,0
26182,2019-07-12,797,0,797,63,860,860,0,0
26183,2019-07-12,538,0,538,42,580,580,0,0
26184,2019-07-12,695,0,695,55,750,750,0,0
26185,2019-07-12,195,0,195,15,210,210,0,0
26186,2019-07-12,380,0,380,30,410,410,0,0
26187,2019-07-12,880,0,880,70,950,950,0,0
26188,2019-07-12,435,0,435,25,460,460,0,0
26189,2019-07-12,371,0,371,29,400,400,0,0
26190,2019-07-12,500,0,500,40,540,540,0,0
26191,2019-07-12,658,0,658,52,710,710,0,0
26192,2019-07-12,889,0,889,71,960,960,0,0
26193,2019-07-12,223,0,223,17,240,240,0,0
26194,2019-07-12,556,0,556,44,600,600,0,0
26195,2019-07-12,1612,0,1612,128,1740,0,1740,0
26196,2019-07-12,426,0,426,34,460,460,0,0
26197,2019-07-12,232,0,232,18,250,250,0,0
26198,2019-07-12,306,0,306,24,330,330,0,0
26199,2019-07-12,269,0,269,21,290,290,0,0
26200,2019-07-12,-139,0,-139,-11,-150,0,0,-150
26201,2019-07-12,255,-54,201,15,216,216,0,0
26202,2019-07-12,880,0,880,70,950,950,0,0
26203,2019-07-12,1463,0,1463,117,1580,1580,0,0
26204,2019-07-12,1491,0,1491,119,1610,1610,0,0
26205,2019-07-12,788,0,788,62,850,850,0,0
26206,2019-07-12,788,0,788,62,850,850,0,0
26207,2019-07-12,139,0,139,11,150,0,0,150
26208,2019-07-12,982,0,982,78,1060,0,1060,0
26209,2019-07-12,-110,0,-110,0,-110,0,0,-110
26210,2019-07-12,639,0,639,51,690,690,0,0
26211,2019-07-12,1047,0,1047,83,1130,1130,0,0
26212,2019-07-12,241,0,241,19,260,260,0,0
26213,2019-07-12,2723,0,2723,217,2940,2940,0,0
26214,2019-07-12,1556,0,1556,124,1680,1680,0,0
26215,2019-07-12,686,0,686,54,740,740,0,0
26216,2019-07-12,904,-192,712,56,768,768,0,0
26217,2019-07-12,398,0,398,22,420,420,0,0
26218,2019-07-12,110,0,110,0,110,0,0,110
26219,2019-07-12,371,0,371,29,400,400,0,0
26220,2019-07-12,2001,0,2001,159,2160,2160,0,0
26221,2019-07-12,945,0,945,75,1020,1020,0,0
26222,2019-07-12,595,0,595,47,642,642,0,0
26223,2019-07-12,538,0,538,42,580,580,0,0
26224,2019-07-12,473,0,473,37,510,510,0,0
26225,2019-07-12,778,0,778,62,840,840,0,0
26226,2019-07-12,575,0,575,45,620,620,0,0
26227,2019-07-12,352,0,352,28,380,380,0,0
26228,2019-07-12,1621,0,1621,129,1750,1750,0,0
26229,2019-07-12,501,0,501,39,540,540,0,0
26230,2019-07-12,788,0,788,62,850,850,0,0
26231,2019-07-12,1195,0,1195,95,1290,1290,0,0
26232,2019-07-12,649,0,649,51,700,700,0,0
26233,2019-07-12,260,0,260,20,280,280,0,0
26234,2019-07-12,176,0,176,14,190,190,0,0
26235,2019-07-12,741,0,741,59,800,800,0,0
26236,2019-07-12,1047,0,1047,83,1130,1130,0,0
26237,2019-07-12,954,0,954,76,1030,1030,0,0
26238,2019-07-12,973,0,973,77,1050,1050,0,0
26239,2019-07-12,343,0,343,27,370,370,0,0
26240,2019-07-12,834,0,834,66,900,900,0,0
26241,2019-07-12,538,0,538,42,580,580,0,0
26242,2019-07-12,1112,0,1112,88,1200,1200,0,0
26243,2019-07-12,527,-112,415,33,448,448,0,0
26244,2019-07-12,1158,0,1158,92,1250,1250,0,0
26245,2019-07-12,797,0,797,63,860,860,0,0
26246,2019-07-12,612,0,612,48,660,660,0,0
26247,2019-07-12,871,0,871,69,940,940,0,0
26248,2019-07-12,788,0,788,62,850,0,850,0
26249,2019-07-12,788,0,788,62,850,850,0,0
26250,2019-07-12,501,0,501,39,540,540,0,0
26251,2019-07-12,788,0,788,62,850,850,0,0
26252,2019-07-12,862,0,862,68,930,930,0,0
26253,2019-07-12,788,0,788,62,850,850,0,0
26254,2019-07-12,1639,0,1639,131,1770,1770,0,0
26255,2019-07-12,556,0,556,44,600,600,0,0
26256,2019-07-12,788,0,788,62,850,850,0,0
26257,2019-07-12,732,0,732,58,790,790,0,0
26258,2019-07-12,417,0,417,33,450,0,450,0
26259,2019-07-12,1575,0,1575,125,1700,1700,0,0
26260,2019-07-12,1482,0,1482,118,1600,1600,0,0
26261,2019-07-12,1343,0,1343,107,1450,1450,0,0
26262,2019-07-12,1852,0,1852,148,2000,2000,0,0
26263,2019-07-12,1158,0,1158,92,1250,1250,0,0
26264,2019-07-12,954,0,954,76,1030,1030,0,0
26265,2019-07-12,2130,0,2130,170,2300,2300,0,0
26266,2019-07-12,2194,0,2194,166,2360,0,2360,0
26267,2019-07-12,1741,0,1741,139,1880,1880,0,0
26268,2019-07-12,2065,0,2065,165,2230,2230,0,0
26269,2019-07-13,760,0,760,60,820,820,0,0
26270,2019-07-13,1038,0,1038,82,1120,1120,0,0
26271,2019-07-13,1815,0,1815,145,1960,0,1960,0
26272,2019-07-13,1825,0,1825,145,1970,1970,0,0
26273,2019-07-13,2602,0,2602,208,2810,2810,0,0
26274,2019-07-13,1251,0,1251,99,1350,1350,0,0
26275,2019-07-13,1815,0,1815,145,1960,1960,0,0
26276,2019-07-13,704,0,704,56,760,760,0,0
26277,2019-07-13,1380,0,1380,110,1490,1490,0,0
26278,2019-07-13,352,0,352,28,380,380,0,0
26279,2019-07-13,1075,0,1075,85,1160,1160,0,0
26280,2019-07-13,399,0,399,31,430,430,0,0
26281,2019-07-13,1315,0,1315,105,1420,1420,0,0
26282,2019-07-13,389,0,389,31,420,420,0,0
26283,2019-07-13,704,0,704,56,760,760,0,0
26284,2019-07-13,851,0,851,59,910,910,0,0
26285,2019-07-13,760,0,760,60,820,820,0,0
26286,2019-07-13,112,0,112,8,120,120,0,0
26287,2019-07-13,908,0,908,72,980,980,0,0
26288,2019-07-13,278,0,278,22,300,300,0,0
26289,2019-07-13,732,0,732,58,790,790,0,0
26290,2019-07-13,223,0,223,17,240,240,0,0
26291,2019-07-13,751,0,751,59,810,810,0,0
26292,2019-07-13,1815,0,1815,145,1960,1960,0,0
26293,2019-07-13,491,0,491,39,530,530,0,0
26294,2019-07-13,167,0,167,13,180,180,0,0
26295,2019-07-13,482,0,482,38,520,520,0,0
26296,2019-07-13,2723,0,2723,217,2940,2940,0,0
26297,2019-07-13,834,0,834,66,900,900,0,0
26298,2019-07-13,1815,0,1815,145,1960,1960,0,0
26299,2019-07-13,1380,0,1380,110,1490,1490,0,0
26300,2019-07-13,3092,0,3092,238,3330,3330,0,0
26301,2019-07-13,611,0,611,39,650,650,0,0
26302,2019-07-13,682,-73,609,48,657,657,0,0
26303,2019-07-13,1121,0,1121,89,1210,1210,0,0
26304,2019-07-13,1408,0,1408,112,1520,1520,0,0
26305,2019-07-13,889,0,889,71,960,0,960,0
26306,2019-07-13,371,0,371,29,400,400,0,0
26307,2019-07-13,1109,-118,991,71,1062,1062,0,0
26308,2019-07-13,2788,0,2788,222,3010,3010,0,0
26309,2019-07-13,473,0,473,37,510,510,0,0
26310,2019-07-13,704,0,704,56,760,760,0,0
26311,2019-07-13,3825,0,3825,305,4130,4130,0,0
26312,2019-07-13,954,0,954,76,1030,1030,0,0
26313,2019-07-13,584,0,584,46,630,630,0,0
26314,2019-07-13,352,0,352,28,380,380,0,0
26315,2019-07-13,1815,0,1815,145,1960,0,1960,0
26316,2019-07-13,2038,0,2038,162,2200,2200,0,0
26317,2019-07-13,2740,0,2740,210,2950,2950,0,0
26318,2019-07-13,954,0,954,76,1030,1030,0,0
26319,2019-07-13,1815,0,1815,145,1960,1960,0,0
26320,2019-07-13,1815,0,1815,145,1960,1960,0,0
26321,2019-07-13,639,0,639,51,690,690,0,0
26322,2019-07-13,1018,-109,909,72,981,981,0,0
26323,2019-07-13,278,0,278,22,300,300,0,0
26324,2019-07-13,3176,0,3176,254,3430,3430,0,0
26325,2019-07-13,482,0,482,38,520,520,0,0
26326,2019-07-13,825,0,825,65,890,890,0,0
26327,2019-07-13,167,0,167,13,180,180,0,0
26328,2019-07-13,306,0,306,24,330,330,0,0
26329,2019-07-13,223,0,223,17,240,240,0,0
26330,2019-07-13,1501,0,1501,119,1620,1620,0,0
26331,2019-07-13,149,0,149,11,160,160,0,0
26332,2019-07-13,519,0,519,41,560,560,0,0
26333,2019-07-13,1343,0,1343,107,1450,1450,0,0
26334,2019-07-13,1423,0,1423,87,1510,1510,0,0
26335,2019-07-13,389,0,389,31,420,420,0,0
26336,2019-07-13,945,0,945,75,1020,1020,0,0
26337,2019-07-13,389,0,389,31,420,420,0,0
26338,2019-07-13,389,0,389,31,420,420,0,0
26339,2019-07-13,621,0,621,49,670,670,0,0
26340,2019-07-13,1001,0,1001,79,1080,1080,0,0
26341,2019-07-13,575,0,575,45,620,620,0,0
26342,2019-07-13,528,0,528,42,570,570,0,0
26343,2019-07-13,1815,0,1815,145,1960,1960,0,0
26344,2019-07-13,2213,0,2213,177,2390,2390,0,0
26345,2019-07-13,1195,0,1195,95,1290,1290,0,0
26346,2019-07-13,871,0,871,69,940,940,0,0
26347,2019-07-13,1815,0,1815,145,1960,0,1960,0
26348,2019-07-13,269,0,269,21,290,290,0,0
26349,2019-07-13,501,0,501,39,540,540,0,0
26350,2019-07-13,917,0,917,73,990,990,0,0
26351,2019-07-13,519,0,519,41,560,0,0,560
26352,2019-07-13,1288,0,1288,102,1390,1390,0,0
26353,2019-07-13,2741,0,2741,219,2960,2960,0,0
26354,2019-07-13,357,0,357,28,385,385,0,0
26355,2019-07-13,315,0,315,25,340,340,0,0
26356,2019-07-13,473,0,473,37,510,510,0,0
26357,2019-07-13,454,0,454,36,490,490,0,0
26358,2019-07-13,223,0,223,17,240,240,0,0
26359,2019-07-13,371,0,371,29,400,400,0,0
26360,2019-07-13,116,0,116,9,125,125,0,0
26361,2019-07-13,250,0,250,20,270,270,0,0
26362,2019-07-13,3630,0,3630,290,3920,0,3920,0
26363,2019-07-13,1380,0,1380,110,1490,1490,0,0
26364,2019-07-13,713,0,713,57,770,770,0,0
26365,2019-07-13,306,0,306,24,330,330,0,0
26366,2019-07-13,334,0,334,26,360,360,0,0
26367,2019-07-13,288,0,288,22,310,310,0,0
26368,2019-07-13,1010,0,1010,80,1090,1090,0,0
26369,2019-07-13,769,0,769,61,830,830,0,0
26370,2019-07-13,514,-55,459,36,495,495,0,0
26371,2019-07-13,232,0,232,18,250,250,0,0
26372,2019-07-13,732,0,732,58,790,790,0,0
26373,2019-07-13,389,0,389,31,420,420,0,0
26374,2019-07-13,112,0,112,8,120,120,0,0
26375,2019-07-13,232,0,232,18,250,250,0,0
26376,2019-07-13,509,0,509,31,540,540,0,0
26377,2019-07-13,899,0,899,71,970,970,0,0
26378,2019-07-13,1334,0,1334,106,1440,1440,0,0
26379,2019-07-13,260,0,260,20,280,280,0,0
26380,2019-07-13,1362,0,1362,108,1470,1470,0,0
26381,2019-07-13,139,0,139,11,150,150,0,0
26382,2019-07-13,398,0,398,22,420,420,0,0
26383,2019-07-13,260,0,260,20,280,280,0,0
26384,2019-07-13,1825,0,1825,145,1970,0,1970,0
26385,2019-07-13,260,0,260,20,280,280,0,0
26386,2019-07-13,260,0,260,20,280,280,0,0
26387,2019-07-13,352,0,352,28,380,0,0,380
26388,2019-07-13,306,0,306,24,330,330,0,0
26389,2019-07-13,110,0,110,0,110,110,0,0
26390,2019-07-13,130,0,130,10,140,140,0,0
26391,2019-07-13,346,-37,309,24,333,333,0,0
26392,2019-07-13,760,0,760,60,820,820,0,0
26393,2019-07-13,362,0,362,28,390,390,0,0
26394,2019-07-13,788,0,788,62,850,850,0,0
26395,2019-07-13,297,0,297,23,320,320,0,0
26396,2019-07-13,751,0,751,59,810,810,0,0
26397,2019-07-13,491,0,491,39,530,530,0,0
26398,2019-07-13,243,-26,217,17,234,234,0,0
26399,2019-07-13,2047,0,2047,163,2210,2210,0,0
26400,2019-07-13,1991,0,1991,159,2150,2150,0,0
26401,2019-07-13,612,0,612,48,660,660,0,0
26402,2019-07-13,260,0,260,20,280,280,0,0
26403,2019-07-13,334,0,334,26,360,360,0,0
26404,2019-07-13,1723,0,1723,137,1860,1860,0,0
26405,2019-07-13,1973,0,1973,157,2130,2130,0,0
26406,2019-07-13,926,0,926,74,1000,1000,0,0
26407,2019-07-13,445,0,445,35,480,480,0,0
26408,2019-07-13,278,0,278,22,300,300,0,0
26409,2019-07-13,518,0,518,32,550,550,0,0
26410,2019-07-13,195,0,195,15,210,210,0,0
26411,2019-07-13,556,0,556,44,600,600,0,0
26412,2019-07-13,278,0,278,22,300,0,0,300
26413,2019-07-13,491,0,491,39,530,530,0,0
26414,2019-07-13,370,0,370,20,390,390,0,0
26415,2019-07-13,815,0,815,65,880,880,0,0
26416,2019-07-13,2176,0,2176,174,2350,0,2350,0
26417,2019-07-13,1954,0,1954,156,2110,2110,0,0
26418,2019-07-13,1278,0,1278,102,1380,1380,0,0
26419,2019-07-13,797,0,797,63,860,860,0,0
26420,2019-07-13,1028,0,1028,82,1110,1110,0,0
26421,2019-07-13,1501,0,1501,119,1620,1620,0,0
26422,2019-07-13,408,0,408,32,440,440,0,0
26423,2019-07-13,584,0,584,46,630,630,0,0
26424,2019-07-13,584,0,584,46,630,630,0,0
26425,2019-07-13,445,0,445,35,480,480,0,0
26426,2019-07-13,880,0,880,70,950,950,0,0
26427,2019-07-13,667,0,667,53,720,720,0,0
26428,2019-07-13,1593,0,1593,127,1720,1720,0,0
26429,2019-07-13,1028,0,1028,82,1110,1110,0,0
26430,2019-07-13,343,0,343,27,370,370,0,0
26431,2019-07-13,278,0,278,22,300,300,0,0
26432,2019-07-13,2362,0,2362,188,2550,2550,0,0
26433,2019-07-13,2362,0,2362,188,2550,2550,0,0
26434,2019-07-13,1575,0,1575,125,1700,1700,0,0
26435,2019-07-13,306,0,306,24,330,330,0,0
26436,2019-07-13,1334,0,1334,106,1440,1440,0,0
26437,2019-07-13,672,-72,600,48,648,648,0,0
26438,2019-07-13,260,0,260,20,280,280,0,0
26439,2019-07-13,1889,0,1889,151,2040,0,2040,0
26440,2019-07-13,519,0,519,41,560,560,0,0
26441,2019-07-13,676,0,676,54,730,730,0,0
26442,2019-07-13,723,0,723,57,780,780,0,0
26443,2019-07-13,1593,0,1593,127,1720,1720,0,0
26444,2019-07-13,1825,0,1825,145,1970,1970,0,0
26445,2019-07-13,334,0,334,26,360,360,0,0
26446,2019-07-13,278,0,278,22,300,300,0,0
26447,2019-07-13,473,0,473,37,510,510,0,0
26448,2019-07-13,1852,0,1852,148,2000,2000,0,0
26449,2019-07-13,-2362,0,-2362,-188,-2550,-2550,0,0
26450,2019-07-13,1587,-170,1417,113,1530,1530,0,0
26451,2019-07-13,3149,0,3149,251,3400,3400,0,0
26452,2019-07-13,741,0,741,59,800,800,0,0
26453,2019-07-13,388,0,388,22,410,410,0,0
26454,2019-07-13,1575,0,1575,125,1700,1700,0,0
26455,2019-07-13,788,0,788,62,850,850,0,0
26456,2019-07-13,1575,0,1575,125,1700,1700,0,0
26457,2019-07-13,788,0,788,62,850,850,0,0
26458,2019-07-13,788,0,788,62,850,850,0,0
26459,2019-07-13,788,0,788,62,850,850,0,0
26460,2019-07-13,788,0,788,62,850,850,0,0
26461,2019-07-13,362,0,362,28,390,390,0,0
26462,2019-07-13,1482,0,1482,118,1600,0,0,1600
26463,2019-07-13,788,0,788,62,850,850,0,0
26464,2019-07-13,501,0,501,39,540,540,0,0
26465,2019-07-13,1232,0,1232,98,1330,1330,0,0
26466,2019-07-13,1575,0,1575,125,1700,1700,0,0
26467,2019-07-13,1575,0,1575,125,1700,1700,0,0
26468,2019-07-13,954,0,954,76,1030,1030,0,0
26469,2019-07-13,788,0,788,62,850,850,0,0
26470,2019-07-13,1575,0,1575,125,1700,1700,0,0
26471,2019-07-13,3130,0,3130,250,3380,3380,0,0
26472,2019-07-13,638,0,638,42,680,680,0,0
26473,2019-07-13,299,-32,267,21,288,288,0,0
26474,2019-07-13,713,0,713,57,770,770,0,0
26475,2019-07-14,1463,0,1463,117,1580,1580,0,0
26476,2019-07-14,658,0,658,52,710,710,0,0
26477,2019-07-14,908,0,908,72,980,980,0,0
26478,2019-07-14,806,0,806,64,870,0,870,0
26479,2019-07-14,908,0,908,72,980,980,0,0
26480,2019-07-14,352,0,352,28,380,380,0,0
26481,2019-07-14,1815,0,1815,145,1960,1960,0,0
26482,2019-07-14,473,0,473,37,510,510,0,0
26483,2019-07-14,2880,0,2880,230,3110,3110,0,0
26484,2019-07-14,288,0,288,22,310,310,0,0
26485,2019-07-14,260,0,260,20,280,280,0,0
26486,2019-07-14,352,0,352,28,380,380,0,0
26487,2019-07-14,1815,0,1815,145,1960,1960,0,0
26488,2019-07-14,399,0,399,31,430,430,0,0
26489,2019-07-14,973,0,973,77,1050,1050,0,0
26490,2019-07-14,436,0,436,34,470,470,0,0
26491,2019-07-14,1593,0,1593,127,1720,1720,0,0
26492,2019-07-14,2092,0,2092,158,2250,2250,0,0
26493,2019-07-14,519,0,519,41,560,560,0,0
26494,2019-07-14,408,0,408,32,440,440,0,0
26495,2019-07-14,1269,0,1269,101,1370,1370,0,0
26496,2019-07-14,1408,0,1408,112,1520,1520,0,0
26497,2019-07-14,1315,0,1315,105,1420,1420,0,0
26498,2019-07-14,593,0,593,47,640,640,0,0
26499,2019-07-14,1351,0,1351,99,1450,1450,0,0
26500,2019-07-14,621,0,621,49,670,670,0,0
26501,2019-07-14,408,0,408,32,440,440,0,0
26502,2019-07-14,1426,0,1426,114,1540,1540,0,0
26503,2019-07-14,667,0,667,53,720,720,0,0
26504,2019-07-14,102,0,102,8,110,110,0,0
26505,2019-07-14,204,0,204,16,220,220,0,0
26506,2019-07-14,704,0,704,56,760,760,0,0
26507,2019-07-14,963,0,963,77,1040,1040,0,0
26508,2019-07-14,510,0,510,40,550,550,0,0
26509,2019-07-14,1538,0,1538,122,1660,1660,0,0
26510,2019-07-14,1249,0,1249,91,1340,1340,0,0
26511,2019-07-14,232,0,232,18,250,250,0,0
26512,2019-07-14,1926,0,1926,154,2080,2080,0,0
26513,2019-07-14,1149,0,1149,91,1240,1240,0,0
26514,2019-07-14,417,0,417,33,450,450,0,0
26515,2019-07-14,371,0,371,29,400,400,0,0
26516,2019-07-14,575,0,575,45,620,620,0,0
26517,2019-07-14,3204,0,3204,256,3460,3460,0,0
26518,2019-07-14,575,0,575,45,620,620,0,0
26519,2019-07-14,325,0,325,25,350,350,0,0
26520,2019-07-14,212,0,212,8,220,220,0,0
26521,2019-07-14,1167,0,1167,93,1260,1260,0,0
26522,2019-07-14,907,0,907,63,970,970,0,0
26523,2019-07-14,362,0,362,28,390,390,0,0
26524,2019-07-14,908,0,908,72,980,980,0,0
26525,2019-07-14,1686,0,1686,134,1820,1820,0,0
26526,2019-07-14,250,0,250,20,270,270,0,0
26527,2019-07-14,695,0,695,55,750,750,0,0
26528,2019-07-14,1371,0,1371,109,1480,1480,0,0
26529,2019-07-14,453,0,453,27,480,480,0,0
26530,2019-07-14,1815,0,1815,145,1960,1960,0,0
26531,2019-07-14,1278,0,1278,102,1380,1380,0,0
26532,2019-07-14,908,0,908,72,980,980,0,0
26533,2019-07-14,389,0,389,31,420,420,0,0
26534,2019-07-14,565,0,565,45,610,610,0,0
26535,2019-07-14,1408,0,1408,112,1520,1520,0,0
26536,2019-07-14,833,0,833,57,890,890,0,0
26537,2019-07-14,815,0,815,65,880,880,0,0
26538,2019-07-14,3630,0,3630,290,3920,3920,0,0
26539,2019-07-14,1815,0,1815,145,1960,0,1960,0
26540,2019-07-14,1815,0,1815,145,1960,1960,0,0
26541,2019-07-14,908,0,908,72,980,980,0,0
26542,2019-07-14,1769,0,1769,141,1910,1910,0,0
26543,2019-07-14,667,0,667,53,720,720,0,0
26544,2019-07-14,167,0,167,13,180,180,0,0
26545,2019-07-14,260,0,260,20,280,280,0,0
26546,2019-07-14,602,0,602,48,650,650,0,0
26547,2019-07-14,766,-82,684,54,738,738,0,0
26548,2019-07-14,1815,0,1815,145,1960,1960,0,0
26549,2019-07-14,565,0,565,45,610,610,0,0
26550,2019-07-14,834,0,834,66,900,900,0,0
26551,2019-07-14,862,0,862,68,930,930,0,0
26552,2019-07-14,260,0,260,20,280,280,0,0
26553,2019-07-14,306,0,306,24,330,330,0,0
26554,2019-07-14,547,0,547,43,590,590,0,0
26555,2019-07-14,649,0,649,51,700,700,0,0
26556,2019-07-14,638,0,638,42,680,680,0,0
26557,2019-07-14,399,0,399,31,430,430,0,0
26558,2019-07-14,167,0,167,13,180,180,0,0
26559,2019-07-14,167,0,167,13,180,180,0,0
26560,2019-07-14,741,0,741,59,800,800,0,0
26561,2019-07-14,1277,0,1277,93,1370,1370,0,0
26562,2019-07-14,834,0,834,66,900,900,0,0
26563,2019-07-14,1815,0,1815,145,1960,1960,0,0
26564,2019-07-14,1815,0,1815,145,1960,0,1960,0
26565,2019-07-14,260,0,260,20,280,280,0,0
26566,2019-07-14,278,0,278,22,300,300,0,0
26567,2019-07-14,286,0,286,14,300,300,0,0
26568,2019-07-14,241,0,241,19,260,260,0,0
26569,2019-07-14,1186,0,1186,94,1280,1280,0,0
26570,2019-07-14,463,0,463,37,500,500,0,0
26571,2019-07-14,1001,0,1001,79,1080,1080,0,0
26572,2019-07-14,371,0,371,29,400,400,0,0
26573,2019-07-14,769,0,769,61,830,830,0,0
26574,2019-07-14,1362,0,1362,108,1470,1470,0,0
26575,2019-07-14,445,0,445,35,480,480,0,0
26576,2019-07-14,463,0,463,37,500,500,0,0
26577,2019-07-14,220,0,220,0,220,220,0,0
26578,2019-07-14,1286,0,1286,94,1380,1380,0,0
26579,2019-07-14,926,0,926,74,1000,1000,0,0
26580,2019-07-14,880,0,880,70,950,950,0,0
26581,2019-07-14,658,0,658,52,710,710,0,0
26582,2019-07-14,769,0,769,61,830,830,0,0
26583,2019-07-14,805,0,805,55,860,860,0,0
26584,2019-07-14,945,0,945,75,1020,1020,0,0
26585,2019-07-14,315,0,315,25,340,340,0,0
26586,2019-07-14,1575,0,1575,125,1700,1700,0,0
26587,2019-07-14,389,0,389,31,420,420,0,0
26588,2019-07-14,260,0,260,20,280,280,0,0
26589,2019-07-14,389,0,389,31,420,420,0,0
26590,2019-07-14,426,0,426,34,460,460,0,0
26591,2019-07-14,371,0,371,29,400,400,0,0
26592,2019-07-14,954,0,954,76,1030,1030,0,0
26593,2019-07-14,389,0,389,31,420,420,0,0
26594,2019-07-14,399,0,399,31,430,430,0,0
26595,2019-07-14,269,0,269,21,290,290,0,0
26596,2019-07-14,297,0,297,23,320,320,0,0
26597,2019-07-14,306,0,306,24,330,330,0,0
26598,2019-07-14,538,0,538,42,580,580,0,0
26599,2019-07-14,234,-25,209,16,225,225,0,0
26600,2019-07-14,232,0,232,18,250,250,0,0
26601,2019-07-14,1695,0,1695,135,1830,1830,0,0
26602,2019-07-14,686,0,686,54,740,740,0,0
26603,2019-07-14,981,0,981,69,1050,1050,0,0
26604,2019-07-14,1186,0,1186,94,1280,1280,0,0
26605,2019-07-14,704,0,704,56,760,760,0,0
26606,2019-07-14,945,0,945,75,1020,1020,0,0
26607,2019-07-14,843,0,843,67,910,910,0,0
26608,2019-07-14,208,0,208,16,224,224,0,0
26609,2019-07-14,334,0,334,26,360,360,0,0
26610,2019-07-14,116,0,116,9,125,125,0,0
26611,2019-07-14,399,0,399,31,430,430,0,0
26612,2019-07-14,195,0,195,15,210,210,0,0
26613,2019-07-14,389,0,389,31,420,420,0,0
26614,2019-07-14,760,0,760,60,820,820,0,0
26615,2019-07-14,2352,0,2352,188,2540,2540,0,0
26616,2019-07-14,1195,0,1195,95,1290,1290,0,0
26617,2019-07-14,2454,0,2454,196,2650,2650,0,0
26618,2019-07-14,389,0,389,31,420,420,0,0
26619,2019-07-14,629,0,629,41,670,670,0,0
26620,2019-07-14,2195,0,2195,175,2370,0,2370,0
26621,2019-07-14,556,0,556,44,600,600,0,0
26622,2019-07-14,362,0,362,28,390,390,0,0
26623,2019-07-14,260,0,260,20,280,280,0,0
26624,2019-07-14,501,0,501,39,540,540,0,0
26625,2019-07-14,1638,0,1638,122,1760,1760,0,0
26626,2019-07-14,538,0,538,42,580,580,0,0
26627,2019-07-14,788,0,788,62,850,850,0,0
26628,2019-07-14,2084,0,2084,166,2250,2250,0,0
26629,2019-07-14,2657,0,2657,213,2870,2870,0,0
26630,2019-07-14,1463,0,1463,117,1580,1580,0,0
26631,2019-07-14,980,0,980,60,1040,1040,0,0
26632,2019-07-14,583,0,583,37,620,620,0,0
26633,2019-07-14,392,-42,350,28,378,378,0,0
26634,2019-07-14,602,0,602,48,650,0,650,0
26635,2019-07-14,510,0,510,40,550,550,0,0
26636,2019-07-14,1010,0,1010,80,1090,1090,0,0
26637,2019-07-14,491,0,491,39,530,0,530,0
26638,2019-07-14,343,0,343,27,370,370,0,0
26639,2019-07-14,260,0,260,20,280,280,0,0
26640,2019-07-14,167,0,167,13,180,180,0,0
26641,2019-07-14,2315,0,2315,185,2500,0,2500,0
26642,2019-07-14,195,0,195,15,210,210,0,0
26643,2019-07-14,1575,0,1575,125,1700,1700,0,0
26644,2019-07-14,388,0,388,22,410,410,0,0
26645,2019-07-14,1575,0,1575,125,1700,1700,0,0
26646,2019-07-14,788,0,788,62,850,850,0,0
26647,2019-07-14,528,0,528,42,570,570,0,0
26648,2019-07-14,334,0,334,26,360,360,0,0
26649,2019-07-14,1575,0,1575,125,1700,1700,0,0
26650,2019-07-14,2130,0,2130,170,2300,2300,0,0
26651,2019-07-14,834,0,834,66,900,900,0,0
26652,2019-07-14,1575,0,1575,125,1700,1700,0,0
26653,2019-07-14,1575,0,1575,125,1700,1700,0,0
26654,2019-07-14,334,0,334,26,360,360,0,0
26655,2019-07-14,1575,0,1575,125,1700,1700,0,0
26656,2019-07-14,473,0,473,37,510,510,0,0
26657,2019-07-14,1575,0,1575,125,1700,1700,0,0
26658,2019-07-14,732,0,732,58,790,790,0,0
26659,2019-07-14,1167,0,1167,93,1260,1260,0,0
26660,2019-07-14,1575,0,1575,125,1700,1700,0,0
26661,2019-07-14,1575,0,1575,125,1700,1700,0,0
26662,2019-07-14,658,0,658,52,710,710,0,0
26663,2019-07-14,1028,0,1028,82,1110,1110,0,0
26664,2019-07-14,1436,0,1436,114,1550,1550,0,0
26665,2019-07-14,223,0,223,17,240,240,0,0
26666,2019-07-14,269,0,269,21,290,290,0,0
26667,2019-07-14,1556,0,1556,124,1680,1680,0,0
26668,2019-07-14,426,0,426,34,460,460,0,0
26669,2019-07-14,482,0,482,38,520,520,0,0
26670,2019-07-14,1575,0,1575,125,1700,1700,0,0
26671,2019-07-14,463,0,463,37,500,500,0,0
26672,2019-07-14,501,0,501,39,540,540,0,0
26673,2019-07-14,667,0,667,53,720,720,0,0
26674,2019-07-14,778,0,778,62,840,0,840,0
26675,2019-07-14,501,0,501,39,540,540,0,0
26676,2019-07-14,269,0,269,21,290,290,0,0
26677,2019-07-14,362,0,362,28,390,390,0,0
26678,2019-07-14,352,0,352,28,380,380,0,0
26679,2019-07-14,862,0,862,68,930,930,0,0
26680,2019-07-14,426,0,426,34,460,460,0,0
26681,2019-07-14,501,0,501,39,540,540,0,0
26682,2019-07-14,1575,0,1575,125,1700,1700,0,0
26683,2019-07-14,269,0,269,21,290,290,0,0
26684,2019-07-14,1575,0,1575,125,1700,0,1700,0
26685,2019-07-14,389,0,389,31,420,420,0,0
26686,2019-07-14,788,0,788,62,850,850,0,0
26687,2019-07-14,1575,0,1575,125,1700,1700,0,0
26688,2019-07-14,1575,0,1575,125,1700,1700,0,0
26689,2019-07-14,3139,0,3139,251,3390,3390,0,0
26690,2019-07-14,3149,0,3149,251,3400,3400,0,0
26691,2019-07-14,593,0,593,47,640,640,0,0
26692,2019-07-14,2760,0,2760,220,2980,2980,0,0
26693,2019-07-14,788,0,788,62,850,850,0,0
26694,2019-07-14,788,0,788,62,850,850,0,0
26695,2019-07-14,3936,0,3936,314,4250,0,4250,0
26696,2019-07-15,528,0,528,42,570,570,0,0
26697,2019-07-15,491,0,491,39,530,530,0,0
26698,2019-07-15,445,0,445,35,480,480,0,0
26699,2019-07-15,1130,0,1130,90,1220,1220,0,0
26700,2019-07-15,1028,0,1028,82,1110,1110,0,0
26701,2019-07-15,766,-82,684,54,738,738,0,0
26702,2019-07-15,362,0,362,28,390,390,0,0
26703,2019-07-15,278,0,278,22,300,300,0,0
26704,2019-07-15,649,0,649,51,700,700,0,0
26705,2019-07-15,556,0,556,44,600,600,0,0
26706,2019-07-15,547,0,547,43,590,0,590,0
26707,2019-07-15,908,0,908,72,980,980,0,0
26708,2019-07-15,473,0,473,37,510,510,0,0
26709,2019-07-15,232,0,232,18,250,250,0,0
26710,2019-07-15,908,0,908,72,980,980,0,0
26711,2019-07-15,380,0,380,30,410,410,0,0
26712,2019-07-15,908,0,908,72,980,980,0,0
26713,2019-07-15,1019,0,1019,81,1100,1100,0,0
26714,2019-07-15,667,0,667,53,720,720,0,0
26715,2019-07-15,2889,0,2889,231,3120,3120,0,0
26716,2019-07-15,908,0,908,72,980,980,0,0
26717,2019-07-15,982,0,982,78,1060,1060,0,0
26718,2019-07-15,1019,0,1019,81,1100,1100,0,0
26719,2019-07-15,908,0,908,72,980,980,0,0
26720,2019-07-15,788,0,788,62,850,850,0,0
26721,2019-07-15,982,0,982,78,1060,0,1060,0
26722,2019-07-15,621,0,621,49,670,670,0,0
26723,2019-07-15,990,0,990,70,1060,1060,0,0
26724,2019-07-15,871,0,871,69,940,940,0,0
26725,2019-07-15,667,0,667,53,720,720,0,0
26726,2019-07-15,908,0,908,72,980,980,0,0
26727,2019-07-15,908,0,908,72,980,980,0,0
26728,2019-07-15,500,0,500,40,540,540,0,0
26729,2019-07-15,1130,0,1130,90,1220,1220,0,0
26730,2019-07-15,436,0,436,34,470,470,0,0
26731,2019-07-15,426,0,426,34,460,460,0,0
26732,2019-07-15,306,0,306,24,330,330,0,0
26733,2019-07-15,908,0,908,72,980,980,0,0
26734,2019-07-15,380,0,380,30,410,410,0,0
26735,2019-07-15,379,0,379,21,400,400,0,0
26736,2019-07-15,732,0,732,58,790,790,0,0
26737,2019-07-15,778,0,778,62,840,840,0,0
26738,2019-07-15,778,0,778,62,840,0,840,0
26739,2019-07-15,473,0,473,37,510,510,0,0
26740,2019-07-15,1454,0,1454,116,1570,1570,0,0
26741,2019-07-15,954,0,954,76,1030,0,0,1030
26742,2019-07-15,1260,0,1260,100,1360,1360,0,0
26743,2019-07-15,1815,0,1815,145,1960,1960,0,0
26744,2019-07-15,1519,0,1519,121,1640,1640,0,0
26745,2019-07-15,862,0,862,68,930,930,0,0
26746,2019-07-15,797,0,797,63,860,860,0,0
26747,2019-07-15,241,0,241,19,260,260,0,0
26748,2019-07-15,510,0,510,40,550,550,0,0
26749,2019-07-15,334,0,334,26,360,360,0,0
26750,2019-07-15,121,0,121,9,130,130,0,0
26751,2019-07-15,639,0,639,51,690,690,0,0
26752,2019-07-15,908,0,908,72,980,980,0,0
26753,2019-07-15,908,0,908,72,980,980,0,0
26754,2019-07-15,501,0,501,39,540,540,0,0
26755,2019-07-15,778,0,778,62,840,840,0,0
26756,2019-07-15,1102,0,1102,88,1190,1190,0,0
26757,2019-07-15,723,0,723,57,780,780,0,0
26758,2019-07-15,899,0,899,71,970,970,0,0
26759,2019-07-15,1445,0,1445,115,1560,1560,0,0
26760,2019-07-15,1019,0,1019,81,1100,1100,0,0
26761,2019-07-15,1999,0,1999,151,2150,0,2150,0
26762,2019-07-15,121,0,121,9,130,130,0,0
26763,2019-07-15,408,0,408,32,440,440,0,0
26764,2019-07-15,5445,0,5445,435,5880,5880,0,0
26765,2019-07-15,1565,0,1565,125,1690,1690,0,0
26766,2019-07-15,973,0,973,77,1050,1050,0,0
26767,2019-07-15,547,0,547,43,590,590,0,0
26768,2019-07-15,454,0,454,36,490,490,0,0
26769,2019-07-15,657,0,657,43,700,700,0,0
26770,2019-07-15,491,0,491,39,530,530,0,0
26771,2019-07-15,954,0,954,76,1030,1030,0,0
26772,2019-07-15,2629,0,2629,201,2830,2830,0,0
26773,2019-07-15,999,0,999,71,1070,1070,0,0
26774,2019-07-15,1019,0,1019,81,1100,1100,0,0
26775,2019-07-15,167,0,167,13,180,180,0,0
26776,2019-07-15,334,0,334,26,360,360,0,0
26777,2019-07-15,167,0,167,13,180,180,0,0
26778,2019-07-15,658,0,658,52,710,710,0,0
26779,2019-07-15,565,0,565,45,610,610,0,0
26780,2019-07-15,769,0,769,61,830,830,0,0
26781,2019-07-15,1176,0,1176,94,1270,1270,0,0
26782,2019-07-15,778,0,778,62,840,840,0,0
26783,2019-07-15,2028,0,2028,162,2190,2190,0,0
26784,2019-07-15,963,0,963,77,1040,1040,0,0
26785,2019-07-15,1815,0,1815,145,1960,1960,0,0
26786,2019-07-15,2047,0,2047,163,2210,2210,0,0
26787,2019-07-15,333,0,333,17,350,350,0,0
26788,2019-07-15,954,0,954,76,1030,1030,0,0
26789,2019-07-15,564,0,564,36,600,600,0,0
26790,2019-07-15,538,0,538,42,580,580,0,0
26791,2019-07-15,399,0,399,31,430,430,0,0
26792,2019-07-15,778,0,778,62,840,840,0,0
26793,2019-07-15,732,0,732,58,790,790,0,0
26794,2019-07-15,149,0,149,11,160,160,0,0
26795,2019-07-15,1204,0,1204,96,1300,1300,0,0
26796,2019-07-15,778,0,778,62,840,840,0,0
26797,2019-07-15,1093,0,1093,87,1180,1180,0,0
26798,2019-07-15,454,0,454,36,490,0,490,0
26799,2019-07-15,426,0,426,34,460,460,0,0
26800,2019-07-15,1573,0,1573,117,1690,1690,0,0
26801,2019-07-15,371,0,371,29,400,400,0,0
26802,2019-07-15,1315,0,1315,105,1420,0,1420,0
26803,2019-07-15,1112,0,1112,88,1200,1200,0,0
26804,2019-07-15,436,0,436,34,470,470,0,0
26805,2019-07-15,139,0,139,11,150,150,0,0
26806,2019-07-15,491,0,491,39,530,530,0,0
26807,2019-07-15,426,0,426,34,460,460,0,0
26808,2019-07-15,1454,0,1454,116,1570,1570,0,0
26809,2019-07-15,973,0,973,77,1050,1050,0,0
26810,2019-07-15,723,0,723,57,780,780,0,0
26811,2019-07-15,1297,0,1297,103,1400,1400,0,0
26812,2019-07-15,788,0,788,62,850,850,0,0
26813,2019-07-15,426,0,426,34,460,460,0,0
26814,2019-07-15,584,0,584,46,630,630,0,0
26815,2019-07-15,445,0,445,35,480,480,0,0
26816,2019-07-15,1075,0,1075,85,1160,0,1160,0
26817,2019-07-15,852,0,852,68,920,920,0,0
26818,2019-07-15,130,0,130,10,140,140,0,0
26819,2019-07-15,639,0,639,51,690,690,0,0
26820,2019-07-15,389,0,389,31,420,420,0,0
26821,2019-07-15,686,0,686,54,740,740,0,0
26822,2019-07-15,362,0,362,28,390,390,0,0
26823,2019-07-15,1686,0,1686,134,1820,1820,0,0
26824,2019-07-15,1213,0,1213,97,1310,1310,0,0
26825,2019-07-15,806,0,806,64,870,870,0,0
26826,2019-07-15,630,0,630,50,680,680,0,0
26827,2019-07-15,334,0,334,26,360,360,0,0
26828,2019-07-15,260,0,260,20,280,280,0,0
26829,2019-07-15,764,-81,683,46,729,729,0,0
26830,2019-07-15,399,0,399,31,430,430,0,0
26831,2019-07-15,760,0,760,60,820,820,0,0
26832,2019-07-15,389,0,389,31,420,420,0,0
26833,2019-07-15,547,0,547,43,590,590,0,0
26834,2019-07-15,343,0,343,27,370,370,0,0
26835,2019-07-16,315,0,315,25,340,340,0,0
26836,2019-07-16,436,0,436,34,470,470,0,0
26837,2019-07-16,538,0,538,42,580,580,0,0
26838,2019-07-16,176,0,176,14,190,190,0,0
26839,2019-07-16,288,0,288,22,310,310,0,0
26840,2019-07-16,399,0,399,31,430,430,0,0
26841,2019-07-16,1204,0,1204,96,1300,1300,0,0
26842,2019-07-16,241,0,241,19,260,260,0,0
26843,2019-07-16,778,0,778,62,840,840,0,0
26844,2019-07-16,806,0,806,64,870,870,0,0
26845,2019-07-16,880,0,880,70,950,950,0,0
26846,2019-07-16,362,0,362,28,390,390,0,0
26847,2019-07-16,417,0,417,33,450,450,0,0
26848,2019-07-16,463,0,463,37,500,500,0,0
26849,2019-07-16,139,0,139,11,150,150,0,0
26850,2019-07-16,334,0,334,26,360,360,0,0
26851,2019-07-16,482,0,482,38,520,520,0,0
26852,2019-07-16,1751,0,1751,139,1890,1890,0,0
26853,2019-07-16,389,0,389,31,420,420,0,0
26854,2019-07-16,889,0,889,71,960,960,0,0
26855,2019-07-16,399,0,399,31,430,430,0,0
26856,2019-07-16,565,0,565,45,610,610,0,0
26857,2019-07-16,528,0,528,42,570,570,0,0
26858,2019-07-16,408,0,408,32,440,440,0,0
26859,2019-07-16,880,0,880,70,950,950,0,0
26860,2019-07-16,945,0,945,75,1020,1020,0,0
26861,2019-07-16,379,0,379,21,400,400,0,0
26862,2019-07-16,630,0,630,50,680,680,0,0
26863,2019-07-17,472,0,472,28,500,500,0,0
26864,2019-07-17,667,0,667,53,720,720,0,0
26865,2019-07-17,908,0,908,72,980,980,0,0
26866,2019-07-17,908,0,908,72,980,980,0,0
26867,2019-07-17,157,0,157,3,160,0,0,160
26868,2019-07-17,686,0,686,54,740,740,0,0
26869,2019-07-17,121,0,121,9,130,130,0,0
26870,2019-07-17,908,0,908,72,980,980,0,0
26871,2019-07-17,794,-85,709,56,765,765,0,0
26872,2019-07-17,908,0,908,72,980,980,0,0
26873,2019-07-17,723,0,723,57,780,780,0,0
26874,2019-07-17,490,0,490,30,520,520,0,0
26875,2019-07-17,501,0,501,39,540,540,0,0
26876,2019-07-17,269,0,269,21,290,290,0,0
26877,2019-07-17,510,0,510,40,550,550,0,0
26878,2019-07-17,518,0,518,32,550,550,0,0
26879,2019-07-17,686,0,686,54,740,740,0,0
26880,2019-07-17,1084,0,1084,86,1170,1170,0,0
26881,2019-07-17,584,0,584,46,630,630,0,0
26882,2019-07-17,436,0,436,34,470,470,0,0
26883,2019-07-17,686,0,686,54,740,740,0,0
26884,2019-07-17,973,0,973,77,1050,1050,0,0
26885,2019-07-17,908,0,908,72,980,980,0,0
26886,2019-07-17,277,0,277,13,290,290,0,0
26887,2019-07-17,1593,0,1593,127,1720,1720,0,0
26888,2019-07-17,473,0,473,37,510,510,0,0
26889,2019-07-17,343,0,343,27,370,0,370,0
26890,2019-07-17,1501,0,1501,119,1620,1620,0,0
26891,2019-07-17,786,0,786,54,840,0,840,0
26892,2019-07-17,306,0,306,24,330,330,0,0
26893,2019-07-17,167,0,167,13,180,180,0,0
26894,2019-07-17,167,0,167,13,180,180,0,0
26895,2019-07-17,1769,0,1769,141,1910,1910,0,0
26896,2019-07-17,1575,0,1575,125,1700,1700,0,0
26897,2019-07-17,2362,0,2362,188,2550,0,0,2550
26898,2019-07-17,306,0,306,24,330,330,0,0
26899,2019-07-17,1482,0,1482,118,1600,1600,0,0
26900,2019-07-17,306,0,306,24,330,330,0,0
26901,2019-07-17,889,0,889,71,960,960,0,0
26902,2019-07-17,538,0,538,42,580,580,0,0
26903,2019-07-17,565,0,565,45,610,610,0,0
26904,2019-07-17,963,0,963,77,1040,1040,0,0
26905,2019-07-17,741,0,741,59,800,800,0,0
26906,2019-07-17,241,0,241,19,260,260,0,0
26907,2019-07-17,880,0,880,70,950,950,0,0
26908,2019-07-17,510,0,510,40,550,550,0,0
26909,2019-07-17,260,0,260,20,280,280,0,0
26910,2019-07-17,760,0,760,60,820,820,0,0
26911,2019-07-17,1815,0,1815,145,1960,1960,0,0
26912,2019-07-17,121,0,121,9,130,130,0,0
26913,2019-07-17,575,0,575,45,620,620,0,0
26914,2019-07-17,908,0,908,72,980,980,0,0
26915,2019-07-17,621,0,621,49,670,670,0,0
26916,2019-07-17,788,0,788,62,850,0,0,850
26917,2019-07-17,908,0,908,72,980,980,0,0
26918,2019-07-17,908,0,908,72,980,980,0,0
26919,2019-07-17,962,0,962,68,1030,1030,0,0
26920,2019-07-17,825,0,825,65,890,890,0,0
26921,2019-07-17,389,0,389,31,420,420,0,0
26922,2019-07-18,732,0,732,58,790,790,0,0
26923,2019-07-18,593,0,593,47,640,640,0,0
26924,2019-07-18,260,0,260,20,280,280,0,0
26925,2019-07-18,1093,0,1093,87,1180,1180,0,0
26926,2019-07-18,769,0,769,61,830,830,0,0
26927,2019-07-18,1334,0,1334,106,1440,1440,0,0
26928,2019-07-18,523,-56,467,37,504,504,0,0
26929,2019-07-18,417,0,417,33,450,450,0,0
26930,2019-07-18,2010,0,2010,160,2170,2170,0,0
26931,2019-07-18,1380,0,1380,110,1490,1490,0,0
26932,2019-07-18,538,0,538,42,580,580,0,0
26933,2019-07-18,288,0,288,22,310,310,0,0
26934,2019-07-18,908,0,908,72,980,980,0,0
26935,2019-07-18,852,0,852,68,920,920,0,0
26936,2019-07-18,556,0,556,44,600,600,0,0
26937,2019-07-18,2676,0,2676,214,2890,2890,0,0
26938,2019-07-18,704,0,704,56,760,760,0,0
26939,2019-07-18,778,0,778,62,840,840,0,0
26940,2019-07-18,788,0,788,62,850,0,850,0
26941,2019-07-18,1538,0,1538,122,1660,1660,0,0
26942,2019-07-18,389,0,389,31,420,420,0,0
26943,2019-07-18,241,0,241,19,260,260,0,0
26944,2019-07-18,269,0,269,21,290,290,0,0
26945,2019-07-18,926,0,926,74,1000,1000,0,0
26946,2019-07-18,1166,0,1166,84,1250,1250,0,0
26947,2019-07-18,334,0,334,26,360,360,0,0
26948,2019-07-18,649,0,649,51,700,700,0,0
26949,2019-07-18,760,0,760,60,820,820,0,0
26950,2019-07-18,232,0,232,18,250,250,0,0
26951,2019-07-18,602,0,602,48,650,650,0,0
26952,2019-07-18,278,0,278,22,300,300,0,0
26953,2019-07-18,1575,0,1575,125,1700,1700,0,0
26954,2019-07-18,1886,-202,1684,134,1818,0,1818,0
26955,2019-07-18,982,0,982,78,1060,1060,0,0
26956,2019-07-18,362,0,362,28,390,390,0,0
26957,2019-07-18,306,0,306,24,330,330,0,0
26958,2019-07-18,389,0,389,31,420,0,0,420
26959,2019-07-18,889,0,889,71,960,960,0,0
26960,2019-07-18,1315,0,1315,105,1420,1420,0,0
26961,2019-07-18,1223,0,1223,97,1320,0,1320,0
26962,2019-07-18,2408,0,2408,192,2600,0,2600,0
26963,2019-07-18,1815,0,1815,145,1960,1960,0,0
26964,2019-07-18,695,0,695,55,750,750,0,0
26965,2019-07-18,250,0,250,20,270,270,0,0
26966,2019-07-18,1148,0,1148,82,1230,1230,0,0
26967,2019-07-18,491,0,491,39,530,530,0,0
26968,2019-07-18,556,0,556,44,600,600,0,0
26969,2019-07-18,371,0,371,29,400,0,400,0
26970,2019-07-18,251,0,251,19,270,270,0,0
26971,2019-07-18,139,0,139,11,150,150,0,0
26972,2019-07-18,2065,0,2065,165,2230,2230,0,0
26973,2019-07-18,389,0,389,31,420,420,0,0
26974,2019-07-18,538,0,538,42,580,580,0,0
26975,2019-07-18,908,0,908,72,980,980,0,0
26976,2019-07-18,306,0,306,24,330,330,0,0
26977,2019-07-18,1001,0,1001,79,1080,1080,0,0
26978,2019-07-18,1027,0,1027,73,1100,1100,0,0
26979,2019-07-18,667,0,667,53,720,720,0,0
26980,2019-07-18,908,0,908,72,980,0,980,0
26981,2019-07-18,908,0,908,72,980,980,0,0
26982,2019-07-18,667,0,667,53,720,720,0,0
26983,2019-07-18,861,0,861,59,920,920,0,0
26984,2019-07-18,908,0,908,72,980,980,0,0
26985,2019-07-18,473,0,473,37,510,510,0,0
26986,2019-07-18,306,0,306,24,330,330,0,0
26987,2019-07-18,-788,0,-788,-62,-850,-850,0,0
26988,2019-07-18,1815,0,1815,145,1960,1960,0,0
26989,2019-07-18,1260,0,1260,100,1360,1360,0,0
26990,2019-07-18,788,0,788,62,850,850,0,0
26991,2019-07-18,361,0,361,19,380,380,0,0
26992,2019-07-18,538,0,538,42,580,580,0,0
26993,2019-07-18,760,0,760,60,820,820,0,0
26994,2019-07-18,538,0,538,42,580,580,0,0
26995,2019-07-18,1315,0,1315,105,1420,1420,0,0
26996,2019-07-18,741,0,741,59,800,800,0,0
26997,2019-07-18,1593,0,1593,127,1720,0,0,1720
26998,2019-07-18,364,-39,325,26,351,351,0,0
26999,2019-07-18,315,0,315,25,340,340,0,0
27000,2019-07-18,760,0,760,60,820,820,0,0
27001,2019-07-18,593,0,593,47,640,640,0,0
27002,2019-07-18,630,0,630,50,680,680,0,0
27003,2019-07-18,260,0,260,20,280,280,0,0
27004,2019-07-18,1001,0,1001,79,1080,1080,0,0
27005,2019-07-18,556,0,556,44,600,600,0,0
27006,2019-07-18,1047,0,1047,83,1130,1130,0,0
27007,2019-07-18,362,0,362,28,390,390,0,0
27008,2019-07-18,815,0,815,65,880,880,0,0
27009,2019-07-18,1862,0,1862,148,2010,2010,0,0
27010,2019-07-18,769,0,769,61,830,830,0,0
27011,2019-07-18,788,0,788,62,850,850,0,0
27012,2019-07-18,630,0,630,50,680,680,0,0
27013,2019-07-18,907,0,907,63,970,970,0,0
27014,2019-07-18,639,0,639,51,690,690,0,0
27015,2019-07-18,514,-55,459,36,495,495,0,0
27016,2019-07-18,639,0,639,51,690,690,0,0
27017,2019-07-18,510,0,510,40,550,550,0,0
27018,2019-07-18,139,0,139,11,150,150,0,0
27019,2019-07-18,1482,0,1482,118,1600,1600,0,0
27020,2019-07-18,723,0,723,57,780,780,0,0
27021,2019-07-18,926,0,926,74,1000,1000,0,0
27022,2019-07-18,519,0,519,41,560,560,0,0
27023,2019-07-18,288,0,288,22,310,310,0,0
27024,2019-07-18,704,0,704,56,760,760,0,0
27025,2019-07-18,1047,0,1047,83,1130,1130,0,0
27026,2019-07-18,116,0,116,9,125,125,0,0
27027,2019-07-18,630,0,630,50,680,0,0,680
27028,2019-07-18,917,0,917,73,990,990,0,0
27029,2019-07-18,1538,0,1538,122,1660,1660,0,0
27030,2019-07-18,1575,0,1575,125,1700,1700,0,0
27031,2019-07-18,1575,0,1575,125,1700,0,1700,0
27032,2019-07-18,514,0,514,41,555,555,0,0
27033,2019-07-18,260,0,260,20,280,280,0,0
27034,2019-07-18,788,0,788,62,850,850,0,0
27035,2019-07-18,1575,0,1575,125,1700,0,1700,0
27036,2019-07-18,676,0,676,54,730,730,0,0
27037,2019-07-18,982,0,982,78,1060,1060,0,0
27038,2019-07-18,1203,0,1203,87,1290,1290,0,0
27039,2019-07-18,2362,0,2362,188,2550,2550,0,0
27040,2019-07-18,149,0,149,11,160,160,0,0
27041,2019-07-18,510,0,510,40,550,550,0,0
27042,2019-07-18,362,0,362,28,390,390,0,0
27043,2019-07-18,982,0,982,78,1060,1060,0,0
27044,2019-07-18,778,0,778,62,840,840,0,0
27045,2019-07-18,176,0,176,14,190,190,0,0
27046,2019-07-18,1575,0,1575,125,1700,1700,0,0
27047,2019-07-18,750,-158,592,40,632,632,0,0
27048,2019-07-18,473,0,473,37,510,510,0,0
27049,2019-07-18,1102,0,1102,88,1190,1190,0,0
27050,2019-07-18,630,0,630,50,680,680,0,0
27051,2019-07-18,473,0,473,37,510,510,0,0
27052,2019-07-18,223,0,223,17,240,240,0,0
27053,2019-07-18,463,0,463,37,500,500,0,0
27054,2019-07-18,4195,0,4195,335,4530,4530,0,0
27055,2019-07-18,297,0,297,23,320,320,0,0
27056,2019-07-18,443,-94,349,27,376,376,0,0
27057,2019-07-18,1584,0,1584,126,1710,1710,0,0
27058,2019-07-18,343,0,343,27,370,370,0,0
27059,2019-07-18,416,0,416,24,440,440,0,0
27060,2019-07-18,788,0,788,62,850,850,0,0
27061,2019-07-18,167,0,167,13,180,180,0,0
27062,2019-07-19,445,0,445,35,480,480,0,0
27063,2019-07-19,2723,0,2723,217,2940,2940,0,0
27064,2019-07-19,1466,-157,1309,104,1413,1413,0,0
27065,2019-07-19,-1454,0,-1454,-116,-1570,-1570,0,0
27066,2019-07-19,297,0,297,23,320,320,0,0
27067,2019-07-19,908,0,908,72,980,980,0,0
27068,2019-07-19,473,0,473,37,510,510,0,0
27069,2019-07-19,1241,0,1241,99,1340,1340,0,0
27070,2019-07-19,1334,0,1334,106,1440,1440,0,0
27071,2019-07-19,1751,0,1751,139,1890,1890,0,0
27072,2019-07-19,575,0,575,45,620,620,0,0
27073,2019-07-19,621,0,621,49,670,670,0,0
27074,2019-07-19,445,0,445,35,480,480,0,0
27075,2019-07-19,1454,0,1454,116,1570,1570,0,0
27076,2019-07-19,1232,0,1232,98,1330,1330,0,0
27077,2019-07-19,362,0,362,28,390,390,0,0
27078,2019-07-19,1815,0,1815,145,1960,1960,0,0
27079,2019-07-19,760,0,760,60,820,820,0,0
27080,2019-07-19,658,0,658,52,710,710,0,0
27081,2019-07-19,399,0,399,31,430,430,0,0
27082,2019-07-19,4130,0,4130,330,4460,4460,0,0
27083,2019-07-19,2723,0,2723,217,2940,2940,0,0
27084,2019-07-19,565,0,565,45,610,610,0,0
27085,2019-07-19,1436,0,1436,114,1550,1550,0,0
27086,2019-07-19,612,0,612,48,660,660,0,0
27087,2019-07-19,741,0,741,59,800,800,0,0
27088,2019-07-19,732,0,732,58,790,790,0,0
27089,2019-07-19,741,0,741,59,800,800,0,0
27090,2019-07-19,269,0,269,21,290,290,0,0
27091,2019-07-19,797,0,797,63,860,860,0,0
27092,2019-07-19,1371,0,1371,109,1480,1480,0,0
27093,2019-07-19,565,0,565,45,610,610,0,0
27094,2019-07-19,223,0,223,17,240,240,0,0
27095,2019-07-19,630,0,630,50,680,680,0,0
27096,2019-07-19,1139,0,1139,91,1230,1230,0,0
27097,2019-07-19,908,0,908,72,980,980,0,0
27098,2019-07-19,2408,0,2408,192,2600,2600,0,0
27099,2019-07-19,1186,0,1186,94,1280,1280,0,0
27100,2019-07-19,389,0,389,31,420,420,0,0
27101,2019-07-19,519,0,519,41,560,560,0,0
27102,2019-07-19,889,0,889,71,960,960,0,0
27103,2019-07-19,834,0,834,66,900,900,0,0
27104,2019-07-19,862,0,862,68,930,930,0,0
27105,2019-07-19,1815,0,1815,145,1960,1960,0,0
27106,2019-07-19,297,0,297,23,320,320,0,0
27107,2019-07-19,445,0,445,35,480,480,0,0
27108,2019-07-19,473,0,473,37,510,510,0,0
27109,2019-07-19,550,0,550,0,550,550,0,0
27110,2019-07-19,232,0,232,18,250,250,0,0
27111,2019-07-19,426,0,426,34,460,460,0,0
27112,2019-07-19,334,0,334,26,360,360,0,0
27113,2019-07-19,732,0,732,58,790,790,0,0
27114,2019-07-19,1204,0,1204,96,1300,1300,0,0
27115,2019-07-19,491,0,491,39,530,530,0,0
27116,2019-07-19,1619,-344,1275,101,1376,1376,0,0
27117,2019-07-19,560,-60,500,40,540,540,0,0
27118,2019-07-19,445,0,445,35,480,480,0,0
27119,2019-07-19,741,0,741,59,800,800,0,0
27120,2019-07-19,278,0,278,22,300,300,0,0
27121,2019-07-19,908,0,908,72,980,980,0,0
27122,2019-07-19,371,0,371,29,400,400,0,0
27123,2019-07-19,112,0,112,8,120,120,0,0
27124,2019-07-19,1834,0,1834,146,1980,0,1980,0
27125,2019-07-19,352,0,352,28,380,380,0,0
27126,2019-07-19,908,0,908,72,980,980,0,0
27127,2019-07-19,908,0,908,72,980,980,0,0
27128,2019-07-19,908,0,908,72,980,980,0,0
27129,2019-07-19,538,0,538,42,580,580,0,0
27130,2019-07-19,649,0,649,51,700,700,0,0
27131,2019-07-19,482,0,482,38,520,520,0,0
27132,2019-07-19,806,0,806,64,870,870,0,0
27133,2019-07-19,1056,0,1056,84,1140,1140,0,0
27134,2019-07-19,269,0,269,21,290,290,0,0
27135,2019-07-19,102,0,102,8,110,110,0,0
27136,2019-07-19,815,0,815,65,880,880,0,0
27137,2019-07-19,112,0,112,8,120,120,0,0
27138,2019-07-19,991,0,991,79,1070,1070,0,0
27139,2019-07-19,667,0,667,53,720,720,0,0
27140,2019-07-19,232,0,232,18,250,250,0,0
27141,2019-07-19,334,0,334,26,360,360,0,0
27142,2019-07-19,2362,0,2362,188,2550,2550,0,0
27143,2019-07-19,1575,0,1575,125,1700,1700,0,0
27144,2019-07-19,760,0,760,60,820,820,0,0
27145,2019-07-19,1149,0,1149,91,1240,1240,0,0
27146,2019-07-19,260,0,260,20,280,280,0,0
27147,2019-07-19,1575,0,1575,125,1700,1700,0,0
27148,2019-07-19,676,0,676,54,730,730,0,0
27149,2019-07-19,686,0,686,54,740,740,0,0
27150,2019-07-19,593,0,593,47,640,640,0,0
27151,2019-07-19,908,0,908,72,980,980,0,0
27152,2019-07-19,639,0,639,51,690,690,0,0
27153,2019-07-19,1466,-157,1309,104,1413,1413,0,0
27154,2019-07-19,408,0,408,32,440,440,0,0
27155,2019-07-19,575,0,575,45,620,620,0,0
27156,2019-07-19,389,0,389,31,420,420,0,0
27157,2019-07-19,565,0,565,45,610,610,0,0
27158,2019-07-19,1695,0,1695,135,1830,1830,0,0
27159,2019-07-19,260,0,260,20,280,280,0,0
27160,2019-07-19,313,0,313,7,320,320,0,0
27161,2019-07-19,371,0,371,29,400,400,0,0
27162,2019-07-19,658,0,658,52,710,710,0,0
27163,2019-07-19,260,0,260,20,280,280,0,0
27164,2019-07-19,362,0,362,28,390,390,0,0
27165,2019-07-19,389,0,389,31,420,420,0,0
27166,2019-07-19,723,0,723,57,780,780,0,0
27167,2019-07-19,788,0,788,62,850,850,0,0
27168,2019-07-19,1130,0,1130,90,1220,1220,0,0
27169,2019-07-19,1232,0,1232,98,1330,1330,0,0
27170,2019-07-19,491,0,491,39,530,530,0,0
27171,2019-07-19,195,0,195,15,210,210,0,0
27172,2019-07-19,538,0,538,42,580,580,0,0
27173,2019-07-19,399,0,399,31,430,430,0,0
27174,2019-07-19,788,0,788,62,850,0,850,0
27175,2019-07-19,501,0,501,39,540,540,0,0
27176,2019-07-19,732,0,732,58,790,790,0,0
27177,2019-07-19,453,0,453,27,480,480,0,0
27178,2019-07-19,547,0,547,43,590,590,0,0
27179,2019-07-19,269,0,269,21,290,290,0,0
27180,2019-07-19,2362,0,2362,188,2550,2550,0,0
27181,2019-07-19,1149,0,1149,91,1240,1240,0,0
27182,2019-07-19,926,0,926,74,1000,1000,0,0
27183,2019-07-19,788,0,788,62,850,0,850,0
27184,2019-07-19,1693,0,1693,117,1810,1810,0,0
27185,2019-07-19,1204,0,1204,96,1300,1300,0,0
27186,2019-07-19,788,0,788,62,850,0,850,0
27187,2019-07-19,2362,0,2362,188,2550,2550,0,0
27188,2019-07-19,788,0,788,62,850,850,0,0
27189,2019-07-19,473,0,473,37,510,0,510,0
27190,2019-07-19,1575,0,1575,125,1700,0,1700,0
27191,2019-07-19,2362,0,2362,188,2550,2550,0,0
27192,2019-07-19,788,0,788,62,850,850,0,0
27193,2019-07-19,593,0,593,47,640,640,0,0
27194,2019-07-19,899,0,899,71,970,970,0,0
27195,2019-07-19,1575,0,1575,125,1700,1700,0,0
27196,2019-07-19,157,0,157,3,160,160,0,0
27197,2019-07-19,1555,0,1555,115,1670,1670,0,0
27198,2019-07-19,491,0,491,39,530,530,0,0
27199,2019-07-19,1249,0,1249,91,1340,0,1340,0
27200,2019-07-19,788,0,788,62,850,850,0,0
27201,2019-07-20,1815,0,1815,145,1960,1960,0,0
27202,2019-07-20,2232,0,2232,178,2410,2410,0,0
27203,2019-07-20,1815,0,1815,145,1960,1960,0,0
27204,2019-07-20,1121,0,1121,89,1210,1210,0,0
27205,2019-07-20,232,0,232,18,250,250,0,0
27206,2019-07-20,388,0,388,22,410,410,0,0
27207,2019-07-20,639,0,639,51,690,690,0,0
27208,2019-07-20,751,0,751,59,810,810,0,0
27209,2019-07-20,1639,0,1639,131,1770,1770,0,0
27210,2019-07-20,547,0,547,43,590,590,0,0
27211,2019-07-20,825,0,825,65,890,890,0,0
27212,2019-07-20,260,0,260,20,280,280,0,0
27213,2019-07-20,306,0,306,24,330,330,0,0
27214,2019-07-20,778,0,778,62,840,840,0,0
27215,2019-07-20,1547,0,1547,123,1670,1670,0,0
27216,2019-07-20,1419,-152,1267,101,1368,1368,0,0
27217,2019-07-20,1473,0,1473,117,1590,1590,0,0
27218,2019-07-20,436,0,436,34,470,470,0,0
27219,2019-07-20,436,0,436,34,470,470,0,0
27220,2019-07-20,527,0,527,33,560,560,0,0
27221,2019-07-20,139,0,139,11,150,150,0,0
27222,2019-07-20,630,0,630,50,680,680,0,0
27223,2019-07-20,852,0,852,68,920,920,0,0
27224,2019-07-20,908,0,908,72,980,980,0,0
27225,2019-07-20,778,0,778,62,840,840,0,0
27226,2019-07-20,788,0,788,62,850,850,0,0
27227,2019-07-20,306,0,306,24,330,330,0,0
27228,2019-07-20,1980,0,1980,140,2120,2120,0,0
27229,2019-07-20,343,0,343,27,370,370,0,0
27230,2019-07-20,334,0,334,26,360,360,0,0
27231,2019-07-20,351,0,351,19,370,0,370,0
27232,2019-07-20,510,0,510,40,550,550,0,0
27233,2019-07-20,621,0,621,49,670,670,0,0
27234,2019-07-20,501,0,501,39,540,540,0,0
27235,2019-07-20,2602,0,2602,208,2810,2810,0,0
27236,2019-07-20,1334,0,1334,106,1440,1440,0,0
27237,2019-07-20,908,0,908,72,980,980,0,0
27238,2019-07-20,908,0,908,72,980,980,0,0
27239,2019-07-20,510,0,510,40,550,550,0,0
27240,2019-07-20,954,0,954,76,1030,1030,0,0
27241,2019-07-20,667,0,667,53,720,0,0,720
27242,2019-07-20,788,0,788,62,850,850,0,0
27243,2019-07-20,47,0,47,3,50,0,0,50
27244,2019-07-20,908,0,908,72,980,980,0,0
27245,2019-07-20,925,0,925,65,990,990,0,0
27246,2019-07-20,1815,0,1815,145,1960,1960,0,0
27247,2019-07-20,1010,0,1010,80,1090,1090,0,0
27248,2019-07-20,871,0,871,69,940,940,0,0
27249,2019-07-20,1075,0,1075,85,1160,1160,0,0
27250,2019-07-20,1112,0,1112,88,1200,1200,0,0
27251,2019-07-20,538,0,538,42,580,580,0,0
27252,2019-07-20,1815,0,1815,145,1960,0,0,1960
27253,2019-07-20,277,0,277,13,290,290,0,0
27254,2019-07-20,167,0,167,13,180,180,0,0
27255,2019-07-20,2723,0,2723,217,2940,0,2940,0
27256,2019-07-20,1195,0,1195,95,1290,1290,0,0
27257,2019-07-20,1815,0,1815,145,1960,0,1960,0
27258,2019-07-20,1075,0,1075,85,1160,1160,0,0
27259,2019-07-20,1815,0,1815,145,1960,1960,0,0
27260,2019-07-20,482,0,482,38,520,520,0,0
27261,2019-07-20,399,0,399,31,430,430,0,0
27262,2019-07-20,908,0,908,72,980,980,0,0
27263,2019-07-20,778,0,778,62,840,0,0,840
27264,2019-07-20,-47,0,-47,-3,-50,0,0,-50
27265,2019-07-20,788,0,788,62,850,850,0,0
27266,2019-07-20,1343,0,1343,107,1450,1450,0,0
27267,2019-07-20,1565,0,1565,125,1690,1690,0,0
27268,2019-07-20,788,0,788,62,850,850,0,0
27269,2019-07-20,2528,0,2528,202,2730,2730,0,0
27270,2019-07-20,2139,0,2139,171,2310,2310,0,0
27271,2019-07-20,322,-34,288,23,311,311,0,0
27272,2019-07-20,917,0,917,73,990,990,0,0
27273,2019-07-20,1815,0,1815,145,1960,1960,0,0
27274,2019-07-20,510,0,510,40,550,550,0,0
27275,2019-07-20,573,0,573,37,610,610,0,0
27276,2019-07-20,2723,0,2723,217,2940,2940,0,0
27277,2019-07-20,908,0,908,72,980,980,0,0
27278,2019-07-20,399,0,399,31,430,430,0,0
27279,2019-07-20,1315,0,1315,105,1420,1420,0,0
27280,2019-07-20,500,0,500,40,540,540,0,0
27281,2019-07-20,1065,0,1065,85,1150,1150,0,0
27282,2019-07-20,371,0,371,29,400,400,0,0
27283,2019-07-20,593,0,593,47,640,640,0,0
27284,2019-07-20,917,0,917,73,990,990,0,0
27285,2019-07-20,297,0,297,23,320,320,0,0
27286,2019-07-20,56,0,56,4,60,60,0,0
27287,2019-07-20,2093,0,2093,167,2260,2260,0,0
27288,2019-07-20,130,0,130,10,140,140,0,0
27289,2019-07-20,908,0,908,72,980,980,0,0
27290,2019-07-20,908,0,908,72,980,980,0,0
27291,2019-07-20,491,0,491,39,530,530,0,0
27292,2019-07-20,556,0,556,44,600,600,0,0
27293,2019-07-20,223,0,223,17,240,240,0,0
27294,2019-07-20,510,0,510,40,550,550,0,0
27295,2019-07-20,880,0,880,70,950,950,0,0
27296,2019-07-20,241,0,241,19,260,0,260,0
27297,2019-07-20,2073,0,2073,157,2230,0,2230,0
27298,2019-07-20,693,0,693,55,748,748,0,0
27299,2019-07-20,399,0,399,31,430,430,0,0
27300,2019-07-20,399,0,399,31,430,430,0,0
27301,2019-07-20,399,0,399,31,430,430,0,0
27302,2019-07-20,269,0,269,21,290,290,0,0
27303,2019-07-20,528,0,528,42,570,570,0,0
27304,2019-07-20,639,0,639,51,690,690,0,0
27305,2019-07-20,1815,0,1815,145,1960,1960,0,0
27306,2019-07-20,649,0,649,51,700,700,0,0
27307,2019-07-20,1000,0,1000,80,1080,1080,0,0
27308,2019-07-20,760,0,760,60,820,820,0,0
27309,2019-07-20,223,0,223,17,240,240,0,0
27310,2019-07-20,852,0,852,68,920,920,0,0
27311,2019-07-20,501,0,501,39,540,0,540,0
27312,2019-07-20,56,0,56,4,60,60,0,0
27313,2019-07-20,2788,0,2788,222,3010,3010,0,0
27314,2019-07-20,167,0,167,13,180,180,0,0
27315,2019-07-20,741,0,741,59,800,800,0,0
27316,2019-07-20,315,0,315,25,340,340,0,0
27317,2019-07-20,1704,0,1704,136,1840,1840,0,0
27318,2019-07-20,834,0,834,66,900,900,0,0
27319,2019-07-20,584,0,584,46,630,630,0,0
27320,2019-07-20,1501,0,1501,119,1620,1620,0,0
27321,2019-07-20,1815,0,1815,145,1960,1960,0,0
27322,2019-07-20,663,-71,592,47,639,639,0,0
27323,2019-07-20,232,0,232,18,250,250,0,0
27324,2019-07-20,510,0,510,40,550,550,0,0
27325,2019-07-20,741,0,741,59,800,800,0,0
27326,2019-07-20,570,-61,509,40,549,549,0,0
27327,2019-07-20,889,0,889,71,960,960,0,0
27328,2019-07-20,667,0,667,53,720,720,0,0
27329,2019-07-20,482,0,482,38,520,520,0,0
27330,2019-07-20,815,0,815,65,880,880,0,0
27331,2019-07-20,167,0,167,13,180,180,0,0
27332,2019-07-20,454,0,454,36,490,490,0,0
27333,2019-07-20,639,0,639,51,690,690,0,0
27334,2019-07-20,741,0,741,59,800,800,0,0
27335,2019-07-20,852,0,852,68,920,920,0,0
27336,2019-07-20,528,0,528,42,570,570,0,0
27337,2019-07-20,528,0,528,42,570,570,0,0
27338,2019-07-20,815,0,815,65,880,880,0,0
27339,2019-07-20,399,0,399,31,430,430,0,0
27340,2019-07-20,510,0,510,40,550,550,0,0
27341,2019-07-20,815,0,815,65,880,880,0,0
27342,2019-07-20,454,0,454,36,490,490,0,0
27343,2019-07-20,621,0,621,49,670,670,0,0
27344,2019-07-20,112,0,112,8,120,120,0,0
27345,2019-07-20,834,0,834,66,900,900,0,0
27346,2019-07-20,852,0,852,68,920,0,920,0
27347,2019-07-20,1583,0,1583,117,1700,0,1700,0
27348,2019-07-20,1306,0,1306,104,1410,1410,0,0
27349,2019-07-20,592,0,592,38,630,630,0,0
27350,2019-07-20,1575,0,1575,125,1700,1700,0,0
27351,2019-07-20,1001,0,1001,79,1080,1080,0,0
27352,2019-07-20,1176,0,1176,94,1270,1270,0,0
27353,2019-07-20,3149,0,3149,251,3400,3400,0,0
27354,2019-07-20,880,0,880,70,950,950,0,0
27355,2019-07-20,723,0,723,57,780,780,0,0
27356,2019-07-20,815,0,815,65,880,880,0,0
27357,2019-07-20,306,0,306,24,330,330,0,0
27358,2019-07-20,565,0,565,45,610,610,0,0
27359,2019-07-20,371,0,371,29,400,400,0,0
27360,2019-07-20,945,0,945,75,1020,1020,0,0
27361,2019-07-20,501,0,501,39,540,540,0,0
27362,2019-07-20,1213,0,1213,97,1310,1310,0,0
27363,2019-07-20,1575,0,1575,125,1700,0,0,1700
27364,2019-07-20,1204,0,1204,96,1300,1300,0,0
27365,2019-07-20,473,0,473,37,510,510,0,0
27366,2019-07-20,139,0,139,11,150,150,0,0
27367,2019-07-20,269,0,269,21,290,290,0,0
27368,2019-07-20,250,0,250,20,270,270,0,0
27369,2019-07-20,343,0,343,27,370,370,0,0
27370,2019-07-20,2362,0,2362,188,2550,2550,0,0
27371,2019-07-20,167,0,167,13,180,180,0,0
27372,2019-07-20,1575,0,1575,125,1700,1700,0,0
27373,2019-07-20,556,0,556,44,600,600,0,0
27374,2019-07-20,1936,0,1936,154,2090,0,2090,0
27375,2019-07-20,667,0,667,53,720,720,0,0
27376,2019-07-20,306,0,306,24,330,330,0,0
27377,2019-07-20,1195,0,1195,95,1290,1290,0,0
27378,2019-07-20,399,0,399,31,430,430,0,0
27379,2019-07-20,1575,0,1575,125,1700,1700,0,0
27380,2019-07-20,195,0,195,15,210,210,0,0
27381,2019-07-20,547,0,547,43,590,590,0,0
27382,2019-07-20,843,0,843,67,910,910,0,0
27383,2019-07-20,269,0,269,21,290,290,0,0
27384,2019-07-20,778,0,778,62,840,840,0,0
27385,2019-07-20,1575,0,1575,125,1700,1700,0,0
27386,2019-07-20,121,0,121,9,130,130,0,0
27387,2019-07-20,788,0,788,62,850,850,0,0
27388,2019-07-20,260,0,260,20,280,280,0,0
27389,2019-07-20,186,0,186,14,200,200,0,0
27390,2019-07-20,392,-42,350,28,378,378,0,0
27391,2019-07-20,1806,0,1806,144,1950,1950,0,0
27392,2019-07-20,306,0,306,24,330,330,0,0
27393,2019-07-21,426,0,426,34,460,460,0,0
27394,2019-07-21,980,-105,875,70,945,945,0,0
27395,2019-07-21,1723,0,1723,137,1860,1860,0,0
27396,2019-07-21,269,0,269,21,290,290,0,0
27397,2019-07-21,343,0,343,27,370,370,0,0
27398,2019-07-21,1195,0,1195,95,1290,1290,0,0
27399,2019-07-21,436,0,436,34,470,470,0,0
27400,2019-07-21,1889,0,1889,151,2040,2040,0,0
27401,2019-07-21,908,0,908,72,980,980,0,0
27402,2019-07-21,908,0,908,72,980,980,0,0
27403,2019-07-21,1000,0,1000,80,1080,1080,0,0
27404,2019-07-21,1223,0,1223,97,1320,1320,0,0
27405,2019-07-21,1815,0,1815,145,1960,1960,0,0
27406,2019-07-21,908,0,908,72,980,980,0,0
27407,2019-07-21,658,0,658,52,710,710,0,0
27408,2019-07-21,908,0,908,72,980,980,0,0
27409,2019-07-21,908,0,908,72,980,980,0,0
27410,2019-07-21,676,0,676,54,730,730,0,0
27411,2019-07-21,667,0,667,53,720,720,0,0
27412,2019-07-21,288,0,288,22,310,310,0,0
27413,2019-07-21,232,0,232,18,250,250,0,0
27414,2019-07-21,788,0,788,62,850,850,0,0
27415,2019-07-21,288,0,288,22,310,310,0,0
27416,2019-07-21,426,0,426,34,460,460,0,0
27417,2019-07-21,575,0,575,45,620,620,0,0
27418,2019-07-21,509,0,509,31,540,540,0,0
27419,2019-07-21,1362,0,1362,108,1470,1470,0,0
27420,2019-07-21,1852,0,1852,148,2000,2000,0,0
27421,2019-07-21,538,0,538,42,580,580,0,0
27422,2019-07-21,1325,0,1325,105,1430,1430,0,0
27423,2019-07-21,899,0,899,71,970,970,0,0
27424,2019-07-21,371,0,371,29,400,400,0,0
27425,2019-07-21,741,0,741,59,800,800,0,0
27426,2019-07-21,343,0,343,27,370,370,0,0
27427,2019-07-21,649,0,649,51,700,700,0,0
27428,2019-07-21,2093,0,2093,167,2260,2260,0,0
27429,2019-07-21,1399,0,1399,111,1510,1510,0,0
27430,2019-07-21,1917,0,1917,153,2070,0,2070,0
27431,2019-07-21,491,0,491,39,530,530,0,0
27432,2019-07-21,547,0,547,43,590,590,0,0
27433,2019-07-21,815,0,815,65,880,880,0,0
27434,2019-07-21,1954,0,1954,156,2110,0,2110,0
27435,2019-07-21,232,0,232,18,250,250,0,0
27436,2019-07-21,278,0,278,22,300,300,0,0
27437,2019-07-21,788,0,788,62,850,850,0,0
27438,2019-07-21,176,0,176,14,190,190,0,0
27439,2019-07-21,862,0,862,68,930,930,0,0
27440,2019-07-21,777,0,777,53,830,830,0,0
27441,2019-07-21,666,0,666,44,710,710,0,0
27442,2019-07-21,1482,0,1482,118,1600,1600,0,0
27443,2019-07-21,315,0,315,25,340,340,0,0
27444,2019-07-21,1463,0,1463,117,1580,0,1580,0
27445,2019-07-21,1926,0,1926,154,2080,2080,0,0
27446,2019-07-21,334,0,334,26,360,360,0,0
27447,2019-07-21,491,0,491,39,530,530,0,0
27448,2019-07-21,1815,0,1815,145,1960,1960,0,0
27449,2019-07-21,527,0,527,33,560,0,560,0
27450,2019-07-21,630,0,630,50,680,680,0,0
27451,2019-07-21,1019,0,1019,81,1100,1100,0,0
27452,2019-07-21,612,0,612,48,660,0,660,0
27453,2019-07-21,473,0,473,37,510,510,0,0
27454,2019-07-21,2723,0,2723,217,2940,2940,0,0
27455,2019-07-21,908,0,908,72,980,980,0,0
27456,2019-07-21,908,0,908,72,980,980,0,0
27457,2019-07-21,2038,0,2038,162,2200,2200,0,0
27458,2019-07-21,306,0,306,24,330,330,0,0
27459,2019-07-21,388,0,388,22,410,410,0,0
27460,2019-07-21,1482,0,1482,118,1600,1600,0,0
27461,2019-07-21,445,0,445,35,480,480,0,0
27462,2019-07-21,1167,0,1167,93,1260,1260,0,0
27463,2019-07-21,371,0,371,29,400,400,0,0
27464,2019-07-21,481,0,481,29,510,510,0,0
27465,2019-07-21,2760,0,2760,220,2980,0,0,2980
27466,2019-07-21,612,0,612,48,660,660,0,0
27467,2019-07-21,2112,0,2112,168,2280,2280,0,0
27468,2019-07-21,899,0,899,71,970,0,0,970
27469,2019-07-21,1121,0,1121,89,1210,1210,0,0
27470,2019-07-21,593,0,593,47,640,640,0,0
27471,2019-07-21,788,0,788,62,850,850,0,0
27472,2019-07-21,2889,0,2889,231,3120,3120,0,0
27473,2019-07-21,1213,0,1213,97,1310,1310,0,0
27474,2019-07-21,778,0,778,62,840,840,0,0
27475,2019-07-21,260,0,260,20,280,280,0,0
27476,2019-07-21,1056,0,1056,84,1140,1140,0,0
27477,2019-07-21,139,0,139,11,150,150,0,0
27478,2019-07-21,686,0,686,54,740,0,0,740
27479,2019-07-21,223,0,223,17,240,240,0,0
27480,2019-07-21,102,0,102,8,110,110,0,0
27481,2019-07-21,277,0,277,13,290,290,0,0
27482,2019-07-21,288,0,288,22,310,310,0,0
27483,2019-07-21,806,0,806,64,870,870,0,0
27484,2019-07-21,519,0,519,41,560,560,0,0
27485,2019-07-21,538,0,538,42,580,580,0,0
27486,2019-07-21,181,0,181,14,195,195,0,0
27487,2019-07-21,797,0,797,63,860,860,0,0
27488,2019-07-21,621,0,621,49,670,670,0,0
27489,2019-07-21,815,0,815,65,880,880,0,0
27490,2019-07-21,602,0,602,48,650,650,0,0
27491,2019-07-21,278,0,278,22,300,300,0,0
27492,2019-07-21,749,0,749,51,800,0,800,0
27493,2019-07-21,1139,0,1139,91,1230,1230,0,0
27494,2019-07-21,364,-39,325,26,351,351,0,0
27495,2019-07-21,945,0,945,75,1020,1020,0,0
27496,2019-07-21,945,0,945,75,1020,1020,0,0
27497,2019-07-21,538,0,538,42,580,580,0,0
27498,2019-07-21,445,0,445,35,480,480,0,0
27499,2019-07-21,1334,0,1334,106,1440,1440,0,0
27500,2019-07-21,1565,0,1565,125,1690,1690,0,0
27501,2019-07-21,278,0,278,22,300,300,0,0
27502,2019-07-21,778,0,778,62,840,840,0,0
27503,2019-07-21,362,0,362,28,390,390,0,0
27504,2019-07-21,713,0,713,57,770,770,0,0
27505,2019-07-21,1852,0,1852,148,2000,2000,0,0
27506,2019-07-21,491,0,491,39,530,530,0,0
27507,2019-07-21,139,0,139,11,150,150,0,0
27508,2019-07-21,1027,0,1027,73,1100,1100,0,0
27509,2019-07-21,1325,0,1325,105,1430,1430,0,0
27510,2019-07-21,343,0,343,27,370,370,0,0
27511,2019-07-21,491,0,491,39,530,530,0,0
27512,2019-07-21,297,0,297,23,320,320,0,0
27513,2019-07-21,334,0,334,26,360,360,0,0
27514,2019-07-21,167,0,167,13,180,180,0,0
27515,2019-07-21,1362,0,1362,108,1470,1470,0,0
27516,2019-07-21,936,0,936,74,1010,1010,0,0
27517,2019-07-21,723,0,723,57,780,780,0,0
27518,2019-07-21,788,0,788,62,850,850,0,0
27519,2019-07-21,806,0,806,64,870,870,0,0
27520,2019-07-21,528,0,528,42,570,570,0,0
27521,2019-07-21,167,0,167,13,180,180,0,0
27522,2019-07-21,1158,0,1158,92,1250,1250,0,0
27523,2019-07-21,2639,0,2639,211,2850,2850,0,0
27524,2019-07-21,1575,0,1575,125,1700,1700,0,0
27525,2019-07-21,788,0,788,62,850,850,0,0
27526,2019-07-21,1019,0,1019,81,1100,1100,0,0
27527,2019-07-21,306,0,306,24,330,330,0,0
27528,2019-07-21,362,0,362,28,390,390,0,0
27529,2019-07-21,1371,0,1371,109,1480,1480,0,0
27530,2019-07-21,1575,0,1575,125,1700,1700,0,0
27531,2019-07-21,991,0,991,79,1070,1070,0,0
27532,2019-07-21,232,0,232,18,250,250,0,0
27533,2019-07-21,306,0,306,24,330,330,0,0
27534,2019-07-21,1815,0,1815,145,1960,1960,0,0
27535,2019-07-21,3482,0,3482,278,3760,3760,0,0
27536,2019-07-21,1232,0,1232,98,1330,1330,0,0
27537,2019-07-21,306,0,306,24,330,330,0,0
27538,2019-07-21,510,0,510,40,550,550,0,0
27539,2019-07-21,510,0,510,40,550,0,0,550
27540,2019-07-21,334,0,334,26,360,360,0,0
27541,2019-07-21,862,0,862,68,930,930,0,0
27542,2019-07-21,389,0,389,31,420,420,0,0
27543,2019-07-21,1899,0,1899,151,2050,2050,0,0
27544,2019-07-21,806,0,806,64,870,870,0,0
27545,2019-07-21,945,0,945,75,1020,1020,0,0
27546,2019-07-21,352,0,352,28,380,380,0,0
27547,2019-07-21,426,0,426,34,460,460,0,0
27548,2019-07-21,269,0,269,21,290,290,0,0
27549,2019-07-22,445,0,445,35,480,480,0,0
27550,2019-07-22,788,0,788,62,850,850,0,0
27551,2019-07-22,908,0,908,72,980,0,0,980
27552,2019-07-22,306,0,306,24,330,330,0,0
27553,2019-07-22,-908,0,-908,-72,-980,-980,0,0
27554,2019-07-22,695,0,695,55,750,750,0,0
27555,2019-07-22,232,0,232,18,250,250,0,0
27556,2019-07-22,1251,0,1251,99,1350,1350,0,0
27557,2019-07-22,112,0,112,8,120,120,0,0
27558,2019-07-22,167,0,167,13,180,180,0,0
27559,2019-07-22,1389,0,1389,111,1500,1500,0,0
27560,2019-07-22,121,0,121,9,130,130,0,0
27561,2019-07-22,260,0,260,20,280,280,0,0
27562,2019-07-22,648,0,648,42,690,690,0,0
27563,2019-07-22,426,0,426,34,460,460,0,0
27564,2019-07-22,915,-98,817,65,882,882,0,0
27565,2019-07-22,1139,0,1139,91,1230,1230,0,0
27566,2019-07-22,915,-98,817,65,882,882,0,0
27567,2019-07-22,482,0,482,38,520,520,0,0
27568,2019-07-22,612,0,612,48,660,660,0,0
27569,2019-07-22,915,-98,817,65,882,882,0,0
27570,2019-07-22,915,-98,817,65,882,882,0,0
27571,2019-07-22,915,-98,817,65,882,882,0,0
27572,2019-07-22,915,-98,817,65,882,882,0,0
27573,2019-07-22,915,-98,817,65,882,882,0,0
27574,2019-07-22,908,0,908,72,980,980,0,0
27575,2019-07-22,915,-98,817,65,882,882,0,0
27576,2019-07-22,658,0,658,52,710,710,0,0
27577,2019-07-22,417,0,417,33,450,450,0,0
27578,2019-07-22,510,0,510,40,550,550,0,0
27579,2019-07-22,915,-98,817,65,882,882,0,0
27580,2019-07-22,915,-98,817,65,882,882,0,0
27581,2019-07-22,908,0,908,72,980,980,0,0
27582,2019-07-22,915,-98,817,65,882,882,0,0
27583,2019-07-22,149,0,149,11,160,160,0,0
27584,2019-07-22,908,0,908,72,980,980,0,0
27585,2019-07-22,880,0,880,70,950,950,0,0
27586,2019-07-22,374,-40,334,26,360,360,0,0
27587,2019-07-22,463,0,463,37,500,500,0,0
27588,2019-07-22,723,0,723,57,780,780,0,0
27589,2019-07-22,639,0,639,51,690,690,0,0
27590,2019-07-22,1399,0,1399,111,1510,1510,0,0
27591,2019-07-22,732,0,732,58,790,790,0,0
27592,2019-07-22,825,0,825,65,890,890,0,0
27593,2019-07-22,297,0,297,23,320,320,0,0
27594,2019-07-22,454,0,454,36,490,490,0,0
27595,2019-07-22,380,0,380,30,410,410,0,0
27596,2019-07-22,308,-33,275,22,297,297,0,0
27597,2019-07-22,325,0,325,25,350,350,0,0
27598,2019-07-22,195,0,195,15,210,210,0,0
27599,2019-07-22,6019,0,6019,481,6500,0,6500,0
27600,2019-07-22,33334,0,33334,2666,36000,36000,0,0
27601,2019-07-22,999,0,999,71,1070,1070,0,0
27602,2019-07-22,556,0,556,44,600,600,0,0
27603,2019-07-22,732,0,732,58,790,790,0,0
27604,2019-07-22,352,0,352,28,380,380,0,0
27605,2019-07-22,973,0,973,77,1050,1050,0,0
27606,2019-07-22,723,0,723,57,780,780,0,0
27607,2019-07-22,547,0,547,43,590,590,0,0
27608,2019-07-22,334,0,334,26,360,360,0,0
27609,2019-07-22,612,0,612,48,660,660,0,0
27610,2019-07-22,426,0,426,34,460,460,0,0
27611,2019-07-22,445,0,445,35,480,480,0,0
27612,2019-07-22,1065,0,1065,85,1150,1150,0,0
27613,2019-07-22,908,0,908,72,980,980,0,0
27614,2019-07-22,362,0,362,28,390,390,0,0
27615,2019-07-22,1660,-177,1483,110,1593,1593,0,0
27616,2019-07-22,630,0,630,50,680,680,0,0
27617,2019-07-22,297,0,297,23,320,0,0,320
27618,2019-07-22,825,0,825,65,890,890,0,0
27619,2019-07-22,371,0,371,29,400,400,0,0
27620,2019-07-22,1463,0,1463,117,1580,1580,0,0
27621,2019-07-22,778,0,778,62,840,840,0,0
27622,2019-07-22,649,0,649,51,700,700,0,0
27623,2019-07-22,278,0,278,22,300,300,0,0
27624,2019-07-22,1038,0,1038,82,1120,1120,0,0
27625,2019-07-22,915,-98,817,65,882,882,0,0
27626,2019-07-22,251,0,251,19,270,270,0,0
27627,2019-07-22,380,0,380,30,410,410,0,0
27628,2019-07-22,518,-110,408,32,440,440,0,0
27629,2019-07-22,371,0,371,29,400,400,0,0
27630,2019-07-22,1575,0,1575,125,1700,1700,0,0
27631,2019-07-22,2362,0,2362,188,2550,2550,0,0
27632,2019-07-22,788,0,788,62,850,850,0,0
27633,2019-07-22,186,0,186,14,200,200,0,0
27634,2019-07-22,1575,0,1575,125,1700,0,1700,0
27635,2019-07-22,1575,0,1575,125,1700,0,1700,0
27636,2019-07-22,915,-98,817,65,882,882,0,0
27637,2019-07-22,538,0,538,42,580,580,0,0
27638,2019-07-22,362,0,362,28,390,390,0,0
27639,2019-07-22,723,0,723,57,780,780,0,0
27640,2019-07-22,713,0,713,57,770,770,0,0
27641,2019-07-22,482,0,482,38,520,520,0,0
27642,2019-07-22,399,0,399,31,430,430,0,0
27643,2019-07-22,806,0,806,64,870,870,0,0
27644,2019-07-22,436,0,436,34,470,470,0,0
27645,2019-07-22,6352,0,6352,508,6860,6860,0,0
27646,2019-07-22,998,-212,786,62,848,848,0,0
27647,2019-07-22,880,0,880,70,950,950,0,0
27648,2019-07-22,362,0,362,28,390,390,0,0
27649,2019-07-22,260,0,260,20,280,280,0,0
27650,2019-07-22,519,0,519,41,560,560,0,0
27651,2019-07-22,898,0,898,62,960,960,0,0
27652,2019-07-22,334,0,334,26,360,360,0,0
27653,2019-07-22,167,0,167,13,180,180,0,0
27654,2019-07-22,371,0,371,29,400,400,0,0
27655,2019-07-22,278,0,278,22,300,300,0,0
27656,2019-07-22,1436,0,1436,114,1550,1550,0,0
27657,2019-07-22,149,0,149,11,160,160,0,0
27658,2019-07-22,528,0,528,42,570,570,0,0
27659,2019-07-22,362,0,362,28,390,390,0,0
27660,2019-07-22,1121,0,1121,89,1210,1210,0,0
27661,2019-07-22,1075,0,1075,85,1160,1160,0,0
27662,2019-07-22,297,0,297,23,320,320,0,0
27663,2019-07-22,788,0,788,62,850,850,0,0
27664,2019-07-22,223,0,223,17,240,240,0,0
27665,2019-07-22,1010,0,1010,80,1090,0,1090,0
27666,2019-07-22,732,0,732,58,790,790,0,0
27667,2019-07-22,556,0,556,44,600,600,0,0
27668,2019-07-22,167,0,167,13,180,180,0,0
27669,2019-07-22,-908,0,-908,-72,-980,-980,0,0
27670,2019-07-22,915,-98,817,65,882,882,0,0
27671,2019-07-22,915,-98,817,65,882,882,0,0
27672,2019-07-22,915,-98,817,65,882,882,0,0
27673,2019-07-22,915,-98,817,65,882,882,0,0
27674,2019-07-22,915,-98,817,65,882,882,0,0
27675,2019-07-22,915,-98,817,65,882,882,0,0
27676,2019-07-22,915,-98,817,65,882,882,0,0
27677,2019-07-22,915,-98,817,65,882,882,0,0
27678,2019-07-22,915,-98,817,65,882,882,0,0
27679,2019-07-22,915,-98,817,65,882,882,0,0
27680,2019-07-22,1305,0,1305,95,1400,1400,0,0
27681,2019-07-22,1093,0,1093,87,1180,1180,0,0
27682,2019-07-22,908,0,908,72,980,980,0,0
27683,2019-07-22,834,0,834,66,900,900,0,0
27684,2019-07-22,760,0,760,60,820,820,0,0
27685,2019-07-22,621,0,621,49,670,670,0,0
27686,2019-07-22,667,0,667,53,720,720,0,0
27687,2019-07-22,556,0,556,44,600,600,0,0
27688,2019-07-22,399,0,399,31,430,430,0,0
27689,2019-07-22,262,-28,234,18,252,252,0,0
27690,2019-07-22,1575,0,1575,125,1700,1700,0,0
27691,2019-07-22,408,0,408,32,440,440,0,0
27692,2019-07-22,306,0,306,24,330,330,0,0
27693,2019-07-22,251,0,251,19,270,270,0,0
27694,2019-07-22,815,0,815,65,880,880,0,0
27695,2019-07-22,232,0,232,18,250,250,0,0
27696,2019-07-22,888,0,888,62,950,950,0,0
27697,2019-07-22,260,0,260,20,280,280,0,0
27698,2019-07-22,399,0,399,31,430,430,0,0
27699,2019-07-22,1587,-170,1417,113,1530,1530,0,0
27700,2019-07-22,467,-50,417,33,450,450,0,0
27701,2019-07-23,352,0,352,28,380,380,0,0
27702,2019-07-23,352,0,352,28,380,380,0,0
27703,2019-07-23,-398,0,-398,-32,-430,-430,0,0
27704,2019-07-23,149,0,149,11,160,160,0,0
27705,2019-07-23,288,0,288,22,310,310,0,0
27706,2019-07-23,102,0,102,8,110,110,0,0
27707,2019-07-23,269,0,269,21,290,290,0,0
27708,2019-07-23,204,0,204,16,220,220,0,0
27709,2019-07-23,278,0,278,22,300,300,0,0
27710,2019-07-23,639,0,639,51,690,690,0,0
27711,2019-07-23,3213,0,3213,257,3470,3470,0,0
27712,2019-07-23,213,0,213,17,230,230,0,0
27713,2019-07-23,899,0,899,71,970,970,0,0
27714,2019-07-23,260,0,260,20,280,280,0,0
27715,2019-07-23,232,0,232,18,250,250,0,0
27716,2019-07-23,952,-102,850,68,918,918,0,0
27717,2019-07-23,952,-102,850,68,918,918,0,0
27718,2019-07-23,399,0,399,31,430,430,0,0
27719,2019-07-23,917,0,917,73,990,990,0,0
27720,2019-07-23,732,0,732,58,790,790,0,0
27721,2019-07-23,908,0,908,72,980,980,0,0
27722,2019-07-23,908,0,908,72,980,980,0,0
27723,2019-07-23,658,0,658,52,710,710,0,0
27724,2019-07-23,954,0,954,76,1030,1030,0,0
27725,2019-07-23,778,0,778,62,840,840,0,0
27726,2019-07-23,330,0,330,0,330,330,0,0
27727,2019-07-23,667,0,667,53,720,720,0,0
27728,2019-07-24,945,0,945,75,1020,1020,0,0
27729,2019-07-24,1815,0,1815,145,1960,1960,0,0
27730,2019-07-24,834,0,834,66,900,900,0,0
27731,2019-07-24,908,0,908,72,980,980,0,0
27732,2019-07-24,480,-102,378,30,408,408,0,0
27733,2019-07-24,1149,0,1149,91,1240,1240,0,0
27734,2019-07-24,871,0,871,69,940,940,0,0
27735,2019-07-24,862,0,862,68,930,930,0,0
27736,2019-07-24,538,0,538,42,580,580,0,0
27737,2019-07-24,630,0,630,50,680,680,0,0
27738,2019-07-24,361,0,361,19,380,0,0,380
27739,2019-07-24,723,0,723,57,780,780,0,0
27740,2019-07-24,1815,0,1815,145,1960,1960,0,0
27741,2019-07-24,908,0,908,72,980,980,0,0
27742,2019-07-24,908,0,908,72,980,980,0,0
27743,2019-07-24,1019,0,1019,81,1100,1100,0,0
27744,2019-07-24,584,0,584,46,630,630,0,0
27745,2019-07-24,1815,0,1815,145,1960,1960,0,0
27746,2019-07-24,3223,0,3223,257,3480,0,3480,0
27747,2019-07-24,973,0,973,77,1050,1050,0,0
27748,2019-07-24,473,0,473,37,510,510,0,0
27749,2019-07-24,260,0,260,20,280,280,0,0
27750,2019-07-24,399,0,399,31,430,430,0,0
27751,2019-07-24,251,0,251,19,270,270,0,0
27752,2019-07-24,1815,0,1815,145,1960,1960,0,0
27753,2019-07-24,320,-68,252,20,272,272,0,0
27754,2019-07-24,269,0,269,21,290,290,0,0
27755,2019-07-24,565,0,565,45,610,610,0,0
27756,2019-07-24,621,0,621,49,670,670,0,0
27757,2019-07-24,334,0,334,26,360,360,0,0
27758,2019-07-24,501,0,501,39,540,540,0,0
27759,2019-07-24,908,0,908,72,980,980,0,0
27760,2019-07-24,612,0,612,48,660,660,0,0
27761,2019-07-24,278,0,278,22,300,300,0,0
27762,2019-07-24,1815,0,1815,145,1960,1960,0,0
27763,2019-07-24,334,0,334,26,360,360,0,0
27764,2019-07-24,908,0,908,72,980,980,0,0
27765,2019-07-24,908,0,908,72,980,980,0,0
27766,2019-07-24,250,0,250,20,270,270,0,0
27767,2019-07-24,926,0,926,74,1000,1000,0,0
27768,2019-07-24,260,0,260,20,280,280,0,0
27769,2019-07-24,334,0,334,26,360,360,0,0
27770,2019-07-24,352,0,352,28,380,380,0,0
27771,2019-07-24,260,0,260,20,280,0,280,0
27772,2019-07-24,760,0,760,60,820,820,0,0
27773,2019-07-24,417,0,417,33,450,450,0,0
27774,2019-07-24,269,0,269,21,290,290,0,0
27775,2019-07-24,232,0,232,18,250,250,0,0
27776,2019-07-24,815,0,815,65,880,880,0,0
27777,2019-07-24,445,0,445,35,480,480,0,0
27778,2019-07-24,1730,0,1730,120,1850,1850,0,0
27779,2019-07-24,778,0,778,62,840,840,0,0
27780,2019-07-24,4621,0,4621,369,4990,4990,0,0
27781,2019-07-24,843,0,843,67,910,910,0,0
27782,2019-07-24,788,0,788,62,850,850,0,0
27783,2019-07-24,389,0,389,31,420,420,0,0
27784,2019-07-24,436,0,436,34,470,470,0,0
27785,2019-07-24,788,0,788,62,850,850,0,0
27786,2019-07-24,788,0,788,62,850,850,0,0
27787,2019-07-24,2362,0,2362,188,2550,2550,0,0
27788,2019-07-24,3936,0,3936,314,4250,4250,0,0
27789,2019-07-24,1251,0,1251,99,1350,1350,0,0
27790,2019-07-24,584,0,584,46,630,630,0,0
27791,2019-07-24,1102,0,1102,88,1190,1190,0,0
27792,2019-07-24,908,0,908,72,980,980,0,0
27793,2019-07-24,436,0,436,34,470,470,0,0
27794,2019-07-24,436,0,436,34,470,470,0,0
27795,2019-07-24,491,0,491,39,530,530,0,0
27796,2019-07-24,463,0,463,37,500,500,0,0
27797,2019-07-24,908,0,908,72,980,980,0,0
27798,2019-07-24,482,0,482,38,520,520,0,0
27799,2019-07-24,1751,0,1751,139,1890,1890,0,0
27800,2019-07-24,334,0,334,26,360,360,0,0
27801,2019-07-24,797,0,797,63,860,860,0,0
27802,2019-07-24,843,0,843,67,910,910,0,0
27803,2019-07-24,741,0,741,59,800,800,0,0
27804,2019-07-24,1380,0,1380,110,1490,1490,0,0
27805,2019-07-24,1019,0,1019,81,1100,1100,0,0
27806,2019-07-24,255,-54,201,15,216,216,0,0
27807,2019-07-24,797,0,797,63,860,860,0,0
27808,2019-07-24,686,0,686,54,740,740,0,0
27809,2019-07-24,1112,0,1112,88,1200,0,1200,0
27810,2019-07-24,3389,0,3389,271,3660,3660,0,0
27811,2019-07-25,445,0,445,35,480,480,0,0
27812,2019-07-25,908,0,908,72,980,980,0,0
27813,2019-07-25,908,0,908,72,980,980,0,0
27814,2019-07-25,908,0,908,72,980,980,0,0
27815,2019-07-25,908,0,908,72,980,980,0,0
27816,2019-07-25,1538,0,1538,122,1660,1660,0,0
27817,2019-07-25,908,0,908,72,980,980,0,0
27818,2019-07-25,908,0,908,72,980,980,0,0
27819,2019-07-25,908,0,908,72,980,980,0,0
27820,2019-07-25,666,0,666,44,710,710,0,0
27821,2019-07-25,908,0,908,72,980,980,0,0
27822,2019-07-25,1019,0,1019,81,1100,1100,0,0
27823,2019-07-25,769,0,769,61,830,830,0,0
27824,2019-07-25,538,0,538,42,580,580,0,0
27825,2019-07-25,1649,0,1649,131,1780,1780,0,0
27826,2019-07-25,389,0,389,31,420,420,0,0
27827,2019-07-25,843,0,843,67,910,910,0,0
27828,2019-07-25,908,0,908,72,980,980,0,0
27829,2019-07-25,825,0,825,65,890,890,0,0
27830,2019-07-25,667,0,667,53,720,720,0,0
27831,2019-07-25,1297,0,1297,103,1400,1400,0,0
27832,2019-07-25,2120,0,2120,160,2280,2280,0,0
27833,2019-07-25,362,0,362,28,390,0,0,390
27834,2019-07-25,880,0,880,70,950,950,0,0
27835,2019-07-25,769,0,769,61,830,830,0,0
27836,2019-07-25,889,0,889,71,960,960,0,0
27837,2019-07-25,825,0,825,65,890,890,0,0
27838,2019-07-25,667,0,667,53,720,720,0,0
27839,2019-07-25,260,0,260,20,280,280,0,0
27840,2019-07-25,982,0,982,78,1060,1060,0,0
27841,2019-07-25,1639,0,1639,131,1770,1770,0,0
27842,2019-07-25,186,0,186,14,200,200,0,0
27843,2019-07-25,880,0,880,70,950,950,0,0
27844,2019-07-25,538,0,538,42,580,580,0,0
27845,2019-07-25,871,0,871,69,940,940,0,0
27846,2019-07-25,417,0,417,33,450,450,0,0
27847,2019-07-25,425,0,425,25,450,450,0,0
27848,2019-07-25,908,0,908,72,980,980,0,0
27849,2019-07-25,1093,0,1093,87,1180,1180,0,0
27850,2019-07-25,908,0,908,72,980,980,0,0
27851,2019-07-25,482,0,482,38,520,520,0,0
27852,2019-07-25,917,0,917,73,990,990,0,0
27853,2019-07-25,250,0,250,20,270,270,0,0
27854,2019-07-25,112,0,112,8,120,120,0,0
27855,2019-07-25,149,0,149,11,160,0,0,160
27856,2019-07-25,528,0,528,42,570,570,0,0
27857,2019-07-25,523,-56,467,37,504,504,0,0
27858,2019-07-25,3139,0,3139,251,3390,0,3390,0
27859,2019-07-25,732,0,732,58,790,790,0,0
27860,2019-07-25,751,0,751,59,810,810,0,0
27861,2019-07-25,439,-47,392,31,423,0,423,0
27862,2019-07-25,426,0,426,34,460,460,0,0
27863,2019-07-25,1075,0,1075,85,1160,1160,0,0
27864,2019-07-25,1575,0,1575,125,1700,1700,0,0
27865,2019-07-25,463,0,463,37,500,500,0,0
27866,2019-07-25,436,0,436,34,470,470,0,0
27867,2019-07-25,741,0,741,59,800,800,0,0
27868,2019-07-25,862,0,862,68,930,930,0,0
27869,2019-07-25,538,0,538,42,580,580,0,0
27870,2019-07-25,926,0,926,74,1000,1000,0,0
27871,2019-07-25,232,0,232,18,250,250,0,0
27872,2019-07-25,1343,0,1343,107,1450,1450,0,0
27873,2019-07-25,204,0,204,16,220,220,0,0
27874,2019-07-25,-797,0,-797,-63,-860,-860,0,0
27875,2019-07-25,797,0,797,63,860,860,0,0
27876,2019-07-25,491,0,491,39,530,530,0,0
27877,2019-07-25,362,0,362,28,390,390,0,0
27878,2019-07-25,639,0,639,51,690,690,0,0
27879,2019-07-25,232,0,232,18,250,250,0,0
27880,2019-07-25,1019,0,1019,81,1100,1100,0,0
27881,2019-07-25,778,0,778,62,840,840,0,0
27882,2019-07-25,260,0,260,20,280,280,0,0
27883,2019-07-25,463,0,463,37,500,500,0,0
27884,2019-07-25,501,0,501,39,540,540,0,0
27885,2019-07-25,592,0,592,47,639,639,0,0
27886,2019-07-25,399,0,399,31,430,430,0,0
27887,2019-07-25,440,0,440,0,440,440,0,0
27888,2019-07-25,3630,0,3630,290,3920,3920,0,0
27889,2019-07-25,806,0,806,64,870,870,0,0
27890,2019-07-25,501,0,501,39,540,540,0,0
27891,2019-07-25,1788,0,1788,142,1930,1930,0,0
27892,2019-07-25,797,0,797,63,860,860,0,0
27893,2019-07-25,3149,0,3149,251,3400,3400,0,0
27894,2019-07-25,676,0,676,54,730,730,0,0
27895,2019-07-25,649,0,649,51,700,700,0,0
27896,2019-07-25,1019,0,1019,81,1100,1100,0,0
27897,2019-07-25,389,0,389,31,420,420,0,0
27898,2019-07-25,1325,0,1325,105,1430,0,1430,0
27899,2019-07-25,1297,0,1297,103,1400,1400,0,0
27900,2019-07-25,1158,0,1158,92,1250,1250,0,0
27901,2019-07-25,593,0,593,47,640,640,0,0
27902,2019-07-25,-330,0,-330,0,-330,-330,0,0
27903,2019-07-25,330,-33,297,0,297,297,0,0
27904,2019-07-25,330,0,330,0,330,330,0,0
27905,2019-07-25,278,0,278,22,300,300,0,0
27906,2019-07-25,306,0,306,24,330,330,0,0
27907,2019-07-25,852,0,852,68,920,920,0,0
27908,2019-07-25,260,0,260,20,280,280,0,0
27909,2019-07-25,547,0,547,43,590,590,0,0
27910,2019-07-25,334,0,334,26,360,360,0,0
27911,2019-07-25,788,0,788,62,850,850,0,0
27912,2019-07-25,1575,0,1575,125,1700,1700,0,0
27913,2019-07-25,917,0,917,73,990,990,0,0
27914,2019-07-25,1575,0,1575,125,1700,1700,0,0
27915,2019-07-25,509,0,509,31,540,540,0,0
27916,2019-07-25,1001,0,1001,79,1080,1080,0,0
27917,2019-07-25,1834,0,1834,146,1980,1980,0,0
27918,2019-07-26,445,0,445,35,480,480,0,0
27919,2019-07-26,862,0,862,68,930,930,0,0
27920,2019-07-26,538,0,538,42,580,580,0,0
27921,2019-07-26,732,0,732,58,790,790,0,0
27922,2019-07-26,769,0,769,61,830,830,0,0
27923,2019-07-26,675,0,675,45,720,720,0,0
27924,2019-07-26,306,0,306,24,330,330,0,0
27925,2019-07-26,963,0,963,77,1040,1040,0,0
27926,2019-07-26,1926,0,1926,154,2080,2080,0,0
27927,2019-07-26,806,0,806,64,870,870,0,0
27928,2019-07-26,1815,0,1815,145,1960,1960,0,0
27929,2019-07-26,1001,0,1001,79,1080,1080,0,0
27930,2019-07-26,1223,0,1223,97,1320,1320,0,0
27931,2019-07-26,1380,0,1380,110,1490,1490,0,0
27932,2019-07-26,584,0,584,46,630,630,0,0
27933,2019-07-26,1047,0,1047,83,1130,1130,0,0
27934,2019-07-26,1509,0,1509,111,1620,1620,0,0
27935,2019-07-26,315,0,315,25,340,0,340,0
27936,2019-07-26,463,0,463,37,500,500,0,0
27937,2019-07-26,852,0,852,68,920,920,0,0
27938,2019-07-26,575,0,575,45,620,620,0,0
27939,2019-07-26,269,0,269,21,290,290,0,0
27940,2019-07-26,788,0,788,62,850,0,850,0
27941,2019-07-26,1788,0,1788,142,1930,1930,0,0
27942,2019-07-26,2797,0,2797,223,3020,3020,0,0
27943,2019-07-26,1408,0,1408,112,1520,1520,0,0
27944,2019-07-26,908,0,908,72,980,0,980,0
27945,2019-07-26,501,0,501,39,540,540,0,0
27946,2019-07-26,788,0,788,62,850,850,0,0
27947,2019-07-26,908,0,908,72,980,0,980,0
27948,2019-07-26,621,0,621,49,670,670,0,0
27949,2019-07-26,579,-62,517,41,558,558,0,0
27950,2019-07-26,223,0,223,17,240,240,0,0
27951,2019-07-26,1019,0,1019,81,1100,1100,0,0
27952,2019-07-26,843,0,843,67,910,910,0,0
27953,2019-07-26,1139,0,1139,91,1230,1230,0,0
27954,2019-07-26,380,0,380,30,410,410,0,0
27955,2019-07-26,1815,0,1815,145,1960,1960,0,0
27956,2019-07-26,1833,0,1833,137,1970,1970,0,0
27957,2019-07-26,1047,0,1047,83,1130,1130,0,0
27958,2019-07-26,389,0,389,31,420,420,0,0
27959,2019-07-26,908,0,908,72,980,980,0,0
27960,2019-07-26,269,0,269,21,290,290,0,0
27961,2019-07-26,352,0,352,28,380,380,0,0
27962,2019-07-26,630,0,630,50,680,680,0,0
27963,2019-07-26,741,0,741,59,800,800,0,0
27964,2019-07-26,1362,0,1362,108,1470,1470,0,0
27965,2019-07-26,2038,0,2038,162,2200,2200,0,0
27966,2019-07-26,778,0,778,62,840,840,0,0
27967,2019-07-26,1203,0,1203,87,1290,0,1290,0
27968,2019-07-26,908,0,908,72,980,980,0,0
27969,2019-07-26,908,0,908,72,980,980,0,0
27970,2019-07-26,704,0,704,56,760,760,0,0
27971,2019-07-26,371,0,371,29,400,400,0,0
27972,2019-07-26,1268,0,1268,92,1360,0,1360,0
27973,2019-07-26,1538,0,1538,122,1660,1660,0,0
27974,2019-07-26,399,0,399,31,430,430,0,0
27975,2019-07-26,936,0,936,74,1010,1010,0,0
27976,2019-07-26,732,0,732,58,790,790,0,0
27977,2019-07-26,898,0,898,62,960,960,0,0
27978,2019-07-26,871,0,871,69,940,940,0,0
27979,2019-07-26,380,0,380,30,410,410,0,0
27980,2019-07-26,547,0,547,43,590,0,590,0
27981,2019-07-26,269,0,269,21,290,290,0,0
27982,2019-07-26,249,0,249,11,260,260,0,0
27983,2019-07-26,399,0,399,31,430,430,0,0
27984,2019-07-26,259,0,259,11,270,270,0,0
27985,2019-07-26,463,0,463,37,500,500,0,0
27986,2019-07-26,1575,0,1575,125,1700,1700,0,0
27987,2019-07-26,1426,0,1426,114,1540,1540,0,0
27988,2019-07-26,1797,0,1797,143,1940,1940,0,0
27989,2019-07-26,399,0,399,31,430,430,0,0
27990,2019-07-26,778,0,778,62,840,840,0,0
27991,2019-07-26,1473,0,1473,117,1590,1590,0,0
27992,2019-07-26,778,0,778,62,840,840,0,0
27993,2019-07-26,963,0,963,77,1040,1040,0,0
27994,2019-07-26,288,0,288,22,310,310,0,0
27995,2019-07-26,399,0,399,31,430,430,0,0
27996,2019-07-26,991,0,991,79,1070,1070,0,0
27997,2019-07-26,593,0,593,47,640,640,0,0
27998,2019-07-26,1565,0,1565,125,1690,1690,0,0
27999,2019-07-26,306,0,306,24,330,330,0,0
28000,2019-07-26,1852,0,1852,148,2000,2000,0,0
28001,2019-07-26,176,0,176,14,190,190,0,0
28002,2019-07-26,945,0,945,75,1020,1020,0,0
28003,2019-07-26,889,0,889,71,960,960,0,0
28004,2019-07-26,825,0,825,65,890,890,0,0
28005,2019-07-26,389,0,389,31,420,420,0,0
28006,2019-07-26,1149,0,1149,91,1240,0,1240,0
28007,2019-07-26,1176,0,1176,94,1270,0,1270,0
28008,2019-07-26,639,0,639,51,690,690,0,0
28009,2019-07-26,991,0,991,79,1070,1070,0,0
28010,2019-07-26,1352,0,1352,108,1460,1460,0,0
28011,2019-07-26,1575,0,1575,125,1700,0,1700,0
28012,2019-07-26,519,0,519,41,560,560,0,0
28013,2019-07-26,1575,0,1575,125,1700,1700,0,0
28014,2019-07-26,788,0,788,62,850,850,0,0
28015,2019-07-26,288,0,288,22,310,310,0,0
28016,2019-07-26,343,0,343,27,370,370,0,0
28017,2019-07-26,788,0,788,62,850,850,0,0
28018,2019-07-26,1575,0,1575,125,1700,0,1700,0
28019,2019-07-26,343,0,343,27,370,370,0,0
28020,2019-07-26,1325,0,1325,105,1430,1430,0,0
28021,2019-07-26,408,0,408,32,440,440,0,0
28022,2019-07-26,593,0,593,47,640,0,640,0
28023,2019-07-26,3149,0,3149,251,3400,3400,0,0
28024,2019-07-26,676,0,676,54,730,730,0,0
28025,2019-07-26,741,0,741,59,800,0,0,800
28026,2019-07-26,649,0,649,51,700,700,0,0
28027,2019-07-26,1334,0,1334,106,1440,1440,0,0
28028,2019-07-26,536,0,536,34,570,0,570,0
28029,2019-07-27,815,0,815,65,880,880,0,0
28030,2019-07-27,1815,0,1815,145,1960,1960,0,0
28031,2019-07-27,445,0,445,35,480,480,0,0
28032,2019-07-27,1815,0,1815,145,1960,1960,0,0
28033,2019-07-27,908,0,908,72,980,980,0,0
28034,2019-07-27,713,0,713,57,770,770,0,0
28035,2019-07-27,343,0,343,27,370,370,0,0
28036,2019-07-27,306,0,306,24,330,330,0,0
28037,2019-07-27,908,0,908,72,980,0,0,980
28038,2019-07-27,1056,0,1056,84,1140,1140,0,0
28039,2019-07-27,741,0,741,59,800,800,0,0
28040,2019-07-27,1436,0,1436,114,1550,1550,0,0
28041,2019-07-27,1388,0,1388,102,1490,1490,0,0
28042,2019-07-27,1815,0,1815,145,1960,1960,0,0
28043,2019-07-27,334,0,334,26,360,360,0,0
28044,2019-07-27,639,0,639,51,690,690,0,0
28045,2019-07-27,695,0,695,55,750,750,0,0
28046,2019-07-27,1815,0,1815,145,1960,0,0,1960
28047,2019-07-27,2056,0,2056,164,2220,2220,0,0
28048,2019-07-27,694,0,694,46,740,740,0,0
28049,2019-07-27,445,0,445,35,480,480,0,0
28050,2019-07-27,843,0,843,67,910,910,0,0
28051,2019-07-27,843,0,843,67,910,910,0,0
28052,2019-07-27,2260,0,2260,180,2440,2440,0,0
28053,2019-07-27,658,0,658,52,710,0,0,710
28054,2019-07-27,139,0,139,11,150,150,0,0
28055,2019-07-27,1399,0,1399,111,1510,1510,0,0
28056,2019-07-27,213,0,213,17,230,230,0,0
28057,2019-07-27,788,0,788,62,850,850,0,0
28058,2019-07-27,1834,0,1834,146,1980,1980,0,0
28059,2019-07-27,-1834,0,-1834,-146,-1980,-1980,0,0
28060,2019-07-27,2139,0,2139,171,2310,2310,0,0
28061,2019-07-27,1848,-198,1650,132,1782,1782,0,0
28062,2019-07-27,436,0,436,34,470,470,0,0
28063,2019-07-27,278,0,278,22,300,300,0,0
28064,2019-07-27,417,0,417,33,450,450,0,0
28065,2019-07-27,1186,0,1186,94,1280,1280,0,0
28066,2019-07-27,2639,0,2639,211,2850,2850,0,0
28067,2019-07-27,1334,0,1334,106,1440,1440,0,0
28068,2019-07-27,1575,0,1575,125,1700,1700,0,0
28069,2019-07-27,982,0,982,78,1060,1060,0,0
28070,2019-07-27,278,0,278,22,300,300,0,0
28071,2019-07-27,1288,0,1288,102,1390,1390,0,0
28072,2019-07-27,519,0,519,41,560,560,0,0
28073,2019-07-27,1575,0,1575,125,1700,1700,0,0
28074,2019-07-27,482,0,482,38,520,520,0,0
28075,2019-07-27,639,0,639,51,690,690,0,0
28076,2019-07-27,1575,0,1575,125,1700,1700,0,0
28077,2019-07-27,649,0,649,51,700,700,0,0
28078,2019-07-27,1575,0,1575,125,1700,1700,0,0
28079,2019-07-27,445,0,445,35,480,480,0,0
28080,2019-07-27,264,0,264,21,285,285,0,0
28081,2019-07-27,2278,0,2278,182,2460,2460,0,0
28082,2019-07-27,926,0,926,74,1000,1000,0,0
28083,2019-07-27,1666,0,1666,124,1790,1790,0,0
28084,2019-07-27,2084,0,2084,166,2250,0,2250,0
28085,2019-07-27,2019,0,2019,161,2180,0,2180,0
28086,2019-07-27,1584,0,1584,126,1710,1710,0,0
28087,2019-07-27,788,0,788,62,850,850,0,0
28088,2019-07-27,2038,0,2038,162,2200,0,2200,0
28089,2019-07-27,870,0,870,60,930,930,0,0
28090,2019-07-27,306,0,306,24,330,330,0,0
28091,2019-07-27,1583,0,1583,117,1700,1700,0,0
28092,2019-07-27,935,0,935,65,1000,1000,0,0
28093,2019-07-27,1186,0,1186,94,1280,1280,0,0
28094,2019-07-27,473,0,473,37,510,510,0,0
28095,2019-07-27,343,0,343,27,370,370,0,0
28096,2019-07-27,315,0,315,25,340,340,0,0
28097,2019-07-27,630,0,630,50,680,680,0,0
28098,2019-07-27,251,0,251,19,270,270,0,0
28099,2019-07-27,251,0,251,19,270,0,0,270
28100,2019-07-27,-251,0,-251,-19,-270,-270,0,0
28101,2019-07-27,518,0,518,32,550,550,0,0
28102,2019-07-27,1343,0,1343,107,1450,1450,0,0
28103,2019-07-27,712,0,712,48,760,760,0,0
28104,2019-07-27,2723,0,2723,217,2940,2940,0,0
28105,2019-07-27,936,0,936,74,1010,1010,0,0
28106,2019-07-27,1436,0,1436,114,1550,1550,0,0
28107,2019-07-27,825,0,825,65,890,890,0,0
28108,2019-07-27,269,0,269,21,290,290,0,0
28109,2019-07-27,1084,0,1084,86,1170,1170,0,0
28110,2019-07-27,926,0,926,74,1000,1000,0,0
28111,2019-07-27,1815,0,1815,145,1960,1960,0,0
28112,2019-07-27,1815,0,1815,145,1960,1960,0,0
28113,2019-07-27,852,0,852,68,920,920,0,0
28114,2019-07-27,260,0,260,20,280,0,0,280
28115,2019-07-27,1112,0,1112,88,1200,1200,0,0
28116,2019-07-27,389,0,389,31,420,420,0,0
28117,2019-07-27,288,0,288,22,310,310,0,0
28118,2019-07-27,232,0,232,18,250,250,0,0
28119,2019-07-27,416,0,416,24,440,440,0,0
28120,2019-07-27,731,0,731,49,780,780,0,0
28121,2019-07-27,676,0,676,54,730,730,0,0
28122,2019-07-27,445,0,445,35,480,480,0,0
28123,2019-07-27,491,0,491,39,530,530,0,0
28124,2019-07-27,519,0,519,41,560,560,0,0
28125,2019-07-27,834,0,834,66,900,900,0,0
28126,2019-07-27,851,0,851,59,910,910,0,0
28127,2019-07-27,2130,0,2130,170,2300,2300,0,0
28128,2019-07-27,547,0,547,43,590,590,0,0
28129,2019-07-27,611,0,611,39,650,650,0,0
28130,2019-07-27,788,0,788,62,850,850,0,0
28131,2019-07-27,463,0,463,37,500,500,0,0
28132,2019-07-27,834,0,834,66,900,900,0,0
28133,2019-07-27,686,0,686,54,740,740,0,0
28134,2019-07-27,1463,0,1463,117,1580,1580,0,0
28135,2019-07-27,612,0,612,48,660,660,0,0
28136,2019-07-27,463,0,463,37,500,500,0,0
28137,2019-07-27,371,0,371,29,400,400,0,0
28138,2019-07-27,371,0,371,29,400,400,0,0
28139,2019-07-27,260,0,260,20,280,280,0,0
28140,2019-07-27,167,0,167,13,180,180,0,0
28141,2019-07-27,1538,0,1538,122,1660,1660,0,0
28142,2019-07-27,1473,0,1473,117,1590,1590,0,0
28143,2019-07-27,519,0,519,41,560,560,0,0
28144,2019-07-27,1538,0,1538,122,1660,1660,0,0
28145,2019-07-27,112,0,112,8,120,120,0,0
28146,2019-07-27,139,0,139,11,150,150,0,0
28147,2019-07-27,2348,0,2348,187,2535,2535,0,0
28148,2019-07-27,649,0,649,51,700,700,0,0
28149,2019-07-27,1240,0,1240,90,1330,1330,0,0
28150,2019-07-27,749,0,749,51,800,800,0,0
28151,2019-07-27,445,0,445,35,480,480,0,0
28152,2019-07-27,1538,0,1538,122,1660,1660,0,0
28153,2019-07-27,5028,0,5028,402,5430,0,5430,0
28154,2019-07-27,232,0,232,18,250,250,0,0
28155,2019-07-27,732,0,732,58,790,790,0,0
28156,2019-07-27,788,0,788,62,850,850,0,0
28157,2019-07-27,501,0,501,39,540,540,0,0
28158,2019-07-27,500,0,500,40,540,540,0,0
28159,2019-07-27,899,0,899,71,970,970,0,0
28160,2019-07-27,334,0,334,26,360,360,0,0
28161,2019-07-27,1417,0,1417,113,1530,1530,0,0
28162,2019-07-27,768,0,768,52,820,820,0,0
28163,2019-07-27,519,0,519,41,560,560,0,0
28164,2019-07-27,676,0,676,54,730,730,0,0
28165,2019-07-27,612,0,612,48,660,660,0,0
28166,2019-07-27,501,0,501,39,540,540,0,0
28167,2019-07-27,139,0,139,11,150,150,0,0
28168,2019-07-27,1121,0,1121,89,1210,1210,0,0
28169,2019-07-27,4121,0,4121,329,4450,4450,0,0
28170,2019-07-27,1463,0,1463,117,1580,1580,0,0
28171,2019-07-27,399,0,399,31,430,430,0,0
28172,2019-07-27,371,0,371,29,400,400,0,0
28173,2019-07-27,510,0,510,40,550,550,0,0
28174,2019-07-27,232,0,232,18,250,250,0,0
28175,2019-07-27,2685,0,2685,205,2890,2890,0,0
28176,2019-07-27,1602,0,1602,128,1730,0,1730,0
28177,2019-07-27,704,0,704,56,760,760,0,0
28178,2019-07-27,575,0,575,45,620,620,0,0
28179,2019-07-27,334,0,334,26,360,360,0,0
28180,2019-07-27,223,0,223,17,240,240,0,0
28181,2019-07-27,271,-29,242,19,261,261,0,0
28182,2019-07-27,639,0,639,51,690,690,0,0
28183,2019-07-27,797,0,797,63,860,860,0,0
28184,2019-07-27,1575,0,1575,125,1700,1700,0,0
28185,2019-07-27,278,0,278,22,300,300,0,0
28186,2019-07-27,1575,0,1575,125,1700,1700,0,0
28187,2019-07-27,343,0,343,27,370,370,0,0
28188,2019-07-27,3019,0,3019,241,3260,3260,0,0
28189,2019-07-27,2408,0,2408,192,2600,2600,0,0
28190,2019-07-27,1334,0,1334,106,1440,1440,0,0
28191,2019-07-27,139,0,139,11,150,150,0,0
28192,2019-07-27,1621,0,1621,129,1750,1750,0,0
28193,2019-07-27,1649,0,1649,131,1780,1780,0,0
28194,2019-07-27,343,0,343,27,370,370,0,0
28195,2019-07-27,1575,0,1575,125,1700,1700,0,0
28196,2019-07-27,575,0,575,45,620,620,0,0
28197,2019-07-27,1510,0,1510,120,1630,0,1630,0
28198,2019-07-27,888,0,888,62,950,950,0,0
28199,2019-07-27,713,0,713,57,770,770,0,0
28200,2019-07-27,788,0,788,62,850,850,0,0
28201,2019-07-27,584,0,584,46,630,630,0,0
28202,2019-07-27,167,0,167,13,180,180,0,0
28203,2019-07-27,2362,0,2362,188,2550,0,2550,0
28204,2019-07-27,1575,0,1575,125,1700,1700,0,0
28205,2019-07-27,1575,0,1575,125,1700,1700,0,0
28206,2019-07-27,1462,0,1462,108,1570,0,1570,0
28207,2019-07-27,926,0,926,74,1000,1000,0,0
28208,2019-07-27,1575,0,1575,125,1700,1700,0,0
28209,2019-07-27,945,0,945,75,1020,1020,0,0
28210,2019-07-27,463,0,463,37,500,0,500,0
28211,2019-07-27,1880,0,1880,150,2030,2030,0,0
28212,2019-07-27,584,0,584,46,630,630,0,0
28213,2019-07-27,612,0,612,48,660,660,0,0
28214,2019-07-27,1786,0,1786,134,1920,0,1920,0
28215,2019-07-27,945,0,945,75,1020,1020,0,0
28216,2019-07-27,945,0,945,75,1020,1020,0,0
28217,2019-07-27,1333,0,1333,97,1430,1430,0,0
28218,2019-07-27,1047,0,1047,83,1130,1130,0,0
28219,2019-07-27,760,0,760,60,820,820,0,0
28220,2019-07-27,1473,0,1473,117,1590,1590,0,0
28221,2019-07-27,1028,0,1028,82,1110,1110,0,0
28222,2019-07-27,362,0,362,28,390,390,0,0
28223,2019-07-27,1575,0,1575,125,1700,1700,0,0
28224,2019-07-27,908,0,908,72,980,980,0,0
28225,2019-07-27,482,0,482,38,520,520,0,0
28226,2019-07-27,491,0,491,39,530,530,0,0
28227,2019-07-27,649,0,649,51,700,700,0,0
28228,2019-07-27,315,0,315,25,340,340,0,0
28229,2019-07-27,181,0,181,14,195,195,0,0
28230,2019-07-28,1482,0,1482,118,1600,1600,0,0
28231,2019-07-28,1815,0,1815,145,1960,0,1960,0
28232,2019-07-28,908,0,908,72,980,980,0,0
28233,2019-07-28,1815,0,1815,145,1960,1960,0,0
28234,2019-07-28,362,0,362,28,390,390,0,0
28235,2019-07-28,2102,0,2102,168,2270,2270,0,0
28236,2019-07-28,1445,0,1445,115,1560,1560,0,0
28237,2019-07-28,1815,0,1815,145,1960,1960,0,0
28238,2019-07-28,232,0,232,18,250,250,0,0
28239,2019-07-28,2575,0,2575,205,2780,2780,0,0
28240,2019-07-28,288,0,288,22,310,310,0,0
28241,2019-07-28,1075,0,1075,85,1160,1160,0,0
28242,2019-07-28,1741,0,1741,139,1880,1880,0,0
28243,2019-07-28,797,0,797,63,860,860,0,0
28244,2019-07-28,908,0,908,72,980,980,0,0
28245,2019-07-28,1954,0,1954,156,2110,2110,0,0
28246,2019-07-28,385,0,385,30,415,415,0,0
28247,2019-07-28,1176,0,1176,94,1270,1270,0,0
28248,2019-07-28,778,0,778,62,840,840,0,0
28249,2019-07-28,1454,0,1454,116,1570,1570,0,0
28250,2019-07-28,908,0,908,72,980,980,0,0
28251,2019-07-28,704,0,704,56,760,760,0,0
28252,2019-07-28,788,0,788,62,850,850,0,0
28253,2019-07-28,806,0,806,64,870,870,0,0
28254,2019-07-28,695,0,695,55,750,750,0,0
28255,2019-07-28,547,0,547,43,590,590,0,0
28256,2019-07-28,556,0,556,44,600,600,0,0
28257,2019-07-28,1575,0,1575,125,1700,1700,0,0
28258,2019-07-28,1547,0,1547,123,1670,1670,0,0
28259,2019-07-28,408,0,408,32,440,440,0,0
28260,2019-07-28,1019,0,1019,81,1100,1100,0,0
28261,2019-07-28,954,0,954,76,1030,1030,0,0
28262,2019-07-28,399,0,399,31,430,430,0,0
28263,2019-07-28,399,0,399,31,430,430,0,0
28264,2019-07-28,463,0,463,37,500,500,0,0
28265,2019-07-28,1306,0,1306,104,1410,0,1410,0
28266,2019-07-28,1613,-172,1441,107,1548,1548,0,0
28267,2019-07-28,1186,0,1186,94,1280,1280,0,0
28268,2019-07-28,417,0,417,33,450,450,0,0
28269,2019-07-28,-1884,201,-1683,-126,-1809,-1809,0,0
28270,2019-07-28,963,0,963,77,1040,1040,0,0
28271,2019-07-28,649,0,649,51,700,700,0,0
28272,2019-07-28,519,0,519,41,560,560,0,0
28273,2019-07-28,1815,0,1815,145,1960,1960,0,0
28274,2019-07-28,463,0,463,37,500,0,0,500
28275,2019-07-28,704,0,704,56,760,0,760,0
28276,2019-07-28,417,0,417,33,450,450,0,0
28277,2019-07-28,871,0,871,69,940,940,0,0
28278,2019-07-28,379,0,379,21,400,400,0,0
28279,2019-07-28,788,0,788,62,850,850,0,0
28280,2019-07-28,355,-38,317,25,342,342,0,0
28281,2019-07-28,593,0,593,47,640,0,0,640
28282,2019-07-28,1204,0,1204,96,1300,1300,0,0
28283,2019-07-28,612,0,612,48,660,660,0,0
28284,2019-07-28,685,0,685,45,730,730,0,0
28285,2019-07-28,-1613,172,-1441,-107,-1548,-1548,0,0
28286,2019-07-28,1028,0,1028,82,1110,1110,0,0
28287,2019-07-28,334,0,334,26,360,360,0,0
28288,2019-07-28,583,0,583,37,620,620,0,0
28289,2019-07-28,908,0,908,72,980,980,0,0
28290,2019-07-28,1288,0,1288,102,1390,1390,0,0
28291,2019-07-28,482,0,482,38,520,520,0,0
28292,2019-07-28,139,0,139,11,150,150,0,0
28293,2019-07-28,176,0,176,14,190,190,0,0
28294,2019-07-28,888,0,888,62,950,950,0,0
28295,2019-07-28,223,0,223,17,240,240,0,0
28296,2019-07-28,908,0,908,72,980,980,0,0
28297,2019-07-28,4167,0,4167,333,4500,0,4500,0
28298,2019-07-28,1084,0,1084,86,1170,1170,0,0
28299,2019-07-28,482,0,482,38,520,520,0,0
28300,2019-07-28,1538,0,1538,122,1660,1660,0,0
28301,2019-07-28,1884,-201,1683,126,1809,1809,0,0
28302,2019-07-28,1613,-172,1441,107,1548,1548,0,0
28303,2019-07-28,334,0,334,26,360,360,0,0
28304,2019-07-28,778,0,778,62,840,840,0,0
28305,2019-07-28,343,0,343,27,370,370,0,0
28306,2019-07-28,149,0,149,11,160,160,0,0
28307,2019-07-28,676,0,676,54,730,730,0,0
28308,2019-07-28,676,0,676,54,730,730,0,0
28309,2019-07-28,-676,0,-676,-54,-730,-730,0,0
28310,2019-07-28,3565,0,3565,285,3850,0,3850,0
28311,2019-07-28,36297,0,36297,2903,39200,39200,0,0
28312,2019-07-28,916,0,916,64,980,980,0,0
28313,2019-07-28,926,0,926,74,1000,1000,0,0
28314,2019-07-28,167,0,167,13,180,180,0,0
28315,2019-07-28,769,0,769,61,830,830,0,0
28316,2019-07-28,204,0,204,16,220,220,0,0
28317,2019-07-28,1038,0,1038,82,1120,1120,0,0
28318,2019-07-28,399,0,399,31,430,430,0,0
28319,2019-07-28,767,0,767,43,810,810,0,0
28320,2019-07-28,917,0,917,73,990,990,0,0
28321,2019-07-28,621,0,621,49,670,670,0,0
28322,2019-07-28,371,0,371,29,400,400,0,0
28323,2019-07-28,204,0,204,16,220,220,0,0
28324,2019-07-28,499,0,499,31,530,530,0,0
28325,2019-07-28,1797,0,1797,143,1940,1940,0,0
28326,2019-07-28,1056,0,1056,84,1140,0,1140,0
28327,2019-07-28,667,0,667,53,720,720,0,0
28328,2019-07-28,889,0,889,71,960,960,0,0
28329,2019-07-28,1815,0,1815,145,1960,1960,0,0
28330,2019-07-28,1149,0,1149,91,1240,1240,0,0
28331,2019-07-28,269,0,269,21,290,290,0,0
28332,2019-07-28,751,0,751,59,810,810,0,0
28333,2019-07-28,491,0,491,39,530,0,0,530
28334,2019-07-28,399,0,399,31,430,430,0,0
28335,2019-07-28,260,0,260,20,280,280,0,0
28336,2019-07-28,278,0,278,22,300,300,0,0
28337,2019-07-28,297,0,297,23,320,320,0,0
28338,2019-07-28,556,0,556,44,600,600,0,0
28339,2019-07-28,639,0,639,51,690,690,0,0
28340,2019-07-28,630,0,630,50,680,680,0,0
28341,2019-07-28,538,0,538,42,580,580,0,0
28342,2019-07-28,584,0,584,46,630,630,0,0
28343,2019-07-28,278,0,278,22,300,300,0,0
28344,2019-07-28,1575,0,1575,125,1700,1700,0,0
28345,2019-07-28,602,0,602,48,650,650,0,0
28346,2019-07-28,389,0,389,31,420,420,0,0
28347,2019-07-28,1575,0,1575,125,1700,1700,0,0
28348,2019-07-28,676,0,676,54,730,730,0,0
28349,2019-07-28,232,0,232,18,250,250,0,0
28350,2019-07-28,760,0,760,60,820,820,0,0
28351,2019-07-28,362,0,362,28,390,390,0,0
28352,2019-07-28,1056,0,1056,84,1140,1140,0,0
28353,2019-07-28,880,0,880,70,950,950,0,0
28354,2019-07-28,343,0,343,27,370,370,0,0
28355,2019-07-28,1852,0,1852,148,2000,2000,0,0
28356,2019-07-28,575,0,575,45,620,620,0,0
28357,2019-07-28,1001,0,1001,79,1080,1080,0,0
28358,2019-07-28,352,0,352,28,380,380,0,0
28359,2019-07-28,695,0,695,55,750,750,0,0
28360,2019-07-28,695,0,695,55,750,750,0,0
28361,2019-07-28,408,0,408,32,440,440,0,0
28362,2019-07-28,1445,0,1445,115,1560,1560,0,0
28363,2019-07-28,352,0,352,28,380,380,0,0
28364,2019-07-28,1056,0,1056,84,1140,1140,0,0
28365,2019-07-28,232,0,232,18,250,250,0,0
28366,2019-07-28,523,-56,467,37,504,504,0,0
28367,2019-07-28,269,0,269,21,290,290,0,0
28368,2019-07-28,362,0,362,28,390,390,0,0
28369,2019-07-28,255,0,255,20,275,275,0,0
28370,2019-07-28,234,-25,209,16,225,225,0,0
28371,2019-07-28,1760,0,1760,140,1900,1900,0,0
28372,2019-07-28,417,0,417,33,450,450,0,0
28373,2019-07-28,334,0,334,26,360,360,0,0
28374,2019-07-28,297,0,297,23,320,320,0,0
28375,2019-07-28,575,0,575,45,620,620,0,0
28376,2019-07-28,297,0,297,23,320,320,0,0
28377,2019-07-28,788,0,788,62,850,850,0,0
28378,2019-07-28,843,0,843,67,910,910,0,0
28379,2019-07-28,788,0,788,62,850,850,0,0
28380,2019-07-29,1815,0,1815,145,1960,1960,0,0
28381,2019-07-29,1936,0,1936,154,2090,2090,0,0
28382,2019-07-29,1815,0,1815,145,1960,1960,0,0
28383,2019-07-29,1815,0,1815,145,1960,1960,0,0
28384,2019-07-29,584,0,584,46,630,630,0,0
28385,2019-07-29,908,0,908,72,980,0,0,980
28386,2019-07-29,1815,0,1815,145,1960,1960,0,0
28387,2019-07-29,788,0,788,62,850,850,0,0
28388,2019-07-29,1815,0,1815,145,1960,1960,0,0
28389,2019-07-29,747,-80,667,53,720,720,0,0
28390,2019-07-29,1417,0,1417,113,1530,0,1530,0
28391,2019-07-29,1547,0,1547,123,1670,0,0,1670
28392,2019-07-29,1361,0,1361,99,1460,1460,0,0
28393,2019-07-29,306,0,306,24,330,330,0,0
28394,2019-07-29,908,0,908,72,980,980,0,0
28395,2019-07-29,473,0,473,37,510,510,0,0
28396,2019-07-29,913,0,913,72,985,985,0,0
28397,2019-07-29,1102,0,1102,88,1190,1190,0,0
28398,2019-07-29,417,0,417,33,450,450,0,0
28399,2019-07-29,510,0,510,40,550,550,0,0
28400,2019-07-29,260,0,260,20,280,280,0,0
28401,2019-07-29,1501,0,1501,119,1620,1620,0,0
28402,2019-07-29,343,0,343,27,370,370,0,0
28403,2019-07-29,704,0,704,56,760,760,0,0
28404,2019-07-29,371,0,371,29,400,400,0,0
28405,2019-07-29,362,0,362,28,390,390,0,0
28406,2019-07-29,973,0,973,77,1050,1050,0,0
28407,2019-07-29,908,0,908,72,980,980,0,0
28408,2019-07-29,491,0,491,39,530,530,0,0
28409,2019-07-29,1149,0,1149,91,1240,1240,0,0
28410,2019-07-29,565,0,565,45,610,610,0,0
28411,2019-07-29,1815,0,1815,145,1960,1960,0,0
28412,2019-07-29,1101,0,1101,79,1180,1180,0,0
28413,2019-07-29,676,0,676,54,730,730,0,0
28414,2019-07-29,954,0,954,76,1030,1030,0,0
28415,2019-07-29,1241,0,1241,99,1340,1340,0,0
28416,2019-07-29,167,0,167,13,180,180,0,0
28417,2019-07-29,908,0,908,72,980,980,0,0
28418,2019-07-29,519,0,519,41,560,560,0,0
28419,2019-07-29,639,0,639,51,690,690,0,0
28420,2019-07-29,3593,0,3593,287,3880,3880,0,0
28421,2019-07-29,538,0,538,42,580,580,0,0
28422,2019-07-29,713,0,713,57,770,770,0,0
28423,2019-07-29,1167,0,1167,93,1260,1260,0,0
28424,2019-07-29,523,-56,467,37,504,504,0,0
28425,2019-07-29,862,0,862,68,930,930,0,0
28426,2019-07-29,232,0,232,18,250,250,0,0
28427,2019-07-29,786,0,786,54,840,840,0,0
28428,2019-07-29,467,-50,417,33,450,450,0,0
28429,2019-07-29,936,0,936,74,1010,1010,0,0
28430,2019-07-29,269,0,269,21,290,290,0,0
28431,2019-07-29,1667,0,1667,133,1800,1800,0,0
28432,2019-07-29,93,0,93,7,100,100,0,0
28433,2019-07-29,430,-46,384,30,414,414,0,0
28434,2019-07-29,1575,0,1575,125,1700,1700,0,0
28435,2019-07-29,278,0,278,22,300,300,0,0
28436,2019-07-29,139,0,139,11,150,150,0,0
28437,2019-07-29,278,0,278,22,300,300,0,0
28438,2019-07-29,186,0,186,14,200,200,0,0
28439,2019-07-29,695,0,695,55,750,750,0,0
28440,2019-07-29,1231,0,1231,89,1320,1320,0,0
28441,2019-07-29,1055,0,1055,75,1130,1130,0,0
28442,2019-07-29,389,0,389,31,420,420,0,0
28443,2019-07-29,399,0,399,31,430,430,0,0
28444,2019-07-29,1204,0,1204,96,1300,1300,0,0
28445,2019-07-29,234,-25,209,16,225,225,0,0
28446,2019-07-29,399,0,399,31,430,430,0,0
28447,2019-07-29,204,0,204,16,220,220,0,0
28448,2019-07-29,334,0,334,26,360,360,0,0
28449,2019-07-29,1454,0,1454,116,1570,0,1570,0
28450,2019-07-29,501,0,501,39,540,540,0,0
28451,2019-07-29,47,0,47,3,50,50,0,0
28452,2019-07-29,2695,0,2695,215,2910,2910,0,0
28453,2019-07-29,306,0,306,24,330,330,0,0
28454,2019-07-29,297,0,297,23,320,320,0,0
28455,2019-07-29,1436,0,1436,114,1550,1550,0,0
28456,2019-07-29,491,0,491,39,530,530,0,0
28457,2019-07-29,751,0,751,59,810,810,0,0
28458,2019-07-29,234,-25,209,16,225,225,0,0
28459,2019-07-29,556,0,556,44,600,600,0,0
28460,2019-07-29,704,0,704,56,760,760,0,0
28461,2019-07-29,1501,0,1501,119,1620,1620,0,0
28462,2019-07-29,167,0,167,13,180,180,0,0
28463,2019-07-29,630,0,630,50,680,680,0,0
28464,2019-07-29,426,0,426,34,460,460,0,0
28465,2019-07-29,630,0,630,50,680,680,0,0
28466,2019-07-29,1092,-117,975,78,1053,1053,0,0
28467,2019-07-29,1093,0,1093,87,1180,1180,0,0
28468,2019-07-29,2362,0,2362,188,2550,2550,0,0
28469,2019-07-29,612,0,612,48,660,660,0,0
28470,2019-07-29,1241,0,1241,99,1340,1340,0,0
28471,2019-07-29,2362,0,2362,188,2550,0,0,2550
28472,2019-07-29,269,0,269,21,290,290,0,0
28473,2019-07-29,936,0,936,74,1010,1010,0,0
28474,2019-07-29,195,0,195,15,210,210,0,0
28475,2019-07-29,260,0,260,20,280,280,0,0
28476,2019-07-29,880,0,880,70,950,0,0,950
28477,2019-07-29,1575,0,1575,125,1700,1700,0,0
28478,2019-07-29,1288,0,1288,102,1390,1390,0,0
28479,2019-07-29,528,0,528,42,570,570,0,0
28480,2019-07-29,621,0,621,49,670,670,0,0
28481,2019-07-29,1065,0,1065,85,1150,1150,0,0
28482,2019-07-29,1139,0,1139,91,1230,1230,0,0
28483,2019-07-29,695,0,695,55,750,750,0,0
28484,2019-07-29,2362,0,2362,188,2550,2550,0,0
28485,2019-07-30,343,0,343,27,370,370,0,0
28486,2019-07-30,713,0,713,57,770,770,0,0
28487,2019-07-30,695,0,695,55,750,750,0,0
28488,2019-07-30,593,0,593,47,640,640,0,0
28489,2019-07-30,56,0,56,4,60,60,0,0
28490,2019-07-30,510,0,510,40,550,550,0,0
28491,2019-07-30,639,0,639,51,690,690,0,0
28492,2019-07-30,167,0,167,13,180,180,0,0
28493,2019-07-30,435,0,435,25,460,460,0,0
28494,2019-07-30,556,0,556,44,600,600,0,0
28495,2019-07-30,167,0,167,13,180,180,0,0
28496,2019-07-30,704,0,704,56,760,760,0,0
28497,2019-07-30,278,0,278,22,300,300,0,0
28498,2019-07-30,851,0,851,59,910,910,0,0
28499,2019-07-30,916,0,916,64,980,980,0,0
28500,2019-07-30,436,0,436,34,470,470,0,0
28501,2019-07-30,778,0,778,62,840,840,0,0
28502,2019-07-30,260,0,260,20,280,280,0,0
28503,2019-07-30,741,0,741,59,800,800,0,0
28504,2019-07-30,473,0,473,37,510,510,0,0
28505,2019-07-30,306,0,306,24,330,330,0,0
28506,2019-07-30,713,0,713,57,770,770,0,0
28507,2019-07-30,751,0,751,59,810,810,0,0
28508,2019-07-30,500,0,500,40,540,540,0,0
28509,2019-07-30,2010,0,2010,160,2170,0,2170,0
28510,2019-07-30,75,0,75,5,80,80,0,0
28511,2019-07-30,241,0,241,19,260,260,0,0
28512,2019-07-30,454,0,454,36,490,490,0,0
28513,2019-07-30,491,0,491,39,530,530,0,0
28514,2019-07-30,1001,0,1001,79,1080,1080,0,0
28515,2019-07-30,658,0,658,52,710,710,0,0
28516,2019-07-30,362,0,362,28,390,390,0,0
28517,2019-07-30,1047,0,1047,83,1130,1130,0,0
28518,2019-07-30,352,0,352,28,380,380,0,0
28519,2019-07-30,2325,0,2325,185,2510,2510,0,0
28520,2019-07-30,139,0,139,11,150,150,0,0
28521,2019-07-30,371,0,371,29,400,400,0,0
28522,2019-07-30,130,0,130,10,140,140,0,0
28523,2019-07-30,741,0,741,59,800,800,0,0
28524,2019-07-30,982,0,982,78,1060,0,1060,0
28525,2019-07-30,1158,0,1158,92,1250,1250,0,0
28526,2019-07-31,621,0,621,49,670,670,0,0
28527,2019-07-31,269,0,269,21,290,290,0,0
28528,2019-07-31,1482,0,1482,118,1600,1600,0,0
28529,2019-07-31,408,0,408,32,440,440,0,0
28530,2019-07-31,584,0,584,46,630,630,0,0
28531,2019-07-31,250,0,250,20,270,270,0,0
28532,2019-07-31,1651,-176,1475,109,1584,1584,0,0
28533,2019-07-31,564,0,564,36,600,600,0,0
28534,2019-07-31,463,0,463,37,500,500,0,0
28535,2019-07-31,825,0,825,65,890,890,0,0
28536,2019-07-31,760,0,760,60,820,820,0,0
28537,2019-07-31,362,0,362,28,390,390,0,0
28538,2019-07-31,498,0,498,22,520,520,0,0
28539,2019-07-31,575,0,575,45,620,620,0,0
28540,2019-07-31,1973,0,1973,157,2130,2130,0,0
28541,2019-07-31,306,0,306,24,330,330,0,0
28542,2019-07-31,963,0,963,77,1040,1040,0,0
28543,2019-07-31,445,0,445,35,480,480,0,0
28544,2019-07-31,2084,0,2084,166,2250,2250,0,0
28545,2019-07-31,501,0,501,39,540,540,0,0
28546,2019-07-31,1815,0,1815,145,1960,1960,0,0
28547,2019-07-31,778,0,778,62,840,840,0,0
28548,2019-07-31,260,0,260,20,280,280,0,0
28549,2019-07-31,788,0,788,62,850,850,0,0
28550,2019-07-31,945,0,945,75,1020,1020,0,0
28551,2019-07-31,666,0,666,44,710,710,0,0
28552,2019-07-31,1195,0,1195,95,1290,1290,0,0
28553,2019-07-31,501,0,501,39,540,540,0,0
28554,2019-07-31,436,0,436,34,470,470,0,0
28555,2019-07-31,806,0,806,64,870,870,0,0
28556,2019-07-31,1528,0,1528,122,1650,0,0,1650
28557,2019-07-31,445,0,445,35,480,480,0,0
28558,2019-07-31,908,0,908,72,980,980,0,0
28559,2019-07-31,2028,0,2028,162,2190,0,2190,0
28560,2019-07-31,945,0,945,75,1020,1020,0,0
28561,2019-07-31,399,0,399,31,430,430,0,0
28562,2019-07-31,1186,0,1186,94,1280,1280,0,0
28563,2019-07-31,430,-46,384,30,414,414,0,0
28564,2019-07-31,454,0,454,36,490,490,0,0
28565,2019-07-31,334,0,334,26,360,360,0,0
28566,2019-07-31,713,0,713,57,770,770,0,0
28567,2019-07-31,575,0,575,45,620,620,0,0
28568,2019-07-31,1575,0,1575,125,1700,1700,0,0
28569,2019-07-31,362,0,362,28,390,390,0,0
28570,2019-07-31,-1065,0,-1065,-85,-1150,-1150,0,0
28571,2019-07-31,1065,0,1065,85,1150,1150,0,0
28572,2019-07-31,1065,0,1065,85,1150,1150,0,0
28573,2019-07-31,491,0,491,39,530,0,530,0
28574,2019-07-31,1575,0,1575,125,1700,1700,0,0
28575,2019-07-31,815,0,815,65,880,880,0,0
28576,2019-07-31,788,0,788,62,850,850,0,0
28577,2019-07-31,167,0,167,13,180,180,0,0
28578,2019-07-31,195,0,195,15,210,210,0,0
28579,2019-07-31,2306,0,2306,184,2490,0,2490,0
28580,2019-07-31,871,0,871,69,940,940,0,0
28581,2019-07-31,3075,0,3075,245,3320,3320,0,0
28582,2019-07-31,825,0,825,65,890,890,0,0
28583,2019-07-31,862,0,862,68,930,930,0,0
28584,2019-07-31,936,0,936,74,1010,1010,0,0
28585,2019-07-31,343,0,343,27,370,370,0,0
28586,2019-07-31,-788,0,-788,-62,-850,-850,0,0
28587,2019-07-31,259,0,259,11,270,0,270,0
28588,2019-07-31,2389,0,2389,191,2580,2580,0,0
28589,2019-07-31,760,0,760,60,820,820,0,0
28590,2019-07-31,264,-56,208,16,224,224,0,0
28591,2019-07-31,834,0,834,66,900,900,0,0
28592,2019-07-31,704,0,704,56,760,760,0,0
28593,2019-07-31,1001,0,1001,79,1080,1080,0,0
28594,2019-07-31,834,0,834,66,900,0,0,900
28595,2019-07-31,269,0,269,21,290,290,0,0
28596,2019-07-31,1065,0,1065,85,1150,1150,0,0
28597,2019-07-31,741,0,741,59,800,800,0,0
28598,2019-07-31,775,-83,692,55,747,747,0,0
28599,2019-07-31,732,0,732,58,790,790,0,0
28600,2019-07-31,269,0,269,21,290,290,0,0
28601,2019-07-31,584,0,584,46,630,630,0,0
28602,2019-07-31,1408,0,1408,112,1520,1520,0,0
28603,2019-07-31,334,0,334,26,360,360,0,0
28604,2019-07-31,880,0,880,70,950,950,0,0
28605,2019-08-01,908,0,908,72,980,980,0,0
28606,2019-08-01,510,0,510,40,550,550,0,0
28607,2019-08-01,841,-90,751,59,810,0,0,810
28608,2019-08-01,1010,0,1010,80,1090,1090,0,0
28609,2019-08-01,908,0,908,72,980,980,0,0
28610,2019-08-01,732,0,732,58,790,790,0,0
28611,2019-08-01,528,0,528,42,570,570,0,0
28612,2019-08-01,2806,0,2806,224,3030,3030,0,0
28613,2019-08-01,1241,0,1241,99,1340,1340,0,0
28614,2019-08-01,1815,0,1815,145,1960,0,1960,0
28615,2019-08-01,334,0,334,26,360,360,0,0
28616,2019-08-01,1269,0,1269,101,1370,1370,0,0
28617,2019-08-01,232,0,232,18,250,250,0,0
28618,2019-08-01,538,0,538,42,580,580,0,0
28619,2019-08-01,1019,0,1019,81,1100,1100,0,0
28620,2019-08-01,611,0,611,39,650,650,0,0
28621,2019-08-01,788,0,788,62,850,850,0,0
28622,2019-08-01,788,0,788,62,850,850,0,0
28623,2019-08-01,454,0,454,36,490,0,490,0
28624,2019-08-01,908,0,908,72,980,980,0,0
28625,2019-08-01,852,0,852,68,920,920,0,0
28626,2019-08-01,908,0,908,72,980,980,0,0
28627,2019-08-01,908,0,908,72,980,980,0,0
28628,2019-08-01,926,0,926,74,1000,1000,0,0
28629,2019-08-01,1001,0,1001,79,1080,1080,0,0
28630,2019-08-01,1112,0,1112,88,1200,1200,0,0
28631,2019-08-01,547,0,547,43,590,590,0,0
28632,2019-08-01,547,0,547,43,590,590,0,0
28633,2019-08-01,213,0,213,17,230,230,0,0
28634,2019-08-01,482,0,482,38,520,520,0,0
28635,2019-08-01,1047,0,1047,83,1130,1130,0,0
28636,2019-08-01,1436,0,1436,114,1550,1550,0,0
28637,2019-08-01,908,0,908,72,980,980,0,0
28638,2019-08-01,602,0,602,48,650,0,0,650
28639,2019-08-01,232,0,232,18,250,250,0,0
28640,2019-08-01,1815,0,1815,145,1960,1960,0,0
28641,2019-08-01,879,0,879,61,940,940,0,0
28642,2019-08-01,1815,0,1815,145,1960,1960,0,0
28643,2019-08-01,667,0,667,53,720,720,0,0
28644,2019-08-01,908,0,908,72,980,980,0,0
28645,2019-08-01,991,0,991,79,1070,1070,0,0
28646,2019-08-01,1942,-208,1734,138,1872,1872,0,0
28647,2019-08-01,333,0,333,17,350,350,0,0
28648,2019-08-01,1473,0,1473,117,1590,1590,0,0
28649,2019-08-01,991,0,991,79,1070,1070,0,0
28650,2019-08-01,760,0,760,60,820,820,0,0
28651,2019-08-01,306,0,306,24,330,330,0,0
28652,2019-08-01,788,0,788,62,850,850,0,0
28653,2019-08-01,2362,0,2362,188,2550,2550,0,0
28654,2019-08-01,260,0,260,20,280,280,0,0
28655,2019-08-01,260,0,260,20,280,280,0,0
28656,2019-08-01,880,0,880,70,950,950,0,0
28657,2019-08-01,945,0,945,75,1020,1020,0,0
28658,2019-08-01,1556,0,1556,124,1680,0,0,1680
28659,2019-08-01,1084,0,1084,86,1170,0,1170,0
28660,2019-08-01,917,0,917,73,990,990,0,0
28661,2019-08-01,953,0,953,67,1020,0,1020,0
28662,2019-08-01,110,0,110,0,110,110,0,0
28663,2019-08-01,491,0,491,39,530,530,0,0
28664,2019-08-01,519,0,519,41,560,560,0,0
28665,2019-08-01,352,0,352,28,380,380,0,0
28666,2019-08-01,1315,0,1315,105,1420,1420,0,0
28667,2019-08-01,352,0,352,28,380,380,0,0
28668,2019-08-01,334,0,334,26,360,360,0,0
28669,2019-08-01,332,0,332,8,340,340,0,0
28670,2019-08-01,417,0,417,33,450,450,0,0
28671,2019-08-01,139,0,139,11,150,150,0,0
28672,2019-08-01,898,0,898,62,960,960,0,0
28673,2019-08-01,1054,0,1054,66,1120,1120,0,0
28674,2019-08-01,1575,0,1575,125,1700,1700,0,0
28675,2019-08-01,649,0,649,51,700,700,0,0
28676,2019-08-01,168,-18,150,12,162,162,0,0
28677,2019-08-01,501,0,501,39,540,540,0,0
28678,2019-08-01,1186,0,1186,94,1280,1280,0,0
28679,2019-08-01,241,0,241,19,260,260,0,0
28680,2019-08-01,371,0,371,29,400,400,0,0
28681,2019-08-01,249,0,249,11,260,260,0,0
28682,2019-08-01,371,0,371,29,400,400,0,0
28683,2019-08-01,556,0,556,44,600,600,0,0
28684,2019-08-01,3149,0,3149,251,3400,3400,0,0
28685,2019-08-01,2362,0,2362,188,2550,2550,0,0
28686,2019-08-01,667,0,667,53,720,720,0,0
28687,2019-08-01,1667,0,1667,133,1800,1800,0,0
28688,2019-08-01,788,0,788,62,850,850,0,0
28689,2019-08-01,491,0,491,39,530,530,0,0
28690,2019-08-01,278,0,278,22,300,300,0,0
28691,2019-08-01,1269,0,1269,101,1370,1370,0,0
28692,2019-08-01,1001,0,1001,79,1080,1080,0,0
28693,2019-08-01,389,0,389,31,420,420,0,0
28694,2019-08-01,306,0,306,24,330,330,0,0
28695,2019-08-01,139,0,139,11,150,150,0,0
28696,2019-08-01,713,0,713,57,770,770,0,0
28697,2019-08-01,1112,0,1112,88,1200,1200,0,0
28698,2019-08-01,538,0,538,42,580,580,0,0
28699,2019-08-01,2889,0,2889,231,3120,3120,0,0
28700,2019-08-01,1436,0,1436,114,1550,1550,0,0
28701,2019-08-01,676,0,676,54,730,730,0,0
28702,2019-08-02,371,0,371,29,400,400,0,0
28703,2019-08-02,1815,0,1815,145,1960,1960,0,0
28704,2019-08-02,1519,0,1519,121,1640,0,0,1640
28705,2019-08-02,528,0,528,42,570,570,0,0
28706,2019-08-02,602,0,602,48,650,650,0,0
28707,2019-08-02,260,0,260,20,280,280,0,0
28708,2019-08-02,1149,-123,1026,81,1107,1107,0,0
28709,2019-08-02,1491,0,1491,119,1610,1610,0,0
28710,2019-08-02,547,0,547,43,590,590,0,0
28711,2019-08-02,1751,0,1751,139,1890,1890,0,0
28712,2019-08-02,760,0,760,60,820,820,0,0
28713,2019-08-02,334,0,334,26,360,360,0,0
28714,2019-08-02,1075,0,1075,85,1160,1160,0,0
28715,2019-08-02,908,0,908,72,980,980,0,0
28716,2019-08-02,908,0,908,72,980,980,0,0
28717,2019-08-02,251,0,251,19,270,270,0,0
28718,2019-08-02,288,0,288,22,310,310,0,0
28719,2019-08-02,584,0,584,46,630,630,0,0
28720,2019-08-02,1889,0,1889,151,2040,2040,0,0
28721,2019-08-02,629,0,629,41,670,670,0,0
28722,2019-08-02,788,0,788,62,850,850,0,0
28723,2019-08-02,3010,0,3010,240,3250,3250,0,0
28724,2019-08-02,926,0,926,74,1000,1000,0,0
28725,2019-08-02,805,0,805,55,860,860,0,0
28726,2019-08-02,167,0,167,13,180,180,0,0
28727,2019-08-02,305,0,305,15,320,320,0,0
28728,2019-08-02,528,0,528,42,570,570,0,0
28729,2019-08-02,676,0,676,54,730,730,0,0
28730,2019-08-02,1028,0,1028,82,1110,1110,0,0
28731,2019-08-02,639,0,639,51,690,690,0,0
28732,2019-08-02,268,0,268,12,280,280,0,0
28733,2019-08-02,426,0,426,34,460,460,0,0
28734,2019-08-02,1899,0,1899,151,2050,2050,0,0
28735,2019-08-02,936,0,936,74,1010,1010,0,0
28736,2019-08-02,852,0,852,68,920,920,0,0
28737,2019-08-02,1307,-140,1167,93,1260,1260,0,0
28738,2019-08-02,2084,0,2084,166,2250,2250,0,0
28739,2019-08-02,1056,0,1056,84,1140,1140,0,0
28740,2019-08-02,232,0,232,18,250,250,0,0
28741,2019-08-02,778,0,778,62,840,840,0,0
28742,2019-08-02,1830,-196,1634,130,1764,1764,0,0
28743,2019-08-02,491,0,491,39,530,530,0,0
28744,2019-08-02,676,0,676,54,730,730,0,0
28745,2019-08-02,399,0,399,31,430,430,0,0
28746,2019-08-02,1019,0,1019,81,1100,1100,0,0
28747,2019-08-02,399,0,399,31,430,430,0,0
28748,2019-08-02,806,0,806,64,870,870,0,0
28749,2019-08-02,3204,0,3204,256,3460,3460,0,0
28750,2019-08-02,232,0,232,18,250,250,0,0
28751,2019-08-02,1954,0,1954,156,2110,2110,0,0
28752,2019-08-02,519,0,519,41,560,560,0,0
28753,2019-08-02,389,0,389,31,420,420,0,0
28754,2019-08-02,1954,0,1954,156,2110,2110,0,0
28755,2019-08-02,352,0,352,28,380,380,0,0
28756,2019-08-02,501,0,501,39,540,540,0,0
28757,2019-08-02,565,0,565,45,610,610,0,0
28758,2019-08-02,1288,0,1288,102,1390,1390,0,0
28759,2019-08-02,1093,0,1093,87,1180,0,1180,0
28760,2019-08-02,2038,0,2038,162,2200,0,2200,0
28761,2019-08-02,1278,0,1278,102,1380,1380,0,0
28762,2019-08-02,1019,0,1019,81,1100,1100,0,0
28763,2019-08-02,1889,0,1889,151,2040,2040,0,0
28764,2019-08-02,510,0,510,40,550,550,0,0
28765,2019-08-02,575,0,575,45,620,620,0,0
28766,2019-08-02,463,0,463,37,500,500,0,0
28767,2019-08-02,621,0,621,49,670,670,0,0
28768,2019-08-02,2204,0,2204,176,2380,2380,0,0
28769,2019-08-02,389,0,389,31,420,420,0,0
28770,2019-08-02,352,0,352,28,380,380,0,0
28771,2019-08-02,760,0,760,60,820,820,0,0
28772,2019-08-02,760,0,760,60,820,820,0,0
28773,2019-08-02,1639,0,1639,131,1770,1770,0,0
28774,2019-08-02,269,0,269,21,290,290,0,0
28775,2019-08-02,297,0,297,23,320,320,0,0
28776,2019-08-02,991,0,991,79,1070,1070,0,0
28777,2019-08-02,862,0,862,68,930,930,0,0
28778,2019-08-02,442,0,442,8,450,450,0,0
28779,2019-08-02,135,0,135,10,145,145,0,0
28780,2019-08-02,510,0,510,40,550,550,0,0
28781,2019-08-02,565,0,565,45,610,610,0,0
28782,2019-08-02,612,0,612,48,660,660,0,0
28783,2019-08-02,116,0,116,9,125,125,0,0
28784,2019-08-02,1584,0,1584,126,1710,1710,0,0
28785,2019-08-02,1028,0,1028,82,1110,1110,0,0
28786,2019-08-02,973,0,973,77,1050,0,1050,0
28787,2019-08-02,278,0,278,22,300,300,0,0
28788,2019-08-02,-389,0,-389,-31,-420,-420,0,0
28789,2019-08-02,556,0,556,44,600,600,0,0
28790,2019-08-02,1472,0,1472,108,1580,1580,0,0
28791,2019-08-02,1038,0,1038,82,1120,1120,0,0
28792,2019-08-02,788,0,788,62,850,850,0,0
28793,2019-08-02,1852,0,1852,148,2000,2000,0,0
28794,2019-08-02,389,0,389,31,420,420,0,0
28795,2019-08-02,1575,0,1575,125,1700,1700,0,0
28796,2019-08-02,788,0,788,62,850,850,0,0
28797,2019-08-02,723,0,723,57,780,780,0,0
28798,2019-08-02,556,0,556,44,600,600,0,0
28799,2019-08-02,1010,0,1010,80,1090,1090,0,0
28800,2019-08-02,991,0,991,79,1070,1070,0,0
28801,2019-08-02,445,0,445,35,480,480,0,0
28802,2019-08-02,2362,0,2362,188,2550,2550,0,0
28803,2019-08-02,2463,0,2463,197,2660,2660,0,0
28804,2019-08-02,389,0,389,31,420,420,0,0
28805,2019-08-02,880,0,880,70,950,950,0,0
28806,2019-08-02,362,0,362,28,390,0,390,0
28807,2019-08-02,626,0,626,49,675,675,0,0
28808,2019-08-02,1399,0,1399,111,1510,1510,0,0
28809,2019-08-03,1575,0,1575,125,1700,1700,0,0
28810,2019-08-03,538,0,538,42,580,580,0,0
28811,2019-08-03,-1315,0,-1315,-105,-1420,-1420,0,0
28812,2019-08-03,426,0,426,34,460,460,0,0
28813,2019-08-03,1019,0,1019,81,1100,1100,0,0
28814,2019-08-03,1575,0,1575,125,1700,1700,0,0
28815,2019-08-03,1315,0,1315,105,1420,1420,0,0
28816,2019-08-03,1575,0,1575,125,1700,1700,0,0
28817,2019-08-03,1343,0,1343,107,1450,1450,0,0
28818,2019-08-03,1251,0,1251,99,1350,1350,0,0
28819,2019-08-03,1315,0,1315,105,1420,1420,0,0
28820,2019-08-03,1889,0,1889,151,2040,0,2040,0
28821,2019-08-03,630,0,630,50,680,680,0,0
28822,2019-08-03,899,0,899,71,970,970,0,0
28823,2019-08-03,306,0,306,24,330,330,0,0
28824,2019-08-03,389,0,389,31,420,420,0,0
28825,2019-08-03,602,0,602,48,650,650,0,0
28826,2019-08-03,1575,0,1575,125,1700,1700,0,0
28827,2019-08-03,741,0,741,59,800,0,800,0
28828,2019-08-03,1010,0,1010,80,1090,1090,0,0
28829,2019-08-03,139,0,139,11,150,150,0,0
28830,2019-08-03,769,0,769,61,830,830,0,0
28831,2019-08-03,139,0,139,11,150,0,0,150
28832,2019-08-03,751,0,751,59,810,0,0,810
28833,2019-08-03,740,0,740,50,790,790,0,0
28834,2019-08-03,695,0,695,55,750,750,0,0
28835,2019-08-03,788,0,788,62,850,850,0,0
28836,2019-08-03,676,0,676,54,730,730,0,0
28837,2019-08-03,1575,0,1575,125,1700,1700,0,0
28838,2019-08-03,1019,0,1019,81,1100,1100,0,0
28839,2019-08-03,1575,0,1575,125,1700,1700,0,0
28840,2019-08-03,1575,0,1575,125,1700,1700,0,0
28841,2019-08-03,871,0,871,69,940,940,0,0
28842,2019-08-03,1852,0,1852,148,2000,2000,0,0
28843,2019-08-03,1852,0,1852,148,2000,2000,0,0
28844,2019-08-03,4352,0,4352,348,4700,4700,0,0
28845,2019-08-03,1167,0,1167,93,1260,1260,0,0
28846,2019-08-03,1575,0,1575,125,1700,1700,0,0
28847,2019-08-03,556,0,556,44,600,600,0,0
28848,2019-08-03,3149,0,3149,251,3400,3400,0,0
28849,2019-08-03,426,0,426,34,460,460,0,0
28850,2019-08-03,1575,0,1575,125,1700,1700,0,0
28851,2019-08-03,463,0,463,37,500,500,0,0
28852,2019-08-03,1575,0,1575,125,1700,1700,0,0
28853,2019-08-03,2175,0,2175,165,2340,2340,0,0
28854,2019-08-03,1575,0,1575,125,1700,1700,0,0
28855,2019-08-03,306,0,306,24,330,330,0,0
28856,2019-08-03,1575,0,1575,125,1700,1700,0,0
28857,2019-08-03,667,0,667,53,720,720,0,0
28858,2019-08-03,788,0,788,62,850,850,0,0
28859,2019-08-03,334,0,334,26,360,360,0,0
28860,2019-08-03,4028,0,4028,322,4350,4350,0,0
28861,2019-08-03,510,0,510,40,550,550,0,0
28862,2019-08-03,538,0,538,42,580,580,0,0
28863,2019-08-03,204,0,204,16,220,220,0,0
28864,2019-08-03,788,0,788,62,850,850,0,0
28865,2019-08-03,788,0,788,62,850,850,0,0
28866,2019-08-03,945,0,945,75,1020,1020,0,0
28867,2019-08-03,417,0,417,33,450,450,0,0
28868,2019-08-03,149,0,149,11,160,160,0,0
28869,2019-08-03,362,0,362,28,390,390,0,0
28870,2019-08-03,1297,0,1297,103,1400,1400,0,0
28871,2019-08-03,862,0,862,68,930,930,0,0
28872,2019-08-03,260,0,260,20,280,280,0,0
28873,2019-08-03,408,0,408,32,440,440,0,0
28874,2019-08-03,908,0,908,72,980,980,0,0
28875,2019-08-03,797,0,797,63,860,860,0,0
28876,2019-08-03,1376,0,1376,109,1485,1485,0,0
28877,2019-08-03,186,0,186,14,200,0,200,0
28878,2019-08-03,2510,0,2510,200,2710,2710,0,0
28879,2019-08-03,1815,0,1815,145,1960,0,1960,0
28880,2019-08-03,1001,0,1001,79,1080,1080,0,0
28881,2019-08-03,1815,0,1815,145,1960,1960,0,0
28882,2019-08-03,260,0,260,20,280,280,0,0
28883,2019-08-03,760,0,760,60,820,0,820,0
28884,2019-08-03,306,0,306,24,330,330,0,0
28885,2019-08-03,527,0,527,33,560,560,0,0
28886,2019-08-03,1064,0,1064,76,1140,1140,0,0
28887,2019-08-03,1334,0,1334,106,1440,1440,0,0
28888,2019-08-03,1639,0,1639,131,1770,1770,0,0
28889,2019-08-03,277,0,277,13,290,290,0,0
28890,2019-08-03,232,0,232,18,250,250,0,0
28891,2019-08-03,519,0,519,41,560,0,560,0
28892,2019-08-03,760,0,760,60,820,0,820,0
28893,2019-08-03,269,0,269,21,290,290,0,0
28894,2019-08-03,1649,0,1649,131,1780,0,1780,0
28895,2019-08-03,495,-53,442,35,477,477,0,0
28896,2019-08-03,1334,0,1334,106,1440,1440,0,0
28897,2019-08-03,1297,0,1297,103,1400,1400,0,0
28898,2019-08-03,852,0,852,68,920,920,0,0
28899,2019-08-03,686,0,686,54,740,740,0,0
28900,2019-08-03,908,0,908,72,980,980,0,0
28901,2019-08-03,1556,0,1556,124,1680,1680,0,0
28902,2019-08-03,1204,0,1204,96,1300,1300,0,0
28903,2019-08-03,408,0,408,32,440,440,0,0
28904,2019-08-03,1463,0,1463,117,1580,1580,0,0
28905,2019-08-03,361,0,361,19,380,380,0,0
28906,2019-08-03,843,0,843,67,910,910,0,0
28907,2019-08-03,306,0,306,24,330,330,0,0
28908,2019-08-03,297,0,297,23,320,320,0,0
28909,2019-08-03,695,0,695,55,750,750,0,0
28910,2019-08-03,1463,0,1463,117,1580,1580,0,0
28911,2019-08-03,250,0,250,20,270,270,0,0
28912,2019-08-03,473,0,473,37,510,510,0,0
28913,2019-08-03,426,0,426,34,460,460,0,0
28914,2019-08-03,426,0,426,34,460,460,0,0
28915,2019-08-03,797,0,797,63,860,860,0,0
28916,2019-08-03,491,0,491,39,530,530,0,0
28917,2019-08-03,1056,0,1056,84,1140,1140,0,0
28918,2019-08-03,556,0,556,44,600,600,0,0
28919,2019-08-03,815,0,815,65,880,880,0,0
28920,2019-08-03,1760,0,1760,140,1900,1900,0,0
28921,2019-08-03,362,0,362,28,390,390,0,0
28922,2019-08-03,2149,0,2149,171,2320,0,0,2320
28923,2019-08-03,1204,0,1204,96,1300,1300,0,0
28924,2019-08-03,945,0,945,75,1020,1020,0,0
28925,2019-08-03,408,0,408,32,440,440,0,0
28926,2019-08-03,556,0,556,44,600,0,600,0
28927,2019-08-03,908,0,908,72,980,980,0,0
28928,2019-08-03,741,0,741,59,800,0,0,800
28929,2019-08-03,1852,0,1852,148,2000,0,2000,0
28930,2019-08-03,1047,0,1047,83,1130,1130,0,0
28931,2019-08-03,1369,0,1369,91,1460,1460,0,0
28932,2019-08-03,889,0,889,71,960,960,0,0
28933,2019-08-03,417,0,417,33,450,450,0,0
28934,2019-08-03,1491,0,1491,119,1610,1610,0,0
28935,2019-08-03,973,0,973,77,1050,0,0,1050
28936,2019-08-03,1186,0,1186,94,1280,1280,0,0
28937,2019-08-03,249,0,249,11,260,260,0,0
28938,2019-08-03,1047,0,1047,83,1130,1130,0,0
28939,2019-08-03,454,0,454,36,490,490,0,0
28940,2019-08-03,871,0,871,69,940,940,0,0
28941,2019-08-03,991,0,991,79,1070,1070,0,0
28942,2019-08-03,501,0,501,39,540,540,0,0
28943,2019-08-03,1038,0,1038,82,1120,1120,0,0
28944,2019-08-03,110,0,110,0,110,110,0,0
28945,2019-08-03,751,0,751,59,810,810,0,0
28946,2019-08-03,232,0,232,18,250,250,0,0
28947,2019-08-03,630,0,630,50,680,680,0,0
28948,2019-08-03,454,0,454,36,490,490,0,0
28949,2019-08-03,371,0,371,29,400,0,0,400
28950,2019-08-03,732,0,732,58,790,790,0,0
28951,2019-08-03,1334,0,1334,106,1440,1440,0,0
28952,2019-08-03,686,0,686,54,740,740,0,0
28953,2019-08-03,167,0,167,13,180,180,0,0
28954,2019-08-03,722,0,722,48,770,770,0,0
28955,2019-08-03,954,0,954,76,1030,0,1030,0
28956,2019-08-03,963,0,963,77,1040,1040,0,0
28957,2019-08-03,167,0,167,13,180,180,0,0
28958,2019-08-03,259,0,259,11,270,270,0,0
28959,2019-08-03,889,0,889,71,960,960,0,0
28960,2019-08-03,982,0,982,78,1060,1060,0,0
28961,2019-08-03,399,0,399,31,430,430,0,0
28962,2019-08-03,1612,0,1612,128,1740,1740,0,0
28963,2019-08-03,169565,0,169565,13565,183130,183130,0,0
28964,2019-08-03,843,0,843,67,910,910,0,0
28965,2019-08-03,954,0,954,76,1030,1030,0,0
28966,2019-08-03,167,0,167,13,180,180,0,0
28967,2019-08-03,553,0,553,17,570,570,0,0
28968,2019-08-03,1166,0,1166,84,1250,1250,0,0
28969,2019-08-03,834,0,834,66,900,900,0,0
28970,2019-08-03,1815,0,1815,145,1960,1960,0,0
28971,2019-08-03,982,0,982,78,1060,1060,0,0
28972,2019-08-03,1241,0,1241,99,1340,1340,0,0
28973,2019-08-03,473,0,473,37,510,510,0,0
28974,2019-08-03,251,0,251,19,270,0,270,0
28975,2019-08-03,778,0,778,62,840,840,0,0
28976,2019-08-03,269,0,269,21,290,290,0,0
28977,2019-08-03,547,0,547,43,590,0,590,0
28978,2019-08-03,788,0,788,62,850,850,0,0
28979,2019-08-03,1778,0,1778,142,1920,1920,0,0
28980,2019-08-03,1112,0,1112,88,1200,1200,0,0
28981,2019-08-03,880,0,880,70,950,950,0,0
28982,2019-08-03,945,0,945,75,1020,1020,0,0
28983,2019-08-03,806,0,806,64,870,870,0,0
28984,2019-08-03,399,0,399,31,430,430,0,0
28985,2019-08-03,806,0,806,64,870,870,0,0
28986,2019-08-03,260,0,260,20,280,280,0,0
28987,2019-08-03,788,0,788,62,850,850,0,0
28988,2019-08-03,510,0,510,40,550,550,0,0
28989,2019-08-03,288,0,288,22,310,310,0,0
28990,2019-08-03,389,0,389,31,420,420,0,0
28991,2019-08-03,186,0,186,14,200,200,0,0
28992,2019-08-03,528,0,528,42,570,570,0,0
28993,2019-08-03,260,0,260,20,280,280,0,0
28994,2019-08-03,288,0,288,22,310,310,0,0
28995,2019-08-03,251,0,251,19,270,270,0,0
28996,2019-08-03,232,0,232,18,250,250,0,0
28997,2019-08-03,1010,0,1010,80,1090,1090,0,0
28998,2019-08-03,769,0,769,61,830,830,0,0
28999,2019-08-03,251,0,251,19,270,270,0,0
29000,2019-08-03,519,0,519,41,560,560,0,0
29001,2019-08-03,686,0,686,54,740,740,0,0
29002,2019-08-03,713,0,713,57,770,770,0,0
29003,2019-08-03,297,0,297,23,320,320,0,0
29004,2019-08-03,1176,0,1176,94,1270,1270,0,0
29005,2019-08-03,139,0,139,11,150,150,0,0
29006,2019-08-03,236,-50,186,14,200,200,0,0
29007,2019-08-03,1195,0,1195,95,1290,1290,0,0
29008,2019-08-03,1593,0,1593,127,1720,1720,0,0
29009,2019-08-03,305,0,305,15,320,320,0,0
29010,2019-08-03,2306,0,2306,184,2490,2490,0,0
29011,2019-08-03,232,0,232,18,250,250,0,0
29012,2019-08-03,538,0,538,42,580,580,0,0
29013,2019-08-03,926,0,926,74,1000,1000,0,0
29014,2019-08-03,936,0,936,74,1010,1010,0,0
29015,2019-08-03,638,0,638,42,680,680,0,0
29016,2019-08-03,278,0,278,22,300,300,0,0
29017,2019-08-03,528,0,528,42,570,570,0,0
29018,2019-08-03,575,0,575,45,620,620,0,0
29019,2019-08-03,260,0,260,20,280,280,0,0
29020,2019-08-03,1473,0,1473,117,1590,0,1590,0
29021,2019-08-03,380,0,380,30,410,410,0,0
29022,2019-08-03,519,0,519,41,560,560,0,0
29023,2019-08-03,1010,0,1010,80,1090,1090,0,0
29024,2019-08-03,1419,-152,1267,101,1368,1368,0,0
29025,2019-08-03,399,0,399,31,430,430,0,0
29026,2019-08-03,343,0,343,27,370,370,0,0
29027,2019-08-03,454,0,454,36,490,490,0,0
29028,2019-08-03,334,0,334,26,360,360,0,0
29029,2019-08-03,675,0,675,45,720,720,0,0
29030,2019-08-03,110,0,110,0,110,110,0,0
29031,2019-08-03,232,0,232,18,250,250,0,0
29032,2019-08-03,176,0,176,14,190,190,0,0
29033,2019-08-03,417,0,417,33,450,450,0,0
29034,2019-08-03,167,0,167,13,180,180,0,0
29035,2019-08-03,232,0,232,18,250,250,0,0
29036,2019-08-03,334,0,334,26,360,360,0,0
29037,2019-08-03,204,0,204,16,220,220,0,0
29038,2019-08-03,416,0,416,24,440,440,0,0
29039,2019-08-03,639,0,639,51,690,690,0,0
29040,2019-08-03,723,0,723,57,780,780,0,0
29041,2019-08-03,593,0,593,47,640,640,0,0
29042,2019-08-03,396,-84,312,24,336,336,0,0
29043,2019-08-03,408,0,408,32,440,440,0,0
29044,2019-08-03,769,0,769,61,830,830,0,0
29045,2019-08-03,343,0,343,27,370,370,0,0
29046,2019-08-03,706,-150,556,44,600,600,0,0
29047,2019-08-03,417,0,417,33,450,450,0,0
29048,2019-08-03,556,0,556,44,600,600,0,0
29049,2019-08-03,719,-77,642,51,693,693,0,0
29050,2019-08-03,1167,0,1167,93,1260,1260,0,0
29051,2019-08-03,232,0,232,18,250,250,0,0
29052,2019-08-03,250,0,250,20,270,270,0,0
29053,2019-08-04,565,0,565,45,610,610,0,0
29054,2019-08-04,723,0,723,57,780,780,0,0
29055,2019-08-04,788,0,788,62,850,850,0,0
29056,2019-08-04,453,0,453,27,480,480,0,0
29057,2019-08-04,712,0,712,48,760,0,760,0
29058,2019-08-04,1453,0,1453,107,1560,1560,0,0
29059,2019-08-04,371,0,371,29,400,400,0,0
29060,2019-08-04,573,0,573,37,610,610,0,0
29061,2019-08-04,269,0,269,21,290,290,0,0
29062,2019-08-04,667,0,667,53,720,720,0,0
29063,2019-08-04,1084,0,1084,86,1170,0,1170,0
29064,2019-08-04,1389,0,1389,111,1500,1500,0,0
29065,2019-08-04,2232,0,2232,178,2410,2410,0,0
29066,2019-08-04,1815,0,1815,145,1960,1960,0,0
29067,2019-08-04,1065,0,1065,85,1150,1150,0,0
29068,2019-08-04,556,0,556,44,600,600,0,0
29069,2019-08-04,362,0,362,28,390,390,0,0
29070,2019-08-04,630,0,630,50,680,680,0,0
29071,2019-08-04,1250,0,1250,100,1350,1350,0,0
29072,2019-08-04,747,-80,667,53,720,720,0,0
29073,2019-08-04,436,0,436,34,470,470,0,0
29074,2019-08-04,704,0,704,56,760,760,0,0
29075,2019-08-04,1815,0,1815,145,1960,1960,0,0
29076,2019-08-04,463,0,463,37,500,500,0,0
29077,2019-08-04,445,0,445,35,480,480,0,0
29078,2019-08-04,519,0,519,41,560,560,0,0
29079,2019-08-04,1315,0,1315,105,1420,1420,0,0
29080,2019-08-04,871,0,871,69,940,940,0,0
29081,2019-08-04,482,0,482,38,520,520,0,0
29082,2019-08-04,1377,0,1377,83,1460,1460,0,0
29083,2019-08-04,167,0,167,13,180,180,0,0
29084,2019-08-04,616,0,616,49,665,665,0,0
29085,2019-08-04,889,0,889,71,960,960,0,0
29086,2019-08-04,3084,0,3084,246,3330,3330,0,0
29087,2019-08-04,982,0,982,78,1060,1060,0,0
29088,2019-08-04,445,0,445,35,480,480,0,0
29089,2019-08-04,519,0,519,41,560,560,0,0
29090,2019-08-04,501,0,501,39,540,540,0,0
29091,2019-08-04,1241,0,1241,99,1340,1340,0,0
29092,2019-08-04,774,0,774,61,835,835,0,0
29093,2019-08-04,389,0,389,31,420,420,0,0
29094,2019-08-04,1815,0,1815,145,1960,1960,0,0
29095,2019-08-04,1667,0,1667,133,1800,1800,0,0
29096,2019-08-04,852,0,852,68,920,920,0,0
29097,2019-08-04,723,0,723,57,780,780,0,0
29098,2019-08-04,1306,0,1306,104,1410,1410,0,0
29099,2019-08-04,501,0,501,39,540,540,0,0
29100,2019-08-04,954,0,954,76,1030,1030,0,0
29101,2019-08-04,973,0,973,77,1050,1050,0,0
29102,2019-08-04,908,0,908,72,980,980,0,0
29103,2019-08-04,908,0,908,72,980,980,0,0
29104,2019-08-04,1815,0,1815,145,1960,1960,0,0
29105,2019-08-04,260,0,260,20,280,280,0,0
29106,2019-08-04,149,0,149,11,160,160,0,0
29107,2019-08-04,2483,-266,2217,177,2394,2394,0,0
29108,2019-08-04,463,0,463,37,500,500,0,0
29109,2019-08-04,232,0,232,18,250,250,0,0
29110,2019-08-04,612,0,612,48,660,660,0,0
29111,2019-08-04,1371,0,1371,109,1480,1480,0,0
29112,2019-08-04,1343,0,1343,107,1450,1450,0,0
29113,2019-08-04,973,0,973,77,1050,1050,0,0
29114,2019-08-04,334,0,334,26,360,360,0,0
29115,2019-08-04,917,0,917,73,990,990,0,0
29116,2019-08-04,778,0,778,62,840,840,0,0
29117,2019-08-04,463,0,463,37,500,500,0,0
29118,2019-08-04,167,0,167,13,180,180,0,0
29119,2019-08-04,704,0,704,56,760,760,0,0
29120,2019-08-04,1621,0,1621,129,1750,1750,0,0
29121,2019-08-04,260,0,260,20,280,280,0,0
29122,2019-08-04,621,0,621,49,670,670,0,0
29123,2019-08-04,112,0,112,8,120,120,0,0
29124,2019-08-04,463,0,463,37,500,500,0,0
29125,2019-08-04,3399,0,3399,271,3670,0,3670,0
29126,2019-08-04,371,0,371,29,400,400,0,0
29127,2019-08-04,2019,0,2019,161,2180,2180,0,0
29128,2019-08-04,917,0,917,73,990,990,0,0
29129,2019-08-04,2045,-219,1826,145,1971,1971,0,0
29130,2019-08-04,667,0,667,53,720,720,0,0
29131,2019-08-04,621,0,621,49,670,670,0,0
29132,2019-08-04,1899,0,1899,151,2050,2050,0,0
29133,2019-08-04,2306,0,2306,184,2490,2490,0,0
29134,2019-08-04,364,-39,325,26,351,351,0,0
29135,2019-08-04,454,0,454,36,490,490,0,0
29136,2019-08-04,1093,0,1093,87,1180,1180,0,0
29137,2019-08-04,139,0,139,11,150,150,0,0
29138,2019-08-04,528,0,528,42,570,570,0,0
29139,2019-08-04,1723,0,1723,137,1860,1860,0,0
29140,2019-08-04,3926,0,3926,314,4240,4240,0,0
29141,2019-08-04,1213,0,1213,97,1310,1310,0,0
29142,2019-08-04,362,0,362,28,390,390,0,0
29143,2019-08-04,325,0,325,25,350,350,0,0
29144,2019-08-04,362,0,362,28,390,390,0,0
29145,2019-08-04,889,0,889,71,960,960,0,0
29146,2019-08-04,1565,0,1565,125,1690,1690,0,0
29147,2019-08-04,649,0,649,51,700,700,0,0
29148,2019-08-04,334,0,334,26,360,360,0,0
29149,2019-08-04,1121,0,1121,89,1210,0,1210,0
29150,2019-08-04,751,0,751,59,810,810,0,0
29151,2019-08-04,167,0,167,13,180,180,0,0
29152,2019-08-04,639,0,639,51,690,690,0,0
29153,2019-08-04,880,0,880,70,950,950,0,0
29154,2019-08-04,917,0,917,73,990,990,0,0
29155,2019-08-04,306,0,306,24,330,330,0,0
29156,2019-08-04,389,0,389,31,420,0,420,0
29157,2019-08-04,593,0,593,47,640,640,0,0
29158,2019-08-04,917,0,917,73,990,990,0,0
29159,2019-08-04,371,0,371,29,400,400,0,0
29160,2019-08-04,1343,0,1343,107,1450,1450,0,0
29161,2019-08-04,325,0,325,25,350,350,0,0
29162,2019-08-04,945,0,945,75,1020,1020,0,0
29163,2019-08-04,250,0,250,20,270,270,0,0
29164,2019-08-04,788,0,788,62,850,850,0,0
29165,2019-08-04,788,0,788,62,850,850,0,0
29166,2019-08-04,223,0,223,17,240,240,0,0
29167,2019-08-05,639,0,639,51,690,690,0,0
29168,2019-08-05,426,0,426,34,460,460,0,0
29169,2019-08-05,862,0,862,68,930,930,0,0
29170,2019-08-05,908,0,908,72,980,980,0,0
29171,2019-08-05,166,0,166,4,170,170,0,0
29172,2019-08-05,491,0,491,39,530,530,0,0
29173,2019-08-05,1278,0,1278,102,1380,0,1380,0
29174,2019-08-05,538,0,538,42,580,580,0,0
29175,2019-08-05,223,0,223,17,240,240,0,0
29176,2019-08-05,1510,0,1510,120,1630,1630,0,0
29177,2019-08-05,1825,0,1825,145,1970,1970,0,0
29178,2019-08-05,547,0,547,43,590,590,0,0
29179,2019-08-05,2195,0,2195,175,2370,2370,0,0
29180,2019-08-05,639,0,639,51,690,690,0,0
29181,2019-08-05,778,0,778,62,840,840,0,0
29182,2019-08-05,2788,0,2788,222,3010,3010,0,0
29183,2019-08-05,491,0,491,39,530,530,0,0
29184,2019-08-05,788,0,788,62,850,850,0,0
29185,2019-08-05,1454,0,1454,116,1570,1570,0,0
29186,2019-08-05,2084,0,2084,166,2250,2250,0,0
29187,2019-08-05,667,0,667,53,720,720,0,0
29188,2019-08-05,593,0,593,47,640,640,0,0
29189,2019-08-05,1815,0,1815,145,1960,1960,0,0
29190,2019-08-05,417,0,417,33,450,450,0,0
29191,2019-08-05,501,0,501,39,540,540,0,0
29192,2019-08-05,915,-98,817,65,882,882,0,0
29193,2019-08-05,473,0,473,37,510,510,0,0
29194,2019-08-05,1343,0,1343,107,1450,1450,0,0
29195,2019-08-05,325,0,325,25,350,350,0,0
29196,2019-08-05,1149,0,1149,91,1240,1240,0,0
29197,2019-08-05,2723,0,2723,217,2940,2940,0,0
29198,2019-08-05,213,0,213,17,230,230,0,0
29199,2019-08-05,1862,0,1862,148,2010,2010,0,0
29200,2019-08-05,269,0,269,21,290,290,0,0
29201,2019-08-05,2034,0,2034,136,2170,2170,0,0
29202,2019-08-05,139,0,139,11,150,150,0,0
29203,2019-08-05,889,0,889,71,960,960,0,0
29204,2019-08-05,1038,0,1038,82,1120,1120,0,0
29205,2019-08-05,362,0,362,28,390,390,0,0
29206,2019-08-05,1232,-132,1100,88,1188,1188,0,0
29207,2019-08-05,880,0,880,70,950,950,0,0
29208,2019-08-05,482,0,482,38,520,520,0,0
29209,2019-08-05,325,0,325,25,350,350,0,0
29210,2019-08-05,1399,0,1399,111,1510,0,1510,0
29211,2019-08-05,575,0,575,45,620,620,0,0
29212,2019-08-05,2723,0,2723,217,2940,0,0,2940
29213,2019-08-05,149,0,149,11,160,160,0,0
29214,2019-08-05,167,0,167,13,180,180,0,0
29215,2019-08-05,1010,0,1010,80,1090,1090,0,0
29216,2019-08-05,1121,0,1121,89,1210,1210,0,0
29217,2019-08-05,908,0,908,72,980,980,0,0
29218,2019-08-05,649,0,649,51,700,700,0,0
29219,2019-08-05,454,0,454,36,490,490,0,0
29220,2019-08-05,1426,0,1426,114,1540,1540,0,0
29221,2019-08-05,1065,0,1065,85,1150,1150,0,0
29222,2019-08-05,3936,0,3936,314,4250,0,4250,0
29223,2019-08-05,778,0,778,62,840,840,0,0
29224,2019-08-05,306,0,306,24,330,330,0,0
29225,2019-08-05,695,0,695,55,750,750,0,0
29226,2019-08-05,797,0,797,63,860,860,0,0
29227,2019-08-05,1158,0,1158,92,1250,1250,0,0
29228,2019-08-05,899,0,899,71,970,970,0,0
29229,2019-08-05,1001,-210,791,49,840,840,0,0
29230,2019-08-05,675,0,675,45,720,720,0,0
29231,2019-08-05,834,0,834,66,900,900,0,0
29232,2019-08-05,260,0,260,20,280,280,0,0
29233,2019-08-05,110,0,110,0,110,110,0,0
29234,2019-08-05,973,0,973,77,1050,1050,0,0
29235,2019-08-05,1556,0,1556,124,1680,1680,0,0
29236,2019-08-05,288,0,288,22,310,310,0,0
29237,2019-08-05,501,0,501,39,540,540,0,0
29238,2019-08-05,871,0,871,69,940,940,0,0
29239,2019-08-05,1278,0,1278,102,1380,1380,0,0
29240,2019-08-05,593,0,593,47,640,640,0,0
29241,2019-08-05,778,0,778,62,840,840,0,0
29242,2019-08-05,481,0,481,29,510,510,0,0
29243,2019-08-05,277,0,277,13,290,290,0,0
29244,2019-08-05,788,0,788,62,850,850,0,0
29245,2019-08-05,260,0,260,20,280,280,0,0
29246,2019-08-05,1862,0,1862,148,2010,2010,0,0
29247,2019-08-05,463,0,463,37,500,500,0,0
29248,2019-08-05,612,0,612,48,660,660,0,0
29249,2019-08-05,1556,0,1556,124,1680,1680,0,0
29250,2019-08-05,1815,0,1815,145,1960,1960,0,0
29251,2019-08-05,473,0,473,37,510,510,0,0
29252,2019-08-05,454,0,454,36,490,490,0,0
29253,2019-08-05,528,0,528,42,570,570,0,0
29254,2019-08-05,1130,0,1130,90,1220,0,0,1220
29255,2019-08-05,815,0,815,65,880,880,0,0
29256,2019-08-05,667,0,667,53,720,720,0,0
29257,2019-08-05,840,-90,750,60,810,810,0,0
29258,2019-08-05,538,0,538,42,580,580,0,0
29259,2019-08-05,519,0,519,41,560,560,0,0
29260,2019-08-05,1426,0,1426,114,1540,1540,0,0
29261,2019-08-05,778,0,778,62,840,840,0,0
29262,2019-08-05,2149,0,2149,171,2320,2320,0,0
29263,2019-08-05,519,0,519,41,560,560,0,0
29264,2019-08-05,852,0,852,68,920,920,0,0
29265,2019-08-05,2362,0,2362,188,2550,2550,0,0
29266,2019-08-05,269,0,269,21,290,290,0,0
29267,2019-08-05,343,0,343,27,370,370,0,0
29268,2019-08-05,852,0,852,68,920,920,0,0
29269,2019-08-05,926,0,926,74,1000,1000,0,0
29270,2019-08-05,1176,0,1176,94,1270,1270,0,0
29271,2019-08-06,352,0,352,28,380,380,0,0
29272,2019-08-06,371,0,371,29,400,400,0,0
29273,2019-08-06,788,0,788,62,850,850,0,0
29274,2019-08-06,538,0,538,42,580,580,0,0
29275,2019-08-06,389,0,389,31,420,420,0,0
29276,2019-08-06,751,0,751,59,810,810,0,0
29277,2019-08-06,1338,0,1338,107,1445,1445,0,0
29278,2019-08-06,778,0,778,62,840,840,0,0
29279,2019-08-06,491,0,491,39,530,530,0,0
29280,2019-08-06,436,0,436,34,470,470,0,0
29281,2019-08-06,260,0,260,20,280,280,0,0
29282,2019-08-06,269,0,269,21,290,290,0,0
29283,2019-08-06,1297,0,1297,103,1400,1400,0,0
29284,2019-08-06,325,0,325,25,350,350,0,0
29285,2019-08-06,232,0,232,18,250,250,0,0
29286,2019-08-06,399,0,399,31,430,430,0,0
29287,2019-08-06,399,0,399,31,430,430,0,0
29288,2019-08-06,158,0,158,12,170,170,0,0
29289,2019-08-06,593,0,593,47,640,640,0,0
29290,2019-08-06,204,0,204,16,220,220,0,0
29291,2019-08-06,1112,0,1112,88,1200,1200,0,0
29292,2019-08-06,1065,0,1065,85,1150,1150,0,0
29293,2019-08-06,1158,0,1158,92,1250,1250,0,0
29294,2019-08-06,472,0,472,28,500,500,0,0
29295,2019-08-06,538,0,538,42,580,580,0,0
29296,2019-08-06,668,-142,526,42,568,568,0,0
29297,2019-08-06,121,0,121,9,130,130,0,0
29298,2019-08-06,260,0,260,20,280,280,0,0
29299,2019-08-06,260,0,260,20,280,280,0,0
29300,2019-08-06,389,0,389,31,420,420,0,0
29301,2019-08-06,538,0,538,42,580,580,0,0
29302,2019-08-06,260,0,260,20,280,280,0,0
29303,2019-08-06,389,0,389,31,420,420,0,0
29304,2019-08-06,426,0,426,34,460,460,0,0
29305,2019-08-06,334,0,334,26,360,360,0,0
29306,2019-08-06,1167,0,1167,93,1260,1260,0,0
29307,2019-08-06,47,0,47,3,50,50,0,0
29308,2019-08-06,1945,0,1945,155,2100,2100,0,0
29309,2019-08-06,297,0,297,23,320,320,0,0
29310,2019-08-06,1167,0,1167,93,1260,1260,0,0
29311,2019-08-06,639,0,639,51,690,690,0,0
29312,2019-08-06,880,0,880,70,950,950,0,0
29313,2019-08-06,436,0,436,34,470,470,0,0
29314,2019-08-07,1815,0,1815,145,1960,1960,0,0
29315,2019-08-07,925,0,925,65,990,990,0,0
29316,2019-08-07,889,0,889,71,960,960,0,0
29317,2019-08-07,315,0,315,25,340,340,0,0
29318,2019-08-07,1130,0,1130,90,1220,1220,0,0
29319,2019-08-07,2408,0,2408,192,2600,0,2600,0
29320,2019-08-07,1314,0,1314,96,1410,1410,0,0
29321,2019-08-07,556,0,556,44,600,600,0,0
29322,2019-08-07,908,0,908,72,980,980,0,0
29323,2019-08-07,593,0,593,47,640,0,0,640
29324,2019-08-07,908,0,908,72,980,980,0,0
29325,2019-08-07,1167,0,1167,93,1260,1260,0,0
29326,2019-08-07,621,0,621,49,670,670,0,0
29327,2019-08-07,158,0,158,12,170,170,0,0
29328,2019-08-07,1463,0,1463,117,1580,1580,0,0
29329,2019-08-07,602,0,602,48,650,650,0,0
29330,2019-08-07,1658,0,1658,132,1790,1790,0,0
29331,2019-08-07,389,0,389,31,420,420,0,0
29332,2019-08-07,908,0,908,72,980,980,0,0
29333,2019-08-07,334,0,334,26,360,360,0,0
29334,2019-08-07,1130,0,1130,90,1220,0,1220,0
29335,2019-08-07,463,0,463,37,500,500,0,0
29336,2019-08-07,1889,0,1889,151,2040,2040,0,0
29337,2019-08-07,1815,0,1815,145,1960,0,1960,0
29338,2019-08-07,898,0,898,62,960,960,0,0
29339,2019-08-07,695,0,695,55,750,750,0,0
29340,2019-08-07,695,0,695,55,750,750,0,0
29341,2019-08-07,908,0,908,72,980,980,0,0
29342,2019-08-07,908,0,908,72,980,980,0,0
29343,2019-08-07,908,0,908,72,980,980,0,0
29344,2019-08-07,1028,0,1028,82,1110,1110,0,0
29345,2019-08-07,269,0,269,21,290,290,0,0
29346,2019-08-07,1834,0,1834,146,1980,1980,0,0
29347,2019-08-07,167,0,167,13,180,180,0,0
29348,2019-08-07,260,0,260,20,280,280,0,0
29349,2019-08-07,269,0,269,21,290,290,0,0
29350,2019-08-07,1593,0,1593,127,1720,1720,0,0
29351,2019-08-07,1139,0,1139,91,1230,1230,0,0
29352,2019-08-07,612,0,612,48,660,660,0,0
29353,2019-08-07,245,-52,193,15,208,208,0,0
29354,2019-08-07,1445,0,1445,115,1560,1560,0,0
29355,2019-08-07,704,0,704,56,760,760,0,0
29356,2019-08-07,963,0,963,77,1040,1040,0,0
29357,2019-08-07,1815,0,1815,145,1960,1960,0,0
29358,2019-08-07,445,0,445,35,480,480,0,0
29359,2019-08-07,880,0,880,70,950,950,0,0
29360,2019-08-07,723,0,723,57,780,780,0,0
29361,2019-08-07,1362,0,1362,108,1470,1470,0,0
29362,2019-08-07,788,0,788,62,850,850,0,0
29363,2019-08-07,788,0,788,62,850,850,0,0
29364,2019-08-07,803,-86,717,57,774,774,0,0
29365,2019-08-07,1575,0,1575,125,1700,1700,0,0
29366,2019-08-07,4241,0,4241,339,4580,0,4580,0
29367,2019-08-07,343,0,343,27,370,370,0,0
29368,2019-08-07,1167,0,1167,93,1260,1260,0,0
29369,2019-08-07,871,0,871,69,940,940,0,0
29370,2019-08-07,1463,0,1463,117,1580,1580,0,0
29371,2019-08-07,788,0,788,62,850,0,850,0
29372,2019-08-07,1475,-158,1317,105,1422,1422,0,0
29373,2019-08-07,1575,0,1575,125,1700,1700,0,0
29374,2019-08-07,788,0,788,62,850,850,0,0
29375,2019-08-07,1575,0,1575,125,1700,1700,0,0
29376,2019-08-07,834,0,834,66,900,900,0,0
29377,2019-08-07,3149,0,3149,251,3400,3400,0,0
29378,2019-08-07,788,0,788,62,850,850,0,0
29379,2019-08-07,788,0,788,62,850,850,0,0
29380,2019-08-07,232,0,232,18,250,250,0,0
29381,2019-08-07,1575,0,1575,125,1700,1700,0,0
29382,2019-08-07,3630,0,3630,290,3920,3920,0,0
29383,2019-08-07,695,0,695,55,750,750,0,0
29384,2019-08-07,-788,0,-788,-62,-850,-850,0,0
29385,2019-08-07,306,0,306,24,330,330,0,0
29386,2019-08-07,139,0,139,11,150,0,150,0
29387,2019-08-07,760,0,760,60,820,820,0,0
29388,2019-08-07,269,0,269,21,290,290,0,0
29389,2019-08-07,1056,0,1056,84,1140,1140,0,0
29390,2019-08-07,778,0,778,62,840,840,0,0
29391,2019-08-07,611,0,611,39,650,650,0,0
29392,2019-08-07,463,0,463,37,500,500,0,0
29393,2019-08-07,362,0,362,28,390,390,0,0
29394,2019-08-07,658,0,658,52,710,710,0,0
29395,2019-08-07,593,0,593,47,640,640,0,0
29396,2019-08-07,723,0,723,57,780,780,0,0
29397,2019-08-07,250,0,250,20,270,270,0,0
29398,2019-08-07,778,0,778,62,840,840,0,0
29399,2019-08-07,575,0,575,45,620,620,0,0
29400,2019-08-07,297,0,297,23,320,320,0,0
29401,2019-08-07,556,0,556,44,600,600,0,0
29402,2019-08-07,260,0,260,20,280,280,0,0
29403,2019-08-08,491,0,491,39,530,530,0,0
29404,2019-08-08,908,0,908,72,980,980,0,0
29405,2019-08-08,3223,0,3223,257,3480,0,3480,0
29406,2019-08-08,547,0,547,43,590,590,0,0
29407,2019-08-08,649,0,649,51,700,700,0,0
29408,2019-08-08,871,0,871,69,940,940,0,0
29409,2019-08-08,232,0,232,18,250,250,0,0
29410,2019-08-08,389,0,389,31,420,420,0,0
29411,2019-08-08,1482,0,1482,118,1600,0,1600,0
29412,2019-08-08,871,0,871,69,940,0,940,0
29413,2019-08-08,1325,0,1325,105,1430,0,1430,0
29414,2019-08-08,908,0,908,72,980,980,0,0
29415,2019-08-08,2723,0,2723,217,2940,2940,0,0
29416,2019-08-08,297,0,297,23,320,320,0,0
29417,2019-08-08,908,0,908,72,980,980,0,0
29418,2019-08-08,519,0,519,41,560,560,0,0
29419,2019-08-08,908,0,908,72,980,980,0,0
29420,2019-08-08,843,0,843,67,910,910,0,0
29421,2019-08-08,1176,0,1176,94,1270,1270,0,0
29422,2019-08-08,1306,0,1306,104,1410,1410,0,0
29423,2019-08-08,936,0,936,74,1010,1010,0,0
29424,2019-08-08,547,0,547,43,590,590,0,0
29425,2019-08-08,446,-47,399,24,423,423,0,0
29426,2019-08-08,778,0,778,62,840,840,0,0
29427,2019-08-08,371,0,371,29,400,0,0,400
29428,2019-08-08,686,0,686,54,740,740,0,0
29429,2019-08-08,686,0,686,54,740,740,0,0
29430,2019-08-08,667,0,667,53,720,720,0,0
29431,2019-08-08,2084,0,2084,166,2250,0,2250,0
29432,2019-08-08,1908,0,1908,152,2060,2060,0,0
29433,2019-08-08,330,0,330,0,330,330,0,0
29434,2019-08-08,908,0,908,72,980,980,0,0
29435,2019-08-08,908,0,908,72,980,980,0,0
29436,2019-08-08,288,0,288,22,310,310,0,0
29437,2019-08-08,769,0,769,61,830,830,0,0
29438,2019-08-08,1510,0,1510,120,1630,1630,0,0
29439,2019-08-08,3547,0,3547,283,3830,3830,0,0
29440,2019-08-08,639,0,639,51,690,690,0,0
29441,2019-08-08,417,0,417,33,450,450,0,0
29442,2019-08-08,686,0,686,54,740,740,0,0
29443,2019-08-08,915,-98,817,65,882,882,0,0
29444,2019-08-08,288,0,288,22,310,310,0,0
29445,2019-08-08,371,0,371,29,400,400,0,0
29446,2019-08-08,417,0,417,33,450,450,0,0
29447,2019-08-08,1010,0,1010,80,1090,1090,0,0
29448,2019-08-08,649,0,649,51,700,700,0,0
29449,2019-08-08,1722,0,1722,128,1850,1850,0,0
29450,2019-08-08,527,0,527,33,560,560,0,0
29451,2019-08-08,908,0,908,72,980,980,0,0
29452,2019-08-08,547,0,547,43,590,590,0,0
29453,2019-08-08,269,0,269,21,290,290,0,0
29454,2019-08-08,463,0,463,37,500,500,0,0
29455,2019-08-08,417,0,417,33,450,450,0,0
29456,2019-08-08,232,0,232,18,250,250,0,0
29457,2019-08-08,2001,0,2001,159,2160,0,2160,0
29458,2019-08-08,2288,0,2288,182,2470,0,2470,0
29459,2019-08-08,639,0,639,51,690,690,0,0
29460,2019-08-08,593,0,593,47,640,640,0,0
29461,2019-08-08,2602,0,2602,208,2810,2810,0,0
29462,2019-08-08,815,0,815,65,880,880,0,0
29463,2019-08-08,852,0,852,68,920,920,0,0
29464,2019-08-08,1815,0,1815,145,1960,1960,0,0
29465,2019-08-08,278,0,278,22,300,300,0,0
29466,2019-08-08,231,0,231,9,240,240,0,0
29467,2019-08-08,797,0,797,63,860,860,0,0
29468,2019-08-08,908,0,908,72,980,980,0,0
29469,2019-08-08,908,0,908,72,980,980,0,0
29470,2019-08-08,501,0,501,39,540,540,0,0
29471,2019-08-08,1815,0,1815,145,1960,1960,0,0
29472,2019-08-08,315,0,315,25,340,340,0,0
29473,2019-08-08,364,-39,325,26,351,351,0,0
29474,2019-08-08,788,0,788,62,850,850,0,0
29475,2019-08-08,481,0,481,29,510,510,0,0
29476,2019-08-08,704,0,704,56,760,0,760,0
29477,2019-08-08,663,-71,592,47,639,639,0,0
29478,2019-08-08,139,0,139,11,150,150,0,0
29479,2019-08-08,250,0,250,20,270,270,0,0
29480,2019-08-08,436,0,436,34,470,470,0,0
29481,2019-08-08,408,0,408,32,440,440,0,0
29482,2019-08-08,556,0,556,44,600,600,0,0
29483,2019-08-08,889,0,889,71,960,960,0,0
29484,2019-08-08,47,0,47,3,50,50,0,0
29485,2019-08-08,1925,0,1925,145,2070,2070,0,0
29486,2019-08-08,741,0,741,59,800,800,0,0
29487,2019-08-08,2149,0,2149,171,2320,2320,0,0
29488,2019-08-08,629,0,629,41,670,670,0,0
29489,2019-08-08,241,0,241,19,260,260,0,0
29490,2019-08-08,362,0,362,28,390,390,0,0
29491,2019-08-08,519,0,519,41,560,560,0,0
29492,2019-08-08,399,0,399,31,430,430,0,0
29493,2019-08-08,749,0,749,51,800,800,0,0
29494,2019-08-08,260,0,260,20,280,280,0,0
29495,2019-08-08,1251,0,1251,99,1350,1350,0,0
29496,2019-08-08,510,0,510,40,550,550,0,0
29497,2019-08-08,426,0,426,34,460,460,0,0
29498,2019-08-08,399,0,399,31,430,430,0,0
29499,2019-08-08,463,0,463,37,500,500,0,0
29500,2019-08-08,121,0,121,9,130,130,0,0
29501,2019-08-08,639,0,639,51,690,0,690,0
29502,2019-08-08,565,0,565,45,610,610,0,0
29503,2019-08-08,232,0,232,18,250,0,250,0
29504,2019-08-08,880,0,880,70,950,0,950,0
29505,2019-08-08,389,0,389,31,420,420,0,0
29506,2019-08-08,436,0,436,34,470,0,470,0
29507,2019-08-08,167,0,167,13,180,180,0,0
29508,2019-08-08,306,0,306,24,330,0,330,0
29509,2019-08-08,1963,0,1963,157,2120,2120,0,0
29510,2019-08-08,602,0,602,48,650,650,0,0
29511,2019-08-08,519,0,519,41,560,560,0,0
29512,2019-08-08,536,0,536,34,570,570,0,0
29513,2019-08-08,223,0,223,17,240,240,0,0
29514,2019-08-08,1575,0,1575,125,1700,1700,0,0
29515,2019-08-08,778,0,778,62,840,840,0,0
29516,2019-08-08,639,0,639,51,690,690,0,0
29517,2019-08-08,1575,0,1575,125,1700,1700,0,0
29518,2019-08-08,278,0,278,22,300,300,0,0
29519,2019-08-08,473,0,473,37,510,510,0,0
29520,2019-08-08,306,0,306,24,330,330,0,0
29521,2019-08-08,760,0,760,60,820,820,0,0
29522,2019-08-08,584,0,584,46,630,630,0,0
29523,2019-08-08,741,0,741,59,800,800,0,0
29524,2019-08-08,917,0,917,73,990,990,0,0
29525,2019-08-08,362,0,362,28,390,390,0,0
29526,2019-08-08,389,0,389,31,420,420,0,0
29527,2019-08-08,1575,0,1575,125,1700,0,1700,0
29528,2019-08-08,575,0,575,45,620,620,0,0
29529,2019-08-08,510,0,510,40,550,550,0,0
29530,2019-08-08,463,0,463,37,500,500,0,0
29531,2019-08-08,1191,0,1191,59,1250,1250,0,0
29532,2019-08-08,139,0,139,11,150,150,0,0
29533,2019-08-08,389,0,389,31,420,420,0,0
29534,2019-08-08,510,0,510,40,550,550,0,0
29535,2019-08-08,343,0,343,27,370,370,0,0
29536,2019-08-08,482,0,482,38,520,520,0,0
29537,2019-08-08,556,0,556,44,600,600,0,0
29538,2019-08-08,1054,0,1054,66,1120,1120,0,0
29539,2019-08-08,454,0,454,36,490,490,0,0
29540,2019-08-08,278,0,278,22,300,300,0,0
29541,2019-08-08,278,0,278,22,300,300,0,0
29542,2019-08-08,1575,0,1575,125,1700,1700,0,0
29543,2019-08-08,823,0,823,57,880,880,0,0
29544,2019-08-08,788,0,788,62,850,850,0,0
29545,2019-08-08,686,0,686,54,740,0,740,0
29546,2019-08-08,788,0,788,62,850,850,0,0
29547,2019-08-09,1815,0,1815,145,1960,1960,0,0
29548,2019-08-09,1186,0,1186,94,1280,1280,0,0
29549,2019-08-09,630,0,630,50,680,680,0,0
29550,2019-08-09,444,0,444,26,470,470,0,0
29551,2019-08-09,672,-72,600,48,648,648,0,0
29552,2019-08-09,1593,0,1593,127,1720,1720,0,0
29553,2019-08-09,917,0,917,73,990,990,0,0
29554,2019-08-09,1001,0,1001,79,1080,1080,0,0
29555,2019-08-09,510,0,510,40,550,550,0,0
29556,2019-08-09,908,0,908,72,980,980,0,0
29557,2019-08-09,908,0,908,72,980,980,0,0
29558,2019-08-09,843,0,843,67,910,910,0,0
29559,2019-08-09,1130,0,1130,90,1220,1220,0,0
29560,2019-08-09,528,0,528,42,570,570,0,0
29561,2019-08-09,899,0,899,71,970,970,0,0
29562,2019-08-09,630,0,630,50,680,680,0,0
29563,2019-08-09,3686,0,3686,294,3980,3980,0,0
29564,2019-08-09,325,0,325,25,350,350,0,0
29565,2019-08-09,862,0,862,68,930,930,0,0
29566,2019-08-09,676,0,676,54,730,730,0,0
29567,2019-08-09,1639,0,1639,131,1770,1770,0,0
29568,2019-08-09,186,0,186,14,200,200,0,0
29569,2019-08-09,695,0,695,55,750,750,0,0
29570,2019-08-09,1815,0,1815,145,1960,1960,0,0
29571,2019-08-09,1528,0,1528,122,1650,1650,0,0
29572,2019-08-09,880,0,880,70,950,950,0,0
29573,2019-08-09,908,0,908,72,980,980,0,0
29574,2019-08-09,908,0,908,72,980,980,0,0
29575,2019-08-09,426,0,426,34,460,460,0,0
29576,2019-08-09,638,0,638,42,680,680,0,0
29577,2019-08-09,1815,0,1815,145,1960,1960,0,0
29578,2019-08-09,445,0,445,35,480,0,0,480
29579,2019-08-09,1241,0,1241,99,1340,1340,0,0
29580,2019-08-09,102,0,102,8,110,110,0,0
29581,2019-08-09,1176,0,1176,94,1270,1270,0,0
29582,2019-08-09,436,0,436,34,470,470,0,0
29583,2019-08-09,694,0,694,46,740,740,0,0
29584,2019-08-09,1973,0,1973,157,2130,0,2130,0
29585,2019-08-09,450,0,450,35,485,485,0,0
29586,2019-08-09,371,0,371,29,400,400,0,0
29587,2019-08-09,-389,0,-389,-31,-420,-420,0,0
29588,2019-08-09,528,0,528,42,570,570,0,0
29589,2019-08-09,2176,0,2176,174,2350,0,2350,0
29590,2019-08-09,1815,0,1815,145,1960,1960,0,0
29591,2019-08-09,250,0,250,20,270,270,0,0
29592,2019-08-09,3047,0,3047,243,3290,0,3290,0
29593,2019-08-09,1436,0,1436,114,1550,0,1550,0
29594,2019-08-09,1056,0,1056,84,1140,1140,0,0
29595,2019-08-09,1084,0,1084,86,1170,1170,0,0
29596,2019-08-09,167,0,167,13,180,180,0,0
29597,2019-08-09,649,0,649,51,700,700,0,0
29598,2019-08-09,1575,0,1575,125,1700,1700,0,0
29599,2019-08-09,1251,0,1251,99,1350,1350,0,0
29600,2019-08-09,732,0,732,58,790,0,0,790
29601,2019-08-09,908,0,908,72,980,980,0,0
29602,2019-08-09,121,0,121,9,130,130,0,0
29603,2019-08-09,417,0,417,33,450,450,0,0
29604,2019-08-09,491,0,491,39,530,530,0,0
29605,2019-08-09,1815,0,1815,145,1960,1960,0,0
29606,2019-08-09,691,-74,617,49,666,666,0,0
29607,2019-08-09,2482,0,2482,198,2680,2680,0,0
29608,2019-08-09,2685,0,2685,205,2890,0,2890,0
29609,2019-08-09,1084,0,1084,86,1170,1170,0,0
29610,2019-08-09,908,0,908,72,980,980,0,0
29611,2019-08-09,4575,0,4575,365,4940,4940,0,0
29612,2019-08-09,556,0,556,44,600,600,0,0
29613,2019-08-09,167,0,167,13,180,180,0,0
29614,2019-08-09,467,-50,417,33,450,450,0,0
29615,2019-08-09,713,0,713,57,770,0,770,0
29616,2019-08-09,723,0,723,57,780,780,0,0
29617,2019-08-09,1334,0,1334,106,1440,1440,0,0
29618,2019-08-09,825,0,825,65,890,890,0,0
29619,2019-08-09,389,0,389,31,420,420,0,0
29620,2019-08-09,556,0,556,44,600,600,0,0
29621,2019-08-09,1343,0,1343,107,1450,1450,0,0
29622,2019-08-09,528,0,528,42,570,570,0,0
29623,2019-08-09,770,-82,688,55,743,743,0,0
29624,2019-08-09,472,0,472,28,500,500,0,0
29625,2019-08-09,713,0,713,57,770,770,0,0
29626,2019-08-09,417,0,417,33,450,450,0,0
29627,2019-08-09,880,0,880,70,950,950,0,0
29628,2019-08-09,260,0,260,20,280,280,0,0
29629,2019-08-09,176,0,176,14,190,190,0,0
29630,2019-08-09,306,0,306,24,330,330,0,0
29631,2019-08-09,713,0,713,57,770,770,0,0
29632,2019-08-09,260,0,260,20,280,280,0,0
29633,2019-08-09,260,0,260,20,280,280,0,0
29634,2019-08-09,1741,0,1741,139,1880,1880,0,0
29635,2019-08-09,491,0,491,39,530,530,0,0
29636,2019-08-09,2723,0,2723,217,2940,2940,0,0
29637,2019-08-09,389,0,389,31,420,420,0,0
29638,2019-08-09,1519,0,1519,121,1640,1640,0,0
29639,2019-08-09,501,0,501,39,540,540,0,0
29640,2019-08-09,1815,0,1815,145,1960,1960,0,0
29641,2019-08-09,362,0,362,28,390,390,0,0
29642,2019-08-09,908,0,908,72,980,0,980,0
29643,2019-08-09,1380,0,1380,110,1490,1490,0,0
29644,2019-08-09,1871,0,1871,149,2020,2020,0,0
29645,2019-08-09,-260,0,-260,-20,-280,-280,0,0
29646,2019-08-09,1064,0,1064,76,1140,1140,0,0
29647,2019-08-09,343,0,343,27,370,370,0,0
29648,2019-08-09,262,-28,234,18,252,252,0,0
29649,2019-08-09,519,0,519,41,560,560,0,0
29650,2019-08-09,301,0,301,24,325,325,0,0
29651,2019-08-09,1815,0,1815,145,1960,1960,0,0
29652,2019-08-09,139,0,139,11,150,150,0,0
29653,2019-08-09,371,0,371,29,400,400,0,0
29654,2019-08-09,1251,0,1251,99,1350,1350,0,0
29655,2019-08-09,1528,0,1528,122,1650,1650,0,0
29656,2019-08-09,318,-34,284,22,306,306,0,0
29657,2019-08-09,815,0,815,65,880,880,0,0
29658,2019-08-09,1038,0,1038,82,1120,1120,0,0
29659,2019-08-09,1788,0,1788,142,1930,1930,0,0
29660,2019-08-09,1592,0,1592,118,1710,0,1710,0
29661,2019-08-09,2047,0,2047,163,2210,0,0,2210
29662,2019-08-09,1788,0,1788,142,1930,1930,0,0
29663,2019-08-09,2009,0,2009,151,2160,2160,0,0
29664,2019-08-09,463,0,463,37,500,500,0,0
29665,2019-08-09,473,0,473,37,510,510,0,0
29666,2019-08-09,343,0,343,27,370,370,0,0
29667,2019-08-09,1760,0,1760,140,1900,1900,0,0
29668,2019-08-09,519,0,519,41,560,560,0,0
29669,2019-08-09,1017,-216,801,63,864,864,0,0
29670,2019-08-09,1815,0,1815,145,1960,1960,0,0
29671,2019-08-09,1815,0,1815,145,1960,1960,0,0
29672,2019-08-09,269,0,269,21,290,290,0,0
29673,2019-08-09,1815,0,1815,145,1960,1960,0,0
29674,2019-08-09,1815,0,1815,145,1960,1960,0,0
29675,2019-08-09,181,0,181,14,195,195,0,0
29676,2019-08-09,2399,0,2399,191,2590,0,2590,0
29677,2019-08-09,306,0,306,24,330,330,0,0
29678,2019-08-09,1815,0,1815,145,1960,1960,0,0
29679,2019-08-10,2565,0,2565,205,2770,2770,0,0
29680,2019-08-10,1815,0,1815,145,1960,0,0,1960
29681,2019-08-10,1547,0,1547,123,1670,1670,0,0
29682,2019-08-10,695,0,695,55,750,750,0,0
29683,2019-08-10,1584,0,1584,126,1710,1710,0,0
29684,2019-08-10,778,0,778,62,840,840,0,0
29685,2019-08-10,1084,0,1084,86,1170,1170,0,0
29686,2019-08-10,871,0,871,69,940,940,0,0
29687,2019-08-10,491,0,491,39,530,530,0,0
29688,2019-08-10,732,0,732,58,790,790,0,0
29689,2019-08-10,769,0,769,61,830,830,0,0
29690,2019-08-10,908,0,908,72,980,980,0,0
29691,2019-08-10,251,0,251,19,270,270,0,0
29692,2019-08-10,1056,0,1056,84,1140,1140,0,0
29693,2019-08-10,538,0,538,42,580,580,0,0
29694,2019-08-10,426,0,426,34,460,460,0,0
29695,2019-08-10,806,0,806,64,870,870,0,0
29696,2019-08-10,797,0,797,63,860,860,0,0
29697,2019-08-10,719,0,719,57,776,776,0,0
29698,2019-08-10,797,0,797,63,860,860,0,0
29699,2019-08-10,899,0,899,71,970,970,0,0
29700,2019-08-10,778,0,778,62,840,840,0,0
29701,2019-08-10,741,0,741,59,800,800,0,0
29702,2019-08-10,908,0,908,72,980,980,0,0
29703,2019-08-10,982,0,982,78,1060,1060,0,0
29704,2019-08-10,2843,0,2843,227,3070,3070,0,0
29705,2019-08-10,2102,0,2102,168,2270,2270,0,0
29706,2019-08-10,1815,0,1815,145,1960,1960,0,0
29707,2019-08-10,723,0,723,57,780,0,780,0
29708,2019-08-10,232,0,232,18,250,250,0,0
29709,2019-08-10,1112,0,1112,88,1200,1200,0,0
29710,2019-08-10,75,0,75,5,80,80,0,0
29711,2019-08-10,2436,0,2436,194,2630,2630,0,0
29712,2019-08-10,1121,0,1121,89,1210,1210,0,0
29713,2019-08-10,1343,0,1343,107,1450,1450,0,0
29714,2019-08-10,1251,0,1251,99,1350,1350,0,0
29715,2019-08-10,575,0,575,45,620,620,0,0
29716,2019-08-10,973,0,973,77,1050,1050,0,0
29717,2019-08-10,676,0,676,54,730,730,0,0
29718,2019-08-10,732,0,732,58,790,790,0,0
29719,2019-08-10,2158,0,2158,172,2330,0,2330,0
29720,2019-08-10,362,0,362,28,390,390,0,0
29721,2019-08-10,3288,0,3288,262,3550,0,3550,0
29722,2019-08-10,491,0,491,39,530,530,0,0
29723,2019-08-10,713,0,713,57,770,770,0,0
29724,2019-08-10,371,0,371,29,400,400,0,0
29725,2019-08-10,908,0,908,72,980,980,0,0
29726,2019-08-10,880,0,880,70,950,950,0,0
29727,2019-08-10,1056,0,1056,84,1140,1140,0,0
29728,2019-08-10,936,0,936,74,1010,0,1010,0
29729,2019-08-10,908,0,908,72,980,980,0,0
29730,2019-08-10,908,0,908,72,980,980,0,0
29731,2019-08-10,584,0,584,46,630,630,0,0
29732,2019-08-10,704,0,704,56,760,760,0,0
29733,2019-08-10,1991,0,1991,159,2150,2150,0,0
29734,2019-08-10,954,0,954,76,1030,1030,0,0
29735,2019-08-10,260,0,260,20,280,280,0,0
29736,2019-08-10,2744,-294,2450,196,2646,2646,0,0
29737,2019-08-10,167,0,167,13,180,180,0,0
29738,2019-08-10,1047,0,1047,83,1130,1130,0,0
29739,2019-08-10,917,0,917,73,990,990,0,0
29740,2019-08-10,463,0,463,37,500,500,0,0
29741,2019-08-10,1815,0,1815,145,1960,0,1960,0
29742,2019-08-10,565,0,565,45,610,610,0,0
29743,2019-08-10,1487,-316,1171,93,1264,1264,0,0
29744,2019-08-10,389,0,389,31,420,420,0,0
29745,2019-08-10,204,0,204,16,220,220,0,0
29746,2019-08-10,380,0,380,30,410,0,410,0
29747,2019-08-10,510,0,510,40,550,550,0,0
29748,2019-08-10,362,0,362,28,390,390,0,0
29749,2019-08-10,1528,0,1528,122,1650,1650,0,0
29750,2019-08-10,1130,0,1130,90,1220,1220,0,0
29751,2019-08-10,1536,0,1536,114,1650,1650,0,0
29752,2019-08-10,1445,0,1445,115,1560,1560,0,0
29753,2019-08-10,1858,0,1858,122,1980,1980,0,0
29754,2019-08-10,1269,0,1269,101,1370,1370,0,0
29755,2019-08-10,1101,0,1101,79,1180,1180,0,0
29756,2019-08-10,723,0,723,57,780,780,0,0
29757,2019-08-10,1296,-138,1158,84,1242,1242,0,0
29758,2019-08-10,426,0,426,34,460,460,0,0
29759,2019-08-10,2436,0,2436,194,2630,2630,0,0
29760,2019-08-10,1379,0,1379,101,1480,1480,0,0
29761,2019-08-10,426,0,426,34,460,460,0,0
29762,2019-08-10,621,0,621,49,670,670,0,0
29763,2019-08-10,334,0,334,26,360,360,0,0
29764,2019-08-10,649,0,649,51,700,0,0,700
29765,2019-08-10,1204,0,1204,96,1300,1300,0,0
29766,2019-08-10,797,0,797,63,860,860,0,0
29767,2019-08-10,1028,0,1028,82,1110,1110,0,0
29768,2019-08-10,1843,0,1843,147,1990,1990,0,0
29769,2019-08-10,908,0,908,72,980,980,0,0
29770,2019-08-10,908,0,908,72,980,980,0,0
29771,2019-08-10,908,0,908,72,980,0,980,0
29772,2019-08-10,963,0,963,77,1040,1040,0,0
29773,2019-08-10,1815,0,1815,145,1960,1960,0,0
29774,2019-08-10,260,0,260,20,280,280,0,0
29775,2019-08-10,510,0,510,40,550,550,0,0
29776,2019-08-10,399,0,399,31,430,430,0,0
29777,2019-08-10,334,0,334,26,360,360,0,0
29778,2019-08-10,519,0,519,41,560,560,0,0
29779,2019-08-10,121,0,121,9,130,130,0,0
29780,2019-08-10,778,0,778,62,840,840,0,0
29781,2019-08-10,269,0,269,21,290,290,0,0
29782,2019-08-10,1176,0,1176,94,1270,1270,0,0
29783,2019-08-10,889,0,889,71,960,960,0,0
29784,2019-08-10,334,0,334,26,360,360,0,0
29785,2019-08-10,362,0,362,28,390,390,0,0
29786,2019-08-10,850,-91,759,60,819,819,0,0
29787,2019-08-10,778,0,778,62,840,840,0,0
29788,2019-08-10,426,0,426,34,460,460,0,0
29789,2019-08-10,778,0,778,62,840,840,0,0
29790,2019-08-10,575,0,575,45,620,620,0,0
29791,2019-08-10,1713,0,1713,137,1850,1850,0,0
29792,2019-08-10,667,0,667,53,720,0,0,720
29793,2019-08-10,399,0,399,31,430,430,0,0
29794,2019-08-10,639,0,639,51,690,690,0,0
29795,2019-08-10,269,0,269,21,290,290,0,0
29796,2019-08-10,1362,0,1362,108,1470,1470,0,0
29797,2019-08-10,814,0,814,56,870,870,0,0
29798,2019-08-10,565,0,565,45,610,610,0,0
29799,2019-08-10,778,0,778,62,840,840,0,0
29800,2019-08-10,2116,0,2116,169,2285,2285,0,0
29801,2019-08-10,1815,0,1815,145,1960,0,1960,0
29802,2019-08-10,1343,0,1343,107,1450,1450,0,0
29803,2019-08-10,1343,0,1343,107,1450,1450,0,0
29804,2019-08-10,278,0,278,22,300,300,0,0
29805,2019-08-10,658,0,658,52,710,710,0,0
29806,2019-08-10,797,0,797,63,860,860,0,0
29807,2019-08-10,277,0,277,13,290,290,0,0
29808,2019-08-10,778,0,778,62,840,0,840,0
29809,2019-08-10,880,0,880,70,950,950,0,0
29810,2019-08-10,399,0,399,31,430,430,0,0
29811,2019-08-10,825,0,825,65,890,0,890,0
29812,2019-08-10,778,0,778,62,840,840,0,0
29813,2019-08-10,260,0,260,20,280,280,0,0
29814,2019-08-10,2269,0,2269,181,2450,2450,0,0
29815,2019-08-10,445,0,445,35,480,480,0,0
29816,2019-08-10,195,0,195,15,210,210,0,0
29817,2019-08-10,982,0,982,78,1060,1060,0,0
29818,2019-08-10,269,0,269,21,290,290,0,0
29819,2019-08-10,510,0,510,40,550,550,0,0
29820,2019-08-10,399,0,399,31,430,430,0,0
29821,2019-08-10,806,0,806,64,870,870,0,0
29822,2019-08-10,880,0,880,70,950,950,0,0
29823,2019-08-10,1519,0,1519,121,1640,1640,0,0
29824,2019-08-10,306,0,306,24,330,330,0,0
29825,2019-08-10,2278,0,2278,182,2460,2460,0,0
29826,2019-08-10,334,0,334,26,360,0,0,360
29827,2019-08-10,416,0,416,24,440,440,0,0
29828,2019-08-10,1186,0,1186,94,1280,1280,0,0
29829,2019-08-10,778,0,778,62,840,840,0,0
29830,2019-08-10,593,0,593,47,640,0,640,0
29831,2019-08-10,852,0,852,68,920,920,0,0
29832,2019-08-10,1084,0,1084,86,1170,1170,0,0
29833,2019-08-10,908,0,908,72,980,980,0,0
29834,2019-08-10,1815,0,1815,145,1960,1960,0,0
29835,2019-08-10,915,-98,817,65,882,882,0,0
29836,2019-08-10,908,0,908,72,980,980,0,0
29837,2019-08-10,167,0,167,13,180,180,0,0
29838,2019-08-10,1815,0,1815,145,1960,1960,0,0
29839,2019-08-10,1788,0,1788,142,1930,1930,0,0
29840,2019-08-10,2334,0,2334,186,2520,2520,0,0
29841,2019-08-10,1601,0,1601,119,1720,1720,0,0
29842,2019-08-10,112,0,112,8,120,120,0,0
29843,2019-08-10,334,0,334,26,360,360,0,0
29844,2019-08-10,1926,0,1926,154,2080,2080,0,0
29845,2019-08-10,926,0,926,74,1000,1000,0,0
29846,2019-08-10,1010,0,1010,80,1090,1090,0,0
29847,2019-08-10,241,0,241,19,260,0,260,0
29848,2019-08-10,510,0,510,40,550,0,550,0
29849,2019-08-10,251,0,251,19,270,270,0,0
29850,2019-08-10,1815,0,1815,145,1960,1960,0,0
29851,2019-08-10,760,0,760,60,820,820,0,0
29852,2019-08-10,232,0,232,18,250,250,0,0
29853,2019-08-10,-232,0,-232,-18,-250,-250,0,0
29854,2019-08-10,1815,0,1815,145,1960,1960,0,0
29855,2019-08-10,3630,0,3630,290,3920,3920,0,0
29856,2019-08-10,1815,0,1815,145,1960,1960,0,0
29857,2019-08-10,1815,0,1815,145,1960,1960,0,0
29858,2019-08-10,908,0,908,72,980,980,0,0
29859,2019-08-10,908,0,908,72,980,980,0,0
29860,2019-08-10,1815,0,1815,145,1960,1960,0,0
29861,2019-08-10,908,0,908,72,980,980,0,0
29862,2019-08-10,1501,0,1501,119,1620,1620,0,0
29863,2019-08-10,1815,0,1815,145,1960,1960,0,0
29864,2019-08-10,1815,0,1815,145,1960,1960,0,0
29865,2019-08-10,667,0,667,53,720,0,0,720
29866,2019-08-10,1019,0,1019,81,1100,1100,0,0
29867,2019-08-10,1815,0,1815,145,1960,0,1960,0
29868,2019-08-10,1102,0,1102,88,1190,1190,0,0
29869,2019-08-10,362,0,362,28,390,390,0,0
29870,2019-08-10,260,0,260,20,280,280,0,0
29871,2019-08-11,1028,0,1028,82,1110,1110,0,0
29872,2019-08-11,565,0,565,45,610,610,0,0
29873,2019-08-11,399,0,399,31,430,430,0,0
29874,2019-08-11,1038,0,1038,82,1120,1120,0,0
29875,2019-08-11,908,0,908,72,980,980,0,0
29876,2019-08-11,1815,0,1815,145,1960,1960,0,0
29877,2019-08-11,1815,0,1815,145,1960,1960,0,0
29878,2019-08-11,862,0,862,68,930,930,0,0
29879,2019-08-11,1001,0,1001,79,1080,1080,0,0
29880,2019-08-11,1195,0,1195,95,1290,1290,0,0
29881,2019-08-11,630,0,630,50,680,680,0,0
29882,2019-08-11,491,0,491,39,530,530,0,0
29883,2019-08-11,1485,-159,1326,105,1431,1431,0,0
29884,2019-08-11,751,0,751,59,810,810,0,0
29885,2019-08-11,649,0,649,51,700,700,0,0
29886,2019-08-11,1176,0,1176,94,1270,1270,0,0
29887,2019-08-11,399,0,399,31,430,0,0,430
29888,2019-08-11,112,0,112,8,120,120,0,0
29889,2019-08-11,4639,0,4639,371,5010,5010,0,0
29890,2019-08-11,454,0,454,36,490,490,0,0
29891,2019-08-11,510,0,510,40,550,550,0,0
29892,2019-08-11,1556,0,1556,124,1680,1680,0,0
29893,2019-08-11,2001,0,2001,159,2160,0,0,2160
29894,2019-08-11,788,0,788,62,850,850,0,0
29895,2019-08-11,908,0,908,72,980,980,0,0
29896,2019-08-11,686,0,686,54,740,740,0,0
29897,2019-08-11,991,0,991,79,1070,0,1070,0
29898,2019-08-11,778,0,778,62,840,840,0,0
29899,2019-08-11,806,0,806,64,870,870,0,0
29900,2019-08-11,1991,0,1991,159,2150,2150,0,0
29901,2019-08-11,676,0,676,54,730,730,0,0
29902,2019-08-11,1001,0,1001,79,1080,1080,0,0
29903,2019-08-11,1482,0,1482,118,1600,1600,0,0
29904,2019-08-11,1815,0,1815,145,1960,1960,0,0
29905,2019-08-11,1815,0,1815,145,1960,1960,0,0
29906,2019-08-11,158,0,158,12,170,170,0,0
29907,2019-08-11,4538,0,4538,362,4900,4900,0,0
29908,2019-08-11,732,0,732,58,790,790,0,0
29909,2019-08-11,1380,0,1380,110,1490,1490,0,0
29910,2019-08-11,1380,0,1380,110,1490,1490,0,0
29911,2019-08-11,1121,0,1121,89,1210,1210,0,0
29912,2019-08-11,-1121,0,-1121,-89,-1210,-1210,0,0
29913,2019-08-11,-1380,0,-1380,-110,-1490,-1490,0,0
29914,2019-08-11,1121,0,1121,89,1210,1210,0,0
29915,2019-08-11,908,0,908,72,980,980,0,0
29916,2019-08-11,269,0,269,21,290,290,0,0
29917,2019-08-11,4751,0,4751,379,5130,5130,0,0
29918,2019-08-11,1676,0,1676,134,1810,1810,0,0
29919,2019-08-11,-398,0,-398,-32,-430,-430,0,0
29920,2019-08-11,260,0,260,20,280,280,0,0
29921,2019-08-11,908,0,908,72,980,980,0,0
29922,2019-08-11,1751,0,1751,139,1890,0,1890,0
29923,2019-08-11,723,0,723,57,780,780,0,0
29924,2019-08-11,1815,0,1815,145,1960,1960,0,0
29925,2019-08-11,806,0,806,64,870,870,0,0
29926,2019-08-11,1102,0,1102,88,1190,1190,0,0
29927,2019-08-11,1223,0,1223,97,1320,1320,0,0
29928,2019-08-11,250,0,250,20,270,270,0,0
29929,2019-08-11,1852,0,1852,148,2000,2000,0,0
29930,2019-08-11,473,0,473,37,510,510,0,0
29931,2019-08-11,408,0,408,32,440,440,0,0
29932,2019-08-11,2723,0,2723,217,2940,2940,0,0
29933,2019-08-11,1130,0,1130,90,1220,1220,0,0
29934,2019-08-11,389,0,389,31,420,420,0,0
29935,2019-08-11,695,0,695,55,750,0,750,0
29936,2019-08-11,649,0,649,51,700,0,700,0
29937,2019-08-11,908,0,908,72,980,0,0,980
29938,2019-08-11,908,0,908,72,980,0,0,980
29939,2019-08-11,1092,0,1092,78,1170,0,1170,0
29940,2019-08-11,2639,0,2639,211,2850,2850,0,0
29941,2019-08-11,491,0,491,39,530,530,0,0
29942,2019-08-11,1815,0,1815,145,1960,1960,0,0
29943,2019-08-11,667,0,667,53,720,720,0,0
29944,2019-08-11,231,0,231,9,240,240,0,0
29945,2019-08-11,250,0,250,20,270,270,0,0
29946,2019-08-11,343,0,343,27,370,370,0,0
29947,2019-08-11,908,0,908,72,980,980,0,0
29948,2019-08-11,166,0,166,4,170,170,0,0
29949,2019-08-11,982,0,982,78,1060,1060,0,0
29950,2019-08-11,1417,0,1417,113,1530,1530,0,0
29951,2019-08-11,1815,0,1815,145,1960,1960,0,0
29952,2019-08-11,-1815,0,-1815,-145,-1960,-1960,0,0
29953,2019-08-11,1815,0,1815,145,1960,0,1960,0
29954,2019-08-11,575,0,575,45,620,620,0,0
29955,2019-08-11,315,0,315,25,340,340,0,0
29956,2019-08-11,1695,0,1695,135,1830,1830,0,0
29957,2019-08-11,2723,0,2723,217,2940,2940,0,0
29958,2019-08-11,584,0,584,46,630,630,0,0
29959,2019-08-11,1047,0,1047,83,1130,1130,0,0
29960,2019-08-11,945,0,945,75,1020,1020,0,0
29961,2019-08-11,1259,0,1259,91,1350,1350,0,0
29962,2019-08-11,898,0,898,62,960,0,960,0
29963,2019-08-11,834,0,834,66,900,900,0,0
29964,2019-08-11,2723,0,2723,217,2940,2940,0,0
29965,2019-08-11,2982,0,2982,238,3220,3220,0,0
29966,2019-08-11,1232,0,1232,98,1330,1330,0,0
29967,2019-08-11,825,0,825,65,890,890,0,0
29968,2019-08-11,334,0,334,26,360,360,0,0
29969,2019-08-11,1269,0,1269,101,1370,1370,0,0
29970,2019-08-11,2723,0,2723,217,2940,2940,0,0
29971,2019-08-11,399,0,399,31,430,430,0,0
29972,2019-08-11,167,0,167,13,180,180,0,0
29973,2019-08-11,2251,0,2251,179,2430,2430,0,0
29974,2019-08-11,501,0,501,39,540,0,540,0
29975,2019-08-11,473,0,473,37,510,510,0,0
29976,2019-08-11,1065,0,1065,85,1150,1150,0,0
29977,2019-08-11,2639,0,2639,211,2850,2850,0,0
29978,2019-08-11,1149,0,1149,91,1240,1240,0,0
29979,2019-08-11,-1380,0,-1380,-110,-1490,-1490,0,0
29980,2019-08-11,1391,-149,1242,99,1341,1341,0,0
29981,2019-08-11,732,0,732,58,790,790,0,0
29982,2019-08-11,825,0,825,65,890,890,0,0
29983,2019-08-11,430,-46,384,30,414,414,0,0
29984,2019-08-11,103,-11,92,7,99,99,0,0
29985,2019-08-11,518,0,518,32,550,550,0,0
29986,2019-08-11,439,0,439,35,474,474,0,0
29987,2019-08-11,112,0,112,8,120,120,0,0
29988,2019-08-11,112,0,112,8,120,120,0,0
29989,2019-08-11,2815,0,2815,225,3040,3040,0,0
29990,2019-08-11,251,0,251,19,270,270,0,0
29991,2019-08-11,399,0,399,31,430,430,0,0
29992,2019-08-11,602,0,602,48,650,650,0,0
29993,2019-08-11,1519,0,1519,121,1640,1640,0,0
29994,2019-08-11,389,0,389,31,420,420,0,0
29995,2019-08-11,621,0,621,49,670,670,0,0
29996,2019-08-11,778,0,778,62,840,0,0,840
29997,2019-08-11,260,0,260,20,280,280,0,0
29998,2019-08-11,797,0,797,63,860,860,0,0
29999,2019-08-11,852,0,852,68,920,920,0,0
30000,2019-08-11,93,0,93,7,100,100,0,0
30001,2019-08-11,695,0,695,55,750,750,0,0
30002,2019-08-11,1380,0,1380,110,1490,1490,0,0
30003,2019-08-11,471,-100,371,29,400,400,0,0
30004,2019-08-11,778,0,778,62,840,840,0,0
30005,2019-08-11,3167,0,3167,253,3420,3420,0,0
30006,2019-08-11,473,0,473,37,510,510,0,0
30007,2019-08-11,1362,0,1362,108,1470,1470,0,0
30008,2019-08-11,732,0,732,58,790,790,0,0
30009,2019-08-11,871,0,871,69,940,940,0,0
30010,2019-08-11,2334,0,2334,186,2520,2520,0,0
30011,2019-08-11,1343,0,1343,107,1450,1450,0,0
30012,2019-08-11,1019,0,1019,81,1100,1100,0,0
30013,2019-08-11,1436,0,1436,114,1550,1550,0,0
30014,2019-08-11,547,0,547,43,590,590,0,0
30015,2019-08-11,639,0,639,51,690,690,0,0
30016,2019-08-11,584,0,584,46,630,630,0,0
30017,2019-08-11,260,0,260,20,280,280,0,0
30018,2019-08-11,2723,0,2723,217,2940,0,2940,0
30019,2019-08-11,2547,0,2547,203,2750,2750,0,0
30020,2019-08-11,330,0,330,0,330,330,0,0
30021,2019-08-11,260,0,260,20,280,280,0,0
30022,2019-08-11,842,0,842,58,900,900,0,0
30023,2019-08-11,963,0,963,77,1040,1040,0,0
30024,2019-08-11,260,0,260,20,280,280,0,0
30025,2019-08-11,2649,0,2649,211,2860,2860,0,0
30026,2019-08-11,260,0,260,20,280,280,0,0
30027,2019-08-11,602,0,602,48,650,650,0,0
30028,2019-08-11,416,0,416,24,440,440,0,0
30029,2019-08-11,362,0,362,28,390,390,0,0
30030,2019-08-11,102,0,102,8,110,110,0,0
30031,2019-08-11,408,0,408,32,440,440,0,0
30032,2019-08-11,723,0,723,57,780,780,0,0
30033,2019-08-11,362,0,362,28,390,390,0,0
30034,2019-08-11,649,0,649,51,700,0,700,0
30035,2019-08-11,1473,0,1473,117,1590,1590,0,0
30036,2019-08-11,1815,0,1815,145,1960,1960,0,0
30037,2019-08-11,408,0,408,32,440,440,0,0
30038,2019-08-11,417,0,417,33,450,450,0,0
30039,2019-08-11,1297,0,1297,103,1400,1400,0,0
30040,2019-08-11,3630,0,3630,290,3920,0,3920,0
30041,2019-08-11,1815,0,1815,145,1960,1960,0,0
30042,2019-08-11,306,0,306,24,330,330,0,0
30043,2019-08-11,1121,0,1121,89,1210,1210,0,0
30044,2019-08-11,556,0,556,44,600,600,0,0
30045,2019-08-11,1362,0,1362,108,1470,1470,0,0
30046,2019-08-11,315,0,315,25,340,340,0,0
30047,2019-08-11,871,0,871,69,940,940,0,0
30048,2019-08-11,3630,0,3630,290,3920,0,3920,0
30049,2019-08-11,399,0,399,31,430,430,0,0
30050,2019-08-11,1815,0,1815,145,1960,1960,0,0
30051,2019-08-11,463,0,463,37,500,500,0,0
30052,2019-08-11,1056,0,1056,84,1140,1140,0,0
30053,2019-08-11,389,0,389,31,420,420,0,0
30054,2019-08-11,806,0,806,64,870,870,0,0
30055,2019-08-11,362,0,362,28,390,390,0,0
30056,2019-08-11,1751,0,1751,139,1890,1890,0,0
30057,2019-08-11,362,0,362,28,390,390,0,0
30058,2019-08-11,695,0,695,55,750,750,0,0
30059,2019-08-11,1815,0,1815,145,1960,0,1960,0
30060,2019-08-11,186,0,186,14,200,200,0,0
30061,2019-08-11,1380,0,1380,110,1490,1490,0,0
30062,2019-08-11,334,0,334,26,360,360,0,0
30063,2019-08-11,954,0,954,76,1030,1030,0,0
30064,2019-08-11,593,0,593,47,640,640,0,0
30065,2019-08-11,1436,0,1436,114,1550,1550,0,0
30066,2019-08-11,1584,0,1584,126,1710,1710,0,0
30067,2019-08-11,1815,0,1815,145,1960,0,0,1960
30068,2019-08-11,2231,0,2231,169,2400,0,2400,0
30069,2019-08-11,1917,0,1917,153,2070,0,2070,0
30070,2019-08-11,1223,0,1223,97,1320,1320,0,0
30071,2019-08-11,2176,0,2176,174,2350,0,2350,0
30072,2019-08-11,1380,0,1380,110,1490,1490,0,0
30073,2019-08-11,278,0,278,22,300,300,0,0
30074,2019-08-11,2723,0,2723,217,2940,2940,0,0
30075,2019-08-11,639,0,639,51,690,690,0,0
30076,2019-08-11,4278,0,4278,342,4620,4620,0,0
30077,2019-08-11,2602,0,2602,208,2810,2810,0,0
30078,2019-08-11,5001,0,5001,399,5400,5400,0,0
30079,2019-08-11,112,0,112,8,120,120,0,0
30080,2019-08-11,288,0,288,22,310,310,0,0
30081,2019-08-11,250,0,250,20,270,270,0,0
30082,2019-08-11,1186,0,1186,94,1280,1280,0,0
30083,2019-08-11,278,0,278,22,300,300,0,0
30084,2019-08-11,843,0,843,67,910,910,0,0
30085,2019-08-12,260,0,260,20,280,280,0,0
30086,2019-08-12,417,0,417,33,450,450,0,0
30087,2019-08-12,556,0,556,44,600,600,0,0
30088,2019-08-12,639,0,639,51,690,690,0,0
30089,2019-08-12,908,0,908,72,980,980,0,0
30090,2019-08-12,769,0,769,61,830,830,0,0
30091,2019-08-12,778,0,778,62,840,840,0,0
30092,2019-08-12,899,0,899,71,970,970,0,0
30093,2019-08-12,467,-50,417,33,450,450,0,0
30094,2019-08-12,2297,0,2297,183,2480,2480,0,0
30095,2019-08-12,871,0,871,69,940,940,0,0
30096,2019-08-12,3621,0,3621,289,3910,0,0,3910
30097,2019-08-12,2278,0,2278,182,2460,2460,0,0
30098,2019-08-12,547,0,547,43,590,590,0,0
30099,2019-08-12,908,0,908,72,980,980,0,0
30100,2019-08-12,925,0,925,65,990,990,0,0
30101,2019-08-12,1713,0,1713,137,1850,1850,0,0
30102,2019-08-12,2936,0,2936,234,3170,0,3170,0
30103,2019-08-12,1815,0,1815,145,1960,0,1960,0
30104,2019-08-12,2954,0,2954,236,3190,3190,0,0
30105,2019-08-12,695,0,695,55,750,750,0,0
30106,2019-08-12,473,0,473,37,510,510,0,0
30107,2019-08-12,1288,0,1288,102,1390,1390,0,0
30108,2019-08-12,889,0,889,71,960,960,0,0
30109,2019-08-12,1010,0,1010,80,1090,1090,0,0
30110,2019-08-12,676,0,676,54,730,730,0,0
30111,2019-08-12,908,0,908,72,980,980,0,0
30112,2019-08-12,1815,0,1815,145,1960,1960,0,0
30113,2019-08-12,355,-38,317,25,342,342,0,0
30114,2019-08-12,778,0,778,62,840,840,0,0
30115,2019-08-12,1815,0,1815,145,1960,1960,0,0
30116,2019-08-12,1334,0,1334,106,1440,1440,0,0
30117,2019-08-12,982,0,982,78,1060,1060,0,0
30118,2019-08-12,565,0,565,45,610,610,0,0
30119,2019-08-12,1001,0,1001,79,1080,1080,0,0
30120,2019-08-12,630,0,630,50,680,680,0,0
30121,2019-08-12,621,0,621,49,670,670,0,0
30122,2019-08-12,593,0,593,47,640,640,0,0
30123,2019-08-12,288,0,288,22,310,310,0,0
30124,2019-08-12,278,0,278,22,300,300,0,0
30125,2019-08-12,473,0,473,37,510,510,0,0
30126,2019-08-12,768,0,768,52,820,0,820,0
30127,2019-08-12,186,0,186,14,200,200,0,0
30128,2019-08-12,139,0,139,11,150,150,0,0
30129,2019-08-12,908,0,908,72,980,980,0,0
30130,2019-08-12,880,0,880,70,950,950,0,0
30131,2019-08-12,47,0,47,3,50,50,0,0
30132,2019-08-12,167,0,167,13,180,180,0,0
30133,2019-08-12,510,0,510,40,550,550,0,0
30134,2019-08-12,47,0,47,3,50,50,0,0
30135,2019-08-12,908,0,908,72,980,980,0,0
30136,2019-08-12,334,0,334,26,360,360,0,0
30137,2019-08-12,260,0,260,20,280,280,0,0
30138,2019-08-12,463,0,463,37,500,500,0,0
30139,2019-08-12,788,0,788,62,850,850,0,0
30140,2019-08-12,399,0,399,31,430,430,0,0
30141,2019-08-12,908,0,908,72,980,980,0,0
30142,2019-08-12,908,0,908,72,980,980,0,0
30143,2019-08-12,723,0,723,57,780,780,0,0
30144,2019-08-12,362,0,362,28,390,390,0,0
30145,2019-08-12,278,0,278,22,300,0,0,300
30146,2019-08-12,186,0,186,14,200,0,0,200
30147,2019-08-12,399,0,399,31,430,430,0,0
30148,2019-08-12,1112,0,1112,88,1200,1200,0,0
30149,2019-08-12,1528,0,1528,122,1650,1650,0,0
30150,2019-08-12,834,0,834,66,900,900,0,0
30151,2019-08-12,399,0,399,31,430,430,0,0
30152,2019-08-12,399,0,399,31,430,430,0,0
30153,2019-08-12,445,0,445,35,480,0,0,480
30154,2019-08-12,399,0,399,31,430,430,0,0
30155,2019-08-12,825,0,825,65,890,890,0,0
30156,2019-08-12,908,0,908,72,980,980,0,0
30157,2019-08-12,1815,0,1815,145,1960,1960,0,0
30158,2019-08-12,570,-61,509,40,549,0,0,549
30159,2019-08-12,1815,0,1815,145,1960,1960,0,0
30160,2019-08-12,2723,0,2723,217,2940,2940,0,0
30161,2019-08-12,306,0,306,24,330,330,0,0
30162,2019-08-12,843,0,843,67,910,910,0,0
30163,2019-08-12,1195,0,1195,95,1290,1290,0,0
30164,2019-08-12,908,0,908,72,980,980,0,0
30165,2019-08-12,2093,0,2093,167,2260,0,0,2260
30166,2019-08-12,362,0,362,28,390,390,0,0
30167,2019-08-12,797,0,797,63,860,860,0,0
30168,2019-08-12,260,0,260,20,280,280,0,0
30169,2019-08-12,2723,0,2723,217,2940,2940,0,0
30170,2019-08-12,639,0,639,51,690,690,0,0
30171,2019-08-12,778,0,778,62,840,840,0,0
30172,2019-08-12,778,0,778,62,840,840,0,0
30173,2019-08-12,1889,0,1889,151,2040,0,2040,0
30174,2019-08-12,556,0,556,44,600,600,0,0
30175,2019-08-12,1815,0,1815,145,1960,1960,0,0
30176,2019-08-12,269,0,269,21,290,290,0,0
30177,2019-08-12,186,0,186,14,200,200,0,0
30178,2019-08-12,264,-56,208,16,224,224,0,0
30179,2019-08-12,463,0,463,37,500,500,0,0
30180,2019-08-12,778,0,778,62,840,840,0,0
30181,2019-08-12,908,0,908,72,980,980,0,0
30182,2019-08-12,908,0,908,72,980,980,0,0
30183,2019-08-12,1768,0,1768,132,1900,1900,0,0
30184,2019-08-12,278,0,278,22,300,300,0,0
30185,2019-08-12,380,0,380,30,410,0,410,0
30186,2019-08-12,389,0,389,31,420,420,0,0
30187,2019-08-12,1815,0,1815,145,1960,1960,0,0
30188,2019-08-12,1741,0,1741,139,1880,1880,0,0
30189,2019-08-12,325,0,325,25,350,350,0,0
30190,2019-08-12,908,0,908,72,980,980,0,0
30191,2019-08-12,1352,0,1352,108,1460,1460,0,0
30192,2019-08-12,2501,0,2501,199,2700,2700,0,0
30193,2019-08-12,389,0,389,31,420,420,0,0
30194,2019-08-12,788,0,788,62,850,850,0,0
30195,2019-08-12,1575,0,1575,125,1700,1700,0,0
30196,2019-08-12,1176,0,1176,94,1270,1270,0,0
30197,2019-08-12,1261,-135,1126,89,1215,1215,0,0
30198,2019-08-12,232,0,232,18,250,250,0,0
30199,2019-08-12,1158,0,1158,92,1250,1250,0,0
30200,2019-08-12,732,0,732,58,790,790,0,0
30201,2019-08-12,1436,0,1436,114,1550,1550,0,0
30202,2019-08-12,389,0,389,31,420,420,0,0
30203,2019-08-12,399,0,399,31,430,430,0,0
30204,2019-08-12,399,0,399,31,430,430,0,0
30205,2019-08-12,1556,0,1556,124,1680,1680,0,0
30206,2019-08-12,-389,0,-389,-31,-420,-420,0,0
30207,2019-08-12,126,0,126,9,135,135,0,0
30208,2019-08-12,417,0,417,33,450,450,0,0
30209,2019-08-12,528,0,528,42,570,570,0,0
30210,2019-08-12,250,0,250,20,270,270,0,0
30211,2019-08-12,269,0,269,21,290,290,0,0
30212,2019-08-12,1019,0,1019,81,1100,1100,0,0
30213,2019-08-12,1926,0,1926,154,2080,2080,0,0
30214,2019-08-12,399,0,399,31,430,430,0,0
30215,2019-08-12,584,0,584,46,630,630,0,0
30216,2019-08-12,621,0,621,49,670,670,0,0
30217,2019-08-12,514,-55,459,36,495,495,0,0
30218,2019-08-12,630,0,630,50,680,680,0,0
30219,2019-08-12,926,0,926,74,1000,1000,0,0
30220,2019-08-12,732,0,732,58,790,790,0,0
30221,2019-08-12,704,0,704,56,760,760,0,0
30222,2019-08-12,260,0,260,20,280,280,0,0
30223,2019-08-12,1815,0,1815,145,1960,1960,0,0
30224,2019-08-12,2408,0,2408,192,2600,2600,0,0
30225,2019-08-12,954,0,954,76,1030,1030,0,0
30226,2019-08-12,788,0,788,62,850,850,0,0
30227,2019-08-12,667,0,667,53,720,720,0,0
30228,2019-08-12,751,0,751,59,810,810,0,0
30229,2019-08-12,954,0,954,76,1030,1030,0,0
30230,2019-08-12,204,0,204,16,220,220,0,0
30231,2019-08-12,547,0,547,43,590,590,0,0
30232,2019-08-12,167,0,167,13,180,180,0,0
30233,2019-08-12,570,-61,509,40,549,549,0,0
30234,2019-08-12,1260,0,1260,100,1360,1360,0,0
30235,2019-08-12,741,0,741,59,800,800,0,0
30236,2019-08-12,1065,0,1065,85,1150,1150,0,0
30237,2019-08-12,399,0,399,31,430,430,0,0
30238,2019-08-12,1149,0,1149,91,1240,0,0,1240
30239,2019-08-12,806,0,806,64,870,870,0,0
30240,2019-08-12,260,0,260,20,280,280,0,0
30241,2019-08-12,278,0,278,22,300,300,0,0
30242,2019-08-12,880,0,880,70,950,950,0,0
30243,2019-08-12,1703,0,1703,127,1830,1830,0,0
30244,2019-08-12,556,0,556,44,600,600,0,0
30245,2019-08-12,1528,0,1528,122,1650,1650,0,0
30246,2019-08-12,788,0,788,62,850,850,0,0
30247,2019-08-12,1815,0,1815,145,1960,1960,0,0
30248,2019-08-12,999,0,999,71,1070,1070,0,0
30249,2019-08-12,2723,0,2723,217,2940,2940,0,0
30250,2019-08-12,1038,0,1038,82,1120,1120,0,0
30251,2019-08-12,1815,0,1815,145,1960,1960,0,0
30252,2019-08-12,2741,0,2741,219,2960,2960,0,0
30253,2019-08-12,880,0,880,70,950,0,0,950
30254,2019-08-12,908,0,908,72,980,980,0,0
30255,2019-08-12,908,0,908,72,980,980,0,0
30256,2019-08-12,2723,0,2723,217,2940,2940,0,0
30257,2019-08-12,352,0,352,28,380,380,0,0
30258,2019-08-12,223,0,223,17,240,240,0,0
30259,2019-08-12,1797,0,1797,143,1940,1940,0,0
30260,2019-08-12,1741,0,1741,139,1880,1880,0,0
30261,2019-08-12,1815,0,1815,145,1960,1960,0,0
30262,2019-08-12,760,0,760,60,820,820,0,0
30263,2019-08-12,510,0,510,40,550,550,0,0
30264,2019-08-12,491,0,491,39,530,530,0,0
30265,2019-08-12,538,0,538,42,580,580,0,0
30266,2019-08-12,371,0,371,29,400,400,0,0
30267,2019-08-12,1538,0,1538,122,1660,1660,0,0
30268,2019-08-12,1815,0,1815,145,1960,1960,0,0
30269,2019-08-12,1797,0,1797,143,1940,0,1940,0
30270,2019-08-12,1408,0,1408,112,1520,1520,0,0
30271,2019-08-12,343,0,343,27,370,370,0,0
30272,2019-08-12,389,0,389,31,420,420,0,0
30273,2019-08-12,269,0,269,21,290,290,0,0
30274,2019-08-12,417,0,417,33,450,450,0,0
30275,2019-08-12,167,0,167,13,180,180,0,0
30276,2019-08-12,1575,0,1575,125,1700,1700,0,0
30277,2019-08-12,112,0,112,8,120,120,0,0
30278,2019-08-12,463,0,463,37,500,500,0,0
30279,2019-08-12,908,0,908,72,980,980,0,0
30280,2019-08-12,1815,0,1815,145,1960,1960,0,0
30281,2019-08-12,2723,0,2723,217,2940,0,2940,0
30282,2019-08-12,1815,0,1815,145,1960,1960,0,0
30283,2019-08-12,889,0,889,71,960,960,0,0
30284,2019-08-12,5445,0,5445,435,5880,5880,0,0
30285,2019-08-12,2723,0,2723,217,2940,2940,0,0
30286,2019-08-12,3630,0,3630,290,3920,3920,0,0
30287,2019-08-12,797,0,797,63,860,860,0,0
30288,2019-08-12,343,0,343,27,370,370,0,0
30289,2019-08-12,889,0,889,71,960,960,0,0
30290,2019-08-12,417,0,417,33,450,450,0,0
30291,2019-08-12,-1815,0,-1815,-145,-1960,-1960,0,0
30292,2019-08-12,908,0,908,72,980,980,0,0
30293,2019-08-12,908,0,908,72,980,980,0,0
30294,2019-08-12,1713,0,1713,137,1850,1850,0,0
30295,2019-08-12,2723,0,2723,217,2940,2940,0,0
30296,2019-08-13,936,0,936,74,1010,1010,0,0
30297,2019-08-13,260,0,260,20,280,280,0,0
30298,2019-08-13,639,0,639,51,690,690,0,0
30299,2019-08-13,908,0,908,72,980,980,0,0
30300,2019-08-13,334,0,334,26,360,360,0,0
30301,2019-08-13,1084,0,1084,86,1170,1170,0,0
30302,2019-08-13,954,0,954,76,1030,0,0,1030
30303,2019-08-13,528,0,528,42,570,570,0,0
30304,2019-08-13,880,0,880,70,950,950,0,0
30305,2019-08-13,1815,0,1815,145,1960,1960,0,0
30306,2019-08-13,528,0,528,42,570,570,0,0
30307,2019-08-13,389,0,389,31,420,420,0,0
30308,2019-08-13,388,0,388,22,410,0,0,410
30309,2019-08-13,556,0,556,44,600,600,0,0
30310,2019-08-13,731,0,731,49,780,780,0,0
30311,2019-08-13,482,0,482,38,520,520,0,0
30312,2019-08-13,621,0,621,49,670,670,0,0
30313,2019-08-13,1593,0,1593,127,1720,1720,0,0
30314,2019-08-13,1139,0,1139,91,1230,1230,0,0
30315,2019-08-13,352,0,352,28,380,380,0,0
30316,2019-08-13,388,0,388,22,410,410,0,0
30317,2019-08-13,2916,0,2916,224,3140,3140,0,0
30318,2019-08-13,658,0,658,52,710,710,0,0
30319,2019-08-13,3630,0,3630,290,3920,3920,0,0
30320,2019-08-13,269,0,269,21,290,0,290,0
30321,2019-08-13,926,0,926,74,1000,1000,0,0
30322,2019-08-13,556,0,556,44,600,600,0,0
30323,2019-08-13,658,0,658,52,710,0,0,710
30324,2019-08-13,278,0,278,22,300,0,300,0
30325,2019-08-13,1593,0,1593,127,1720,1720,0,0
30326,2019-08-13,3630,0,3630,290,3920,3920,0,0
30327,2019-08-13,639,0,639,51,690,690,0,0
30328,2019-08-13,991,0,991,79,1070,1070,0,0
30329,2019-08-13,815,0,815,65,880,880,0,0
30330,2019-08-13,1130,0,1130,90,1220,1220,0,0
30331,2019-08-13,2288,0,2288,182,2470,2470,0,0
30332,2019-08-13,556,0,556,44,600,600,0,0
30333,2019-08-13,399,0,399,31,430,430,0,0
30334,2019-08-13,469,0,469,11,480,480,0,0
30335,2019-08-13,751,0,751,59,810,810,0,0
30336,2019-08-13,880,0,880,70,950,950,0,0
30337,2019-08-13,2777,0,2777,213,2990,2990,0,0
30338,2019-08-13,264,-56,208,16,224,224,0,0
30339,2019-08-13,806,0,806,64,870,870,0,0
30340,2019-08-13,1830,-196,1634,130,1764,1764,0,0
30341,2019-08-13,1195,0,1195,95,1290,1290,0,0
30342,2019-08-13,612,0,612,48,660,660,0,0
30343,2019-08-13,1454,0,1454,116,1570,1570,0,0
30344,2019-08-13,575,0,575,45,620,620,0,0
30345,2019-08-13,362,0,362,28,390,390,0,0
30346,2019-08-13,1019,0,1019,81,1100,1100,0,0
30347,2019-08-13,3630,0,3630,290,3920,3920,0,0
30348,2019-08-13,514,0,514,41,555,555,0,0
30349,2019-08-13,908,0,908,72,980,980,0,0
30350,2019-08-13,1815,0,1815,145,1960,0,1960,0
30351,2019-08-13,686,0,686,54,740,0,740,0
30352,2019-08-13,982,0,982,78,1060,1060,0,0
30353,2019-08-13,501,0,501,39,540,540,0,0
30354,2019-08-13,899,0,899,71,970,970,0,0
30355,2019-08-13,760,0,760,60,820,820,0,0
30356,2019-08-13,501,0,501,39,540,540,0,0
30357,2019-08-13,593,0,593,47,640,640,0,0
30358,2019-08-13,112,0,112,8,120,120,0,0
30359,2019-08-13,389,0,389,31,420,420,0,0
30360,2019-08-13,1139,0,1139,91,1230,1230,0,0
30361,2019-08-13,783,0,783,62,845,845,0,0
30362,2019-08-13,1416,0,1416,104,1520,1520,0,0
30363,2019-08-13,1408,0,1408,112,1520,1520,0,0
30364,2019-08-13,2936,0,2936,234,3170,3170,0,0
30365,2019-08-13,2056,0,2056,164,2220,2220,0,0
30366,2019-08-13,1547,0,1547,123,1670,1670,0,0
30367,2019-08-13,2723,0,2723,217,2940,2940,0,0
30368,2019-08-13,1815,0,1815,145,1960,1960,0,0
30369,2019-08-13,278,0,278,22,300,300,0,0
30370,2019-08-13,4538,0,4538,362,4900,4900,0,0
30371,2019-08-13,565,0,565,45,610,610,0,0
30372,2019-08-13,504,-54,450,36,486,486,0,0
30373,2019-08-13,1241,0,1241,99,1340,0,1340,0
30374,2019-08-13,528,0,528,42,570,570,0,0
30375,2019-08-13,1555,0,1555,115,1670,1670,0,0
30376,2019-08-13,639,0,639,51,690,690,0,0
30377,2019-08-13,602,0,602,48,650,650,0,0
30378,2019-08-13,2426,0,2426,194,2620,2620,0,0
30379,2019-08-13,1425,0,1425,105,1530,1530,0,0
30380,2019-08-13,176,0,176,14,190,190,0,0
30381,2019-08-13,676,0,676,54,730,730,0,0
30382,2019-08-13,751,0,751,59,810,810,0,0
30383,2019-08-13,880,0,880,70,950,950,0,0
30384,2019-08-13,908,0,908,72,980,980,0,0
30385,2019-08-13,3630,0,3630,290,3920,0,3920,0
30386,2019-08-13,158,0,158,12,170,170,0,0
30387,2019-08-13,1212,0,1212,88,1300,1300,0,0
30388,2019-08-13,1195,0,1195,95,1290,1290,0,0
30389,2019-08-13,167,0,167,13,180,180,0,0
30390,2019-08-13,1815,0,1815,145,1960,1960,0,0
30391,2019-08-13,232,0,232,18,250,250,0,0
30392,2019-08-13,1056,0,1056,84,1140,1140,0,0
30393,2019-08-13,788,0,788,62,850,850,0,0
30394,2019-08-13,954,0,954,76,1030,1030,0,0
30395,2019-08-13,371,0,371,29,400,400,0,0
30396,2019-08-13,1584,0,1584,126,1710,0,0,1710
30397,2019-08-13,371,0,371,29,400,400,0,0
30398,2019-08-13,519,0,519,41,560,560,0,0
30399,2019-08-13,2926,0,2926,234,3160,3160,0,0
30400,2019-08-13,778,0,778,62,840,840,0,0
30401,2019-08-13,908,0,908,72,980,980,0,0
30402,2019-08-13,1982,0,1982,158,2140,2140,0,0
30403,2019-08-13,547,0,547,43,590,590,0,0
30404,2019-08-13,2010,0,2010,160,2170,2170,0,0
30405,2019-08-13,519,0,519,41,560,560,0,0
30406,2019-08-13,1288,0,1288,102,1390,1390,0,0
30407,2019-08-13,1241,0,1241,99,1340,1340,0,0
30408,2019-08-13,232,0,232,18,250,250,0,0
30409,2019-08-13,121,0,121,9,130,130,0,0
30410,2019-08-13,167,0,167,13,180,180,0,0
30411,2019-08-13,417,0,417,33,450,450,0,0
30412,2019-08-13,630,0,630,50,680,680,0,0
30413,2019-08-13,1288,0,1288,102,1390,1390,0,0
30414,2019-08-13,852,0,852,68,920,920,0,0
30415,2019-08-13,1815,0,1815,145,1960,0,1960,0
30416,2019-08-13,915,-98,817,65,882,0,0,882
30417,2019-08-13,658,0,658,52,710,710,0,0
30418,2019-08-13,1269,0,1269,101,1370,1370,0,0
30419,2019-08-13,1010,0,1010,80,1090,1090,0,0
30420,2019-08-13,1001,0,1001,79,1080,1080,0,0
30421,2019-08-13,704,0,704,56,760,760,0,0
30422,2019-08-13,1436,0,1436,114,1550,1550,0,0
30423,2019-08-13,463,0,463,37,500,500,0,0
30424,2019-08-13,834,0,834,66,900,900,0,0
30425,2019-08-13,2482,0,2482,198,2680,2680,0,0
30426,2019-08-13,1518,0,1518,112,1630,0,1630,0
30427,2019-08-13,639,0,639,51,690,690,0,0
30428,2019-08-13,1760,0,1760,140,1900,0,1900,0
30429,2019-08-13,945,0,945,75,1020,1020,0,0
30430,2019-08-13,1047,0,1047,83,1130,1130,0,0
30431,2019-08-13,473,0,473,37,510,510,0,0
30432,2019-08-13,481,0,481,29,510,510,0,0
30433,2019-08-13,1278,0,1278,102,1380,1380,0,0
30434,2019-08-13,1920,-408,1512,120,1632,1632,0,0
30435,2019-08-13,260,0,260,20,280,280,0,0
30436,2019-08-13,926,0,926,74,1000,1000,0,0
30437,2019-08-13,915,-98,817,65,882,882,0,0
30438,2019-08-13,482,0,482,38,520,0,520,0
30439,2019-08-13,-908,0,-908,-72,-980,-980,0,0
30440,2019-08-13,908,0,908,72,980,980,0,0
30441,2019-08-13,908,0,908,72,980,980,0,0
30442,2019-08-13,584,0,584,46,630,630,0,0
30443,2019-08-13,1815,0,1815,145,1960,1960,0,0
30444,2019-08-13,852,0,852,68,920,920,0,0
30445,2019-08-13,1590,-338,1252,100,1352,1352,0,0
30446,2019-08-13,538,0,538,42,580,580,0,0
30447,2019-08-13,2899,0,2899,231,3130,3130,0,0
30448,2019-08-13,371,0,371,29,400,400,0,0
30449,2019-08-13,1815,0,1815,145,1960,1960,0,0
30450,2019-08-13,704,0,704,56,760,760,0,0
30451,2019-08-13,908,0,908,72,980,980,0,0
30452,2019-08-13,908,0,908,72,980,980,0,0
30453,2019-08-13,-908,0,-908,-72,-980,0,-980,0
30454,2019-08-13,269,0,269,21,290,290,0,0
30455,2019-08-13,907,0,907,63,970,0,970,0
30456,2019-08-13,612,0,612,48,660,660,0,0
30457,2019-08-13,4056,0,4056,324,4380,4380,0,0
30458,2019-08-13,380,0,380,30,410,410,0,0
30459,2019-08-13,232,0,232,18,250,250,0,0
30460,2019-08-13,556,0,556,44,600,600,0,0
30461,2019-08-13,3019,0,3019,241,3260,0,3260,0
30462,2019-08-13,1028,0,1028,82,1110,1110,0,0
30463,2019-08-13,260,0,260,20,280,280,0,0
30464,2019-08-13,1815,0,1815,145,1960,0,1960,0
30465,2019-08-13,139,0,139,11,150,150,0,0
30466,2019-08-13,251,0,251,19,270,270,0,0
30467,2019-08-13,593,0,593,47,640,0,640,0
30468,2019-08-13,269,0,269,21,290,290,0,0
30469,2019-08-13,908,0,908,72,980,980,0,0
30470,2019-08-13,908,0,908,72,980,980,0,0
30471,2019-08-13,1815,0,1815,145,1960,1960,0,0
30472,2019-08-13,1815,0,1815,145,1960,1960,0,0
30473,2019-08-13,908,0,908,72,980,0,0,980
30474,2019-08-13,649,0,649,51,700,700,0,0
30475,2019-08-13,713,0,713,57,770,770,0,0
30476,2019-08-13,908,0,908,72,980,980,0,0
30477,2019-08-13,908,0,908,72,980,980,0,0
30478,2019-08-13,509,0,509,31,540,540,0,0
30479,2019-08-13,1815,0,1815,145,1960,0,1960,0
30480,2019-08-13,1620,0,1620,120,1740,1740,0,0
30481,2019-08-13,556,0,556,44,600,600,0,0
30482,2019-08-13,1917,0,1917,153,2070,2070,0,0
30483,2019-08-13,908,0,908,72,980,0,980,0
30484,2019-08-14,139,0,139,11,150,150,0,0
30485,2019-08-14,556,0,556,44,600,600,0,0
30486,2019-08-14,676,0,676,54,730,730,0,0
30487,2019-08-14,343,0,343,27,370,370,0,0
30488,2019-08-14,1010,0,1010,80,1090,1090,0,0
30489,2019-08-14,426,0,426,34,460,460,0,0
30490,2019-08-14,741,0,741,59,800,800,0,0
30491,2019-08-14,723,0,723,57,780,780,0,0
30492,2019-08-14,1130,0,1130,90,1220,1220,0,0
30493,2019-08-14,149,0,149,11,160,160,0,0
30494,2019-08-14,204,0,204,16,220,220,0,0
30495,2019-08-14,1028,0,1028,82,1110,1110,0,0
30496,2019-08-14,1501,0,1501,119,1620,1620,0,0
30497,2019-08-14,1600,0,1600,110,1710,1710,0,0
30498,2019-08-14,778,0,778,62,840,840,0,0
30499,2019-08-14,426,0,426,34,460,460,0,0
30500,2019-08-14,306,0,306,24,330,330,0,0
30501,2019-08-14,2723,0,2723,217,2940,0,2940,0
30502,2019-08-14,1194,0,1194,86,1280,1280,0,0
30503,2019-08-14,398,0,398,22,420,420,0,0
30504,2019-08-14,1815,0,1815,145,1960,1960,0,0
30505,2019-08-14,352,0,352,28,380,380,0,0
30506,2019-08-14,1010,0,1010,80,1090,1090,0,0
30507,2019-08-14,1815,0,1815,145,1960,1960,0,0
30508,2019-08-14,917,0,917,73,990,990,0,0
30509,2019-08-14,1195,-128,1067,85,1152,1152,0,0
30510,2019-08-14,467,-50,417,33,450,450,0,0
30511,2019-08-14,945,0,945,75,1020,1020,0,0
30512,2019-08-14,1815,0,1815,145,1960,1960,0,0
30513,2019-08-14,908,0,908,72,980,980,0,0
30514,2019-08-14,528,0,528,42,570,570,0,0
30515,2019-08-14,167,0,167,13,180,180,0,0
30516,2019-08-14,1815,0,1815,145,1960,1960,0,0
30517,2019-08-14,1075,0,1075,85,1160,1160,0,0
30518,2019-08-14,389,0,389,31,420,420,0,0
30519,2019-08-14,584,0,584,46,630,630,0,0
30520,2019-08-14,1639,0,1639,131,1770,1770,0,0
30521,2019-08-14,1830,-196,1634,130,1764,0,1764,0
30522,2019-08-14,501,0,501,39,540,540,0,0
30523,2019-08-14,1019,0,1019,81,1100,0,1100,0
30524,2019-08-14,723,0,723,57,780,780,0,0
30525,2019-08-14,1167,0,1167,93,1260,1260,0,0
30526,2019-08-14,584,0,584,46,630,630,0,0
30527,2019-08-14,1815,0,1815,145,1960,1960,0,0
30528,2019-08-14,908,0,908,72,980,980,0,0
30529,2019-08-14,297,0,297,23,320,320,0,0
30530,2019-08-14,1815,0,1815,145,1960,0,1960,0
30531,2019-08-14,797,0,797,63,860,860,0,0
30532,2019-08-14,1815,0,1815,145,1960,1960,0,0
30533,2019-08-14,1815,0,1815,145,1960,1960,0,0
30534,2019-08-14,908,0,908,72,980,980,0,0
30535,2019-08-14,1121,0,1121,89,1210,1210,0,0
30536,2019-08-14,815,0,815,65,880,880,0,0
30537,2019-08-14,908,0,908,72,980,980,0,0
30538,2019-08-14,649,0,649,51,700,700,0,0
30539,2019-08-14,260,0,260,20,280,280,0,0
30540,2019-08-14,908,0,908,72,980,980,0,0
30541,2019-08-14,815,0,815,65,880,880,0,0
30542,2019-08-14,208,0,208,16,224,224,0,0
30543,2019-08-14,1001,0,1001,79,1080,1080,0,0
30544,2019-08-14,3630,0,3630,290,3920,0,3920,0
30545,2019-08-14,1149,0,1149,91,1240,1240,0,0
30546,2019-08-14,297,0,297,23,320,320,0,0
30547,2019-08-14,454,0,454,36,490,490,0,0
30548,2019-08-14,343,0,343,27,370,370,0,0
30549,2019-08-14,2723,0,2723,217,2940,2940,0,0
30550,2019-08-14,1010,0,1010,80,1090,1090,0,0
30551,2019-08-14,926,0,926,74,1000,1000,0,0
30552,2019-08-14,3630,0,3630,290,3920,3920,0,0
30553,2019-08-14,463,0,463,37,500,500,0,0
30554,2019-08-14,1815,0,1815,145,1960,1960,0,0
30555,2019-08-14,825,0,825,65,890,890,0,0
30556,2019-08-14,167,0,167,13,180,180,0,0
30557,2019-08-14,-260,0,-260,-20,-280,-280,0,0
30558,2019-08-14,658,0,658,52,710,710,0,0
30559,2019-08-14,589,-63,526,41,567,567,0,0
30560,2019-08-14,778,0,778,62,840,840,0,0
30561,2019-08-14,232,0,232,18,250,250,0,0
30562,2019-08-14,973,0,973,77,1050,1050,0,0
30563,2019-08-14,1926,0,1926,154,2080,2080,0,0
30564,2019-08-14,658,0,658,52,710,710,0,0
30565,2019-08-14,1352,0,1352,108,1460,1460,0,0
30566,2019-08-14,260,0,260,20,280,280,0,0
30567,2019-08-14,325,0,325,25,350,350,0,0
30568,2019-08-14,1278,0,1278,102,1380,1380,0,0
30569,2019-08-14,399,0,399,31,430,430,0,0
30570,2019-08-14,630,0,630,50,680,0,0,680
30571,2019-08-14,232,0,232,18,250,250,0,0
30572,2019-08-14,2409,-258,2151,171,2322,2322,0,0
30573,2019-08-14,362,0,362,28,390,390,0,0
30574,2019-08-14,741,0,741,59,800,800,0,0
30575,2019-08-14,815,0,815,65,880,880,0,0
30576,2019-08-14,667,0,667,53,720,720,0,0
30577,2019-08-14,1602,0,1602,128,1730,0,1730,0
30578,2019-08-14,760,0,760,60,820,820,0,0
30579,2019-08-14,1073,0,1073,77,1150,0,1150,0
30580,2019-08-14,168,-18,150,12,162,0,162,0
30581,2019-08-14,463,0,463,37,500,500,0,0
30582,2019-08-14,538,0,538,42,580,580,0,0
30583,2019-08-14,278,0,278,22,300,300,0,0
30584,2019-08-14,1501,0,1501,119,1620,1620,0,0
30585,2019-08-14,536,0,536,34,570,0,0,570
30586,2019-08-14,1830,-196,1634,130,1764,1764,0,0
30587,2019-08-14,1195,0,1195,95,1290,1290,0,0
30588,2019-08-14,2954,0,2954,236,3190,3190,0,0
30589,2019-08-14,360,0,360,20,380,380,0,0
30590,2019-08-14,334,0,334,26,360,360,0,0
30591,2019-08-14,408,0,408,32,440,440,0,0
30592,2019-08-14,1064,0,1064,76,1140,1140,0,0
30593,2019-08-14,719,-77,642,51,693,693,0,0
30594,2019-08-14,778,0,778,62,840,840,0,0
30595,2019-08-14,1732,0,1732,138,1870,1870,0,0
30596,2019-08-14,260,0,260,20,280,280,0,0
30597,2019-08-14,250,0,250,20,270,270,0,0
30598,2019-08-14,1315,0,1315,105,1420,1420,0,0
30599,2019-08-14,732,0,732,58,790,790,0,0
30600,2019-08-14,288,0,288,22,310,310,0,0
30601,2019-08-14,593,0,593,47,640,640,0,0
30602,2019-08-14,1815,0,1815,145,1960,1960,0,0
30603,2019-08-14,-463,0,-463,-37,-500,-500,0,0
30604,2019-08-14,260,0,260,20,280,280,0,0
30605,2019-08-14,788,0,788,62,850,850,0,0
30606,2019-08-14,278,0,278,22,300,300,0,0
30607,2019-08-14,723,0,723,57,780,780,0,0
30608,2019-08-14,186,0,186,14,200,200,0,0
30609,2019-08-14,593,0,593,47,640,640,0,0
30610,2019-08-14,408,0,408,32,440,0,0,440
30611,2019-08-14,2038,0,2038,162,2200,2200,0,0
30612,2019-08-14,630,0,630,50,680,680,0,0
30613,2019-08-14,1102,0,1102,88,1190,1190,0,0
30614,2019-08-14,1862,0,1862,148,2010,2010,0,0
30615,2019-08-14,1232,0,1232,98,1330,1330,0,0
30616,2019-08-14,778,0,778,62,840,840,0,0
30617,2019-08-14,1334,0,1334,106,1440,1440,0,0
30618,2019-08-14,1260,0,1260,100,1360,1360,0,0
30619,2019-08-14,926,0,926,74,1000,1000,0,0
30620,2019-08-14,1075,0,1075,85,1160,1160,0,0
30621,2019-08-14,1075,0,1075,85,1160,0,0,1160
30622,2019-08-14,-1075,0,-1075,-85,-1160,-1160,0,0
30623,2019-08-14,1732,0,1732,138,1870,1870,0,0
30624,2019-08-14,1028,0,1028,82,1110,1110,0,0
30625,2019-08-14,-1028,0,-1028,-82,-1110,-1110,0,0
30626,2019-08-14,1806,0,1806,144,1950,1950,0,0
30627,2019-08-14,1519,0,1519,121,1640,1640,0,0
30628,2019-08-14,181,0,181,14,195,195,0,0
30629,2019-08-14,500,0,500,40,540,540,0,0
30630,2019-08-14,1704,0,1704,136,1840,1840,0,0
30631,2019-08-14,260,0,260,20,280,280,0,0
30632,2019-08-14,343,0,343,27,370,370,0,0
30633,2019-08-14,1176,0,1176,94,1270,1270,0,0
30634,2019-08-14,1278,0,1278,102,1380,1380,0,0
30635,2019-08-14,288,0,288,22,310,310,0,0
30636,2019-08-14,1917,0,1917,153,2070,2070,0,0
30637,2019-08-14,260,0,260,20,280,280,0,0
30638,2019-08-14,491,0,491,39,530,530,0,0
30639,2019-08-14,436,0,436,34,470,0,0,470
30640,2019-08-14,417,0,417,33,450,450,0,0
30641,2019-08-14,269,0,269,21,290,290,0,0
30642,2019-08-14,889,0,889,71,960,0,0,960
30643,2019-08-14,504,-54,450,36,486,486,0,0
30644,2019-08-14,1612,0,1612,128,1740,1740,0,0
30645,2019-08-14,482,0,482,38,520,520,0,0
30646,2019-08-14,686,0,686,54,740,0,0,740
30647,2019-08-14,2028,0,2028,162,2190,2190,0,0
30648,2019-08-14,704,0,704,56,760,760,0,0
30649,2019-08-14,1519,0,1519,121,1640,0,1640,0
30650,2019-08-14,3056,0,3056,244,3300,3300,0,0
30651,2019-08-14,232,0,232,18,250,250,0,0
30652,2019-08-14,1288,0,1288,102,1390,1390,0,0
30653,2019-08-14,1102,0,1102,88,1190,1190,0,0
30654,2019-08-14,1177,-126,1051,83,1134,1134,0,0
30655,2019-08-14,1112,0,1112,88,1200,1200,0,0
30656,2019-08-14,130,0,130,10,140,140,0,0
30657,2019-08-14,186,0,186,14,200,200,0,0
30658,2019-08-14,269,0,269,21,290,290,0,0
30659,2019-08-14,241,0,241,19,260,260,0,0
30660,2019-08-14,204,0,204,16,220,220,0,0
30661,2019-08-14,158,0,158,12,170,170,0,0
30662,2019-08-14,334,0,334,26,360,360,0,0
30663,2019-08-14,547,0,547,43,590,590,0,0
30664,2019-08-14,24,0,24,1,25,25,0,0
30665,2019-08-14,1815,0,1815,145,1960,1960,0,0
30666,2019-08-14,1815,0,1815,145,1960,0,0,1960
30667,2019-08-14,686,0,686,54,740,740,0,0
30668,2019-08-14,417,0,417,33,450,450,0,0
30669,2019-08-14,889,0,889,71,960,960,0,0
30670,2019-08-14,3630,0,3630,290,3920,3920,0,0
30671,2019-08-14,2371,0,2371,189,2560,0,0,2560
30672,2019-08-14,667,0,667,53,720,720,0,0
30673,2019-08-14,843,0,843,67,910,910,0,0
30674,2019-08-14,501,0,501,39,540,540,0,0
30675,2019-08-14,667,0,667,53,720,720,0,0
30676,2019-08-14,306,0,306,24,330,330,0,0
30677,2019-08-14,555,0,555,35,590,590,0,0
30678,2019-08-14,898,0,898,62,960,960,0,0
30679,2019-08-14,1822,0,1822,128,1950,1950,0,0
30680,2019-08-14,426,0,426,34,460,460,0,0
30681,2019-08-14,306,0,306,24,330,330,0,0
30682,2019-08-14,1389,0,1389,111,1500,1500,0,0
30683,2019-08-14,880,0,880,70,950,950,0,0
30684,2019-08-14,1815,0,1815,145,1960,1960,0,0
30685,2019-08-14,463,0,463,37,500,500,0,0
30686,2019-08-14,463,0,463,37,500,500,0,0
30687,2019-08-14,463,0,463,37,500,500,0,0
30688,2019-08-14,704,0,704,56,760,760,0,0
30689,2019-08-14,-463,0,-463,-37,-500,-500,0,0
30690,2019-08-14,2778,0,2778,222,3000,3000,0,0
30691,2019-08-14,713,0,713,57,770,770,0,0
30692,2019-08-14,1815,0,1815,145,1960,0,0,1960
30693,2019-08-14,1325,0,1325,105,1430,1430,0,0
30694,2019-08-14,1815,0,1815,145,1960,1960,0,0
30695,2019-08-14,102,0,102,8,110,110,0,0
30696,2019-08-14,38,0,38,2,40,40,0,0
30697,2019-08-14,825,0,825,65,890,890,0,0
30698,2019-08-14,1251,0,1251,99,1350,0,1350,0
30699,2019-08-14,1408,0,1408,112,1520,1520,0,0
30700,2019-08-14,778,0,778,62,840,0,840,0
30701,2019-08-14,352,0,352,28,380,380,0,0
30702,2019-08-14,371,0,371,29,400,400,0,0
30703,2019-08-14,848,0,848,67,915,915,0,0
30704,2019-08-14,399,0,399,31,430,430,0,0
30705,2019-08-14,112,0,112,8,120,120,0,0
30706,2019-08-14,362,0,362,28,390,390,0,0
30707,2019-08-14,213,0,213,17,230,230,0,0
30708,2019-08-14,486,-52,434,34,468,468,0,0
30709,2019-08-14,1815,0,1815,145,1960,1960,0,0
30710,2019-08-14,352,0,352,28,380,380,0,0
30711,2019-08-14,1510,0,1510,120,1630,1630,0,0
30712,2019-08-14,2380,0,2380,190,2570,2570,0,0
30713,2019-08-14,2723,0,2723,217,2940,2940,0,0
30714,2019-08-14,1815,0,1815,145,1960,1960,0,0
30715,2019-08-14,1797,0,1797,143,1940,1940,0,0
30716,2019-08-14,749,0,749,51,800,800,0,0
30717,2019-08-14,871,0,871,69,940,940,0,0
30718,2019-08-14,3630,0,3630,290,3920,3920,0,0
30719,2019-08-14,1815,0,1815,145,1960,0,0,1960
30720,2019-08-14,1815,0,1815,145,1960,1960,0,0
30721,2019-08-14,250,0,250,20,270,270,0,0
30722,2019-08-15,121,0,121,9,130,130,0,0
30723,2019-08-15,1195,0,1195,95,1290,1290,0,0
30724,2019-08-15,741,0,741,59,800,800,0,0
30725,2019-08-15,917,0,917,73,990,990,0,0
30726,2019-08-15,1760,0,1760,140,1900,1900,0,0
30727,2019-08-15,834,0,834,66,900,900,0,0
30728,2019-08-15,1454,0,1454,116,1570,1570,0,0
30729,2019-08-15,371,0,371,29,400,400,0,0
30730,2019-08-15,908,0,908,72,980,980,0,0
30731,2019-08-15,463,0,463,37,500,500,0,0
30732,2019-08-15,334,0,334,26,360,360,0,0
30733,2019-08-15,945,0,945,75,1020,1020,0,0
30734,2019-08-15,139,0,139,11,150,150,0,0
30735,2019-08-15,556,0,556,44,600,0,600,0
30736,2019-08-15,1269,0,1269,101,1370,1370,0,0
30737,2019-08-15,575,0,575,45,620,620,0,0
30738,2019-08-15,1815,0,1815,145,1960,0,1960,0
30739,2019-08-15,871,0,871,69,940,940,0,0
30740,2019-08-15,352,0,352,28,380,380,0,0
30741,2019-08-15,1028,0,1028,82,1110,1110,0,0
30742,2019-08-15,1815,0,1815,145,1960,1960,0,0
30743,2019-08-15,852,0,852,68,920,920,0,0
30744,2019-08-15,1815,0,1815,145,1960,0,1960,0
30745,2019-08-15,547,0,547,43,590,0,590,0
30746,2019-08-15,519,0,519,41,560,560,0,0
30747,2019-08-15,713,0,713,57,770,770,0,0
30748,2019-08-15,514,-55,459,36,495,495,0,0
30749,2019-08-15,658,0,658,52,710,710,0,0
30750,2019-08-15,4538,0,4538,362,4900,0,4900,0
30751,2019-08-15,1028,0,1028,82,1110,1110,0,0
30752,2019-08-15,2954,0,2954,236,3190,3190,0,0
30753,2019-08-15,-370,0,-370,-30,-400,-400,0,0
30754,2019-08-15,352,0,352,28,380,380,0,0
30755,2019-08-15,1410,-151,1259,100,1359,1359,0,0
30756,2019-08-15,908,0,908,72,980,980,0,0
30757,2019-08-15,815,0,815,65,880,880,0,0
30758,2019-08-15,1630,0,1630,130,1760,1760,0,0
30759,2019-08-15,926,0,926,74,1000,1000,0,0
30760,2019-08-15,907,0,907,63,970,970,0,0
30761,2019-08-15,1223,0,1223,97,1320,0,1320,0
30762,2019-08-15,908,0,908,72,980,980,0,0
30763,2019-08-15,713,0,713,57,770,770,0,0
30764,2019-08-15,315,0,315,25,340,340,0,0
30765,2019-08-15,269,0,269,21,290,290,0,0
30766,2019-08-15,899,0,899,71,970,970,0,0
30767,2019-08-15,490,0,490,30,520,520,0,0
30768,2019-08-15,121,0,121,9,130,130,0,0
30769,2019-08-15,519,0,519,41,560,560,0,0
30770,2019-08-15,2723,0,2723,217,2940,0,0,2940
30771,2019-08-15,518,0,518,32,550,550,0,0
30772,2019-08-15,686,0,686,54,740,0,740,0
30773,2019-08-15,751,0,751,59,810,810,0,0
30774,2019-08-15,167,0,167,13,180,180,0,0
30775,2019-08-15,1047,0,1047,83,1130,1130,0,0
30776,2019-08-15,565,0,565,45,610,610,0,0
30777,2019-08-15,593,0,593,47,640,640,0,0
30778,2019-08-15,518,0,518,32,550,550,0,0
30779,2019-08-15,899,0,899,71,970,970,0,0
30780,2019-08-15,528,0,528,42,570,570,0,0
30781,2019-08-15,445,0,445,35,480,480,0,0
30782,2019-08-15,167,0,167,13,180,180,0,0
30783,2019-08-15,278,0,278,22,300,300,0,0
30784,2019-08-15,3630,0,3630,290,3920,3920,0,0
30785,2019-08-15,760,0,760,60,820,820,0,0
30786,2019-08-15,1010,0,1010,80,1090,1090,0,0
30787,2019-08-15,1139,0,1139,91,1230,1230,0,0
30788,2019-08-15,1815,0,1815,145,1960,1960,0,0
30789,2019-08-15,1815,0,1815,145,1960,1960,0,0
30790,2019-08-15,908,0,908,72,980,980,0,0
30791,2019-08-15,3186,0,3186,254,3440,0,3440,0
30792,2019-08-15,3630,0,3630,290,3920,3920,0,0
30793,2019-08-15,1417,0,1417,113,1530,1530,0,0
30794,2019-08-15,1389,0,1389,111,1500,1500,0,0
30795,2019-08-15,1093,0,1093,87,1180,1180,0,0
30796,2019-08-15,825,0,825,65,890,890,0,0
30797,2019-08-15,2102,0,2102,168,2270,2270,0,0
30798,2019-08-15,751,0,751,59,810,810,0,0
30799,2019-08-15,2723,0,2723,217,2940,2940,0,0
30800,2019-08-15,593,0,593,47,640,640,0,0
30801,2019-08-15,1695,0,1695,135,1830,1830,0,0
30802,2019-08-15,584,0,584,46,630,630,0,0
30803,2019-08-15,167,0,167,13,180,180,0,0
30804,2019-08-15,288,0,288,22,310,310,0,0
30805,2019-08-15,250,0,250,20,270,270,0,0
30806,2019-08-15,1806,0,1806,144,1950,0,1950,0
30807,2019-08-15,1686,0,1686,134,1820,1820,0,0
30808,2019-08-15,584,0,584,46,630,630,0,0
30809,2019-08-15,1407,0,1407,103,1510,0,0,1510
30810,2019-08-15,269,0,269,21,290,290,0,0
30811,2019-08-15,278,0,278,22,300,300,0,0
30812,2019-08-15,251,0,251,19,270,270,0,0
30813,2019-08-15,2075,0,2075,165,2240,2240,0,0
30814,2019-08-15,1621,0,1621,129,1750,1750,0,0
30815,2019-08-15,908,0,908,72,980,980,0,0
30816,2019-08-15,371,0,371,29,400,400,0,0
30817,2019-08-15,260,0,260,20,280,280,0,0
30818,2019-08-15,973,0,973,77,1050,1050,0,0
30819,2019-08-15,573,0,573,37,610,610,0,0
30820,2019-08-15,1149,0,1149,91,1240,1240,0,0
30821,2019-08-15,408,0,408,32,440,440,0,0
30822,2019-08-15,1315,0,1315,105,1420,1420,0,0
30823,2019-08-15,186,0,186,14,200,200,0,0
30824,2019-08-15,297,0,297,23,320,320,0,0
30825,2019-08-15,1538,0,1538,122,1660,1660,0,0
30826,2019-08-15,1343,0,1343,107,1450,0,0,1450
30827,2019-08-15,269,0,269,21,290,290,0,0
30828,2019-08-15,297,0,297,23,320,320,0,0
30829,2019-08-15,436,0,436,34,470,470,0,0
30830,2019-08-15,1436,0,1436,114,1550,1550,0,0
30831,2019-08-15,277,0,277,13,290,290,0,0
30832,2019-08-15,861,0,861,59,920,920,0,0
30833,2019-08-15,1149,0,1149,91,1240,1240,0,0
30834,2019-08-15,278,0,278,22,300,300,0,0
30835,2019-08-15,1037,-111,926,73,999,999,0,0
30836,2019-08-15,93,0,93,7,100,100,0,0
30837,2019-08-15,3167,0,3167,253,3420,3420,0,0
30838,2019-08-15,315,0,315,25,340,340,0,0
30839,2019-08-15,797,0,797,63,860,860,0,0
30840,2019-08-15,1075,0,1075,85,1160,0,1160,0
30841,2019-08-15,1417,0,1417,113,1530,1530,0,0
30842,2019-08-15,445,0,445,35,480,480,0,0
30843,2019-08-15,389,0,389,31,420,420,0,0
30844,2019-08-15,1417,0,1417,113,1530,1530,0,0
30845,2019-08-15,2297,0,2297,183,2480,2480,0,0
30846,2019-08-15,2297,0,2297,183,2480,2480,0,0
30847,2019-08-15,269,0,269,21,290,290,0,0
30848,2019-08-15,-2297,0,-2297,-183,-2480,-2480,0,0
30849,2019-08-15,445,0,445,35,480,480,0,0
30850,2019-08-15,704,0,704,56,760,760,0,0
30851,2019-08-15,1038,0,1038,82,1120,1120,0,0
30852,2019-08-15,1658,0,1658,132,1790,1790,0,0
30853,2019-08-15,121,0,121,9,130,130,0,0
30854,2019-08-15,351,0,351,19,370,370,0,0
30855,2019-08-15,1288,0,1288,102,1390,1390,0,0
30856,2019-08-15,463,0,463,37,500,500,0,0
30857,2019-08-15,491,0,491,39,530,0,530,0
30858,2019-08-15,990,0,990,70,1060,1060,0,0
30859,2019-08-15,1815,0,1815,145,1960,1960,0,0
30860,2019-08-15,4538,0,4538,362,4900,0,4900,0
30861,2019-08-15,908,0,908,72,980,980,0,0
30862,2019-08-15,908,0,908,72,980,980,0,0
30863,2019-08-15,908,0,908,72,980,980,0,0
30864,2019-08-15,473,0,473,37,510,510,0,0
30865,2019-08-15,1195,0,1195,95,1290,1290,0,0
30866,2019-08-15,862,0,862,68,930,930,0,0
30867,2019-08-15,538,0,538,42,580,580,0,0
30868,2019-08-15,1815,0,1815,145,1960,0,1960,0
30869,2019-08-15,1278,0,1278,102,1380,1380,0,0
30870,2019-08-15,926,0,926,74,1000,1000,0,0
30871,2019-08-15,936,0,936,74,1010,1010,0,0
30872,2019-08-15,963,0,963,77,1040,1040,0,0
30873,2019-08-15,639,0,639,51,690,690,0,0
30874,2019-08-15,1286,0,1286,94,1380,1380,0,0
30875,2019-08-15,1852,0,1852,148,2000,2000,0,0
30876,2019-08-15,139,0,139,11,150,0,150,0
30877,2019-08-15,908,0,908,72,980,980,0,0
30878,2019-08-15,908,0,908,72,980,980,0,0
30879,2019-08-15,241,0,241,19,260,260,0,0
30880,2019-08-15,723,0,723,57,780,780,0,0
30881,2019-08-15,908,0,908,72,980,980,0,0
30882,2019-08-15,1129,0,1129,81,1210,1210,0,0
30883,2019-08-15,417,0,417,33,450,450,0,0
30884,2019-08-15,362,0,362,28,390,390,0,0
30885,2019-08-15,1732,0,1732,138,1870,1870,0,0
30886,2019-08-15,269,0,269,21,290,290,0,0
30887,2019-08-15,1815,0,1815,145,1960,1960,0,0
30888,2019-08-15,167,0,167,13,180,180,0,0
30889,2019-08-15,463,0,463,37,500,500,0,0
30890,2019-08-15,908,0,908,72,980,980,0,0
30891,2019-08-15,908,0,908,72,980,980,0,0
30892,2019-08-15,908,0,908,72,980,980,0,0
30893,2019-08-15,2101,0,2101,159,2260,2260,0,0
30894,2019-08-15,519,0,519,41,560,560,0,0
30895,2019-08-15,371,0,371,29,400,400,0,0
30896,2019-08-15,3630,0,3630,290,3920,0,3920,0
30897,2019-08-15,908,0,908,72,980,980,0,0
30898,2019-08-15,749,0,749,51,800,0,800,0
30899,2019-08-15,371,0,371,29,400,400,0,0
30900,2019-08-16,889,0,889,71,960,960,0,0
30901,2019-08-16,1815,0,1815,145,1960,1960,0,0
30902,2019-08-16,797,0,797,63,860,860,0,0
30903,2019-08-16,732,0,732,58,790,790,0,0
30904,2019-08-16,871,0,871,69,940,940,0,0
30905,2019-08-16,532,-57,475,38,513,513,0,0
30906,2019-08-16,278,0,278,22,300,300,0,0
30907,2019-08-16,241,0,241,19,260,260,0,0
30908,2019-08-16,1676,0,1676,134,1810,1810,0,0
30909,2019-08-16,306,0,306,24,330,330,0,0
30910,2019-08-16,1445,0,1445,115,1560,1560,0,0
30911,2019-08-16,2723,0,2723,217,2940,0,2940,0
30912,2019-08-16,551,-59,492,39,531,531,0,0
30913,2019-08-16,1732,0,1732,138,1870,1870,0,0
30914,2019-08-16,528,0,528,42,570,570,0,0
30915,2019-08-16,741,0,741,59,800,800,0,0
30916,2019-08-16,1278,0,1278,102,1380,1380,0,0
30917,2019-08-16,908,0,908,72,980,980,0,0
30918,2019-08-16,1138,0,1138,82,1220,1220,0,0
30919,2019-08-16,241,0,241,19,260,260,0,0
30920,2019-08-16,908,0,908,72,980,980,0,0
30921,2019-08-16,908,0,908,72,980,980,0,0
30922,2019-08-16,1027,-110,917,73,990,990,0,0
30923,2019-08-16,510,0,510,40,550,550,0,0
30924,2019-08-16,908,0,908,72,980,980,0,0
30925,2019-08-16,269,0,269,21,290,290,0,0
30926,2019-08-16,519,0,519,41,560,560,0,0
30927,2019-08-16,463,0,463,37,500,500,0,0
30928,2019-08-16,306,0,306,24,330,330,0,0
30929,2019-08-16,102,0,102,8,110,110,0,0
30930,2019-08-16,463,0,463,37,500,500,0,0
30931,2019-08-16,1232,0,1232,98,1330,1330,0,0
30932,2019-08-16,315,0,315,25,340,0,0,340
30933,2019-08-16,1815,0,1815,145,1960,1960,0,0
30934,2019-08-16,-389,0,-389,-31,-420,-420,0,0
30935,2019-08-16,-4482,0,-4482,-358,-4840,-4840,0,0
30936,2019-08-16,392,-42,350,28,378,378,0,0
30937,2019-08-16,482,0,482,38,520,520,0,0
30938,2019-08-16,4518,-484,4034,322,4356,4356,0,0
30939,2019-08-16,251,0,251,19,270,270,0,0
30940,2019-08-16,1583,0,1583,117,1700,1700,0,0
30941,2019-08-16,1815,0,1815,145,1960,1960,0,0
30942,2019-08-16,862,0,862,68,930,930,0,0
30943,2019-08-16,2575,0,2575,205,2780,2780,0,0
30944,2019-08-16,1815,0,1815,145,1960,1960,0,0
30945,2019-08-16,926,0,926,74,1000,1000,0,0
30946,2019-08-16,491,0,491,39,530,530,0,0
30947,2019-08-16,575,0,575,45,620,620,0,0
30948,2019-08-16,760,0,760,60,820,820,0,0
30949,2019-08-16,491,0,491,39,530,530,0,0
30950,2019-08-16,389,0,389,31,420,420,0,0
30951,2019-08-16,389,0,389,31,420,420,0,0
30952,2019-08-16,1991,0,1991,159,2150,2150,0,0
30953,2019-08-16,565,0,565,45,610,610,0,0
30954,2019-08-16,371,0,371,29,400,400,0,0
30955,2019-08-16,371,0,371,29,400,400,0,0
30956,2019-08-16,445,0,445,35,480,480,0,0
30957,2019-08-16,389,0,389,31,420,0,0,420
30958,2019-08-16,445,0,445,35,480,480,0,0
30959,2019-08-16,288,0,288,22,310,310,0,0
30960,2019-08-16,1815,0,1815,145,1960,1960,0,0
30961,2019-08-16,1815,0,1815,145,1960,0,0,1960
30962,2019-08-16,1213,0,1213,97,1310,1310,0,0
30963,2019-08-16,445,0,445,35,480,480,0,0
30964,2019-08-16,908,0,908,72,980,980,0,0
30965,2019-08-16,491,0,491,39,530,530,0,0
30966,2019-08-16,778,0,778,62,840,840,0,0
30967,2019-08-16,2638,0,2638,202,2840,2840,0,0
30968,2019-08-16,1102,0,1102,88,1190,1190,0,0
30969,2019-08-16,649,0,649,51,700,700,0,0
30970,2019-08-16,620,0,620,40,660,660,0,0
30971,2019-08-16,612,0,612,48,660,660,0,0
30972,2019-08-16,538,0,538,42,580,580,0,0
30973,2019-08-16,167,0,167,13,180,180,0,0
30974,2019-08-16,908,0,908,72,980,980,0,0
30975,2019-08-16,232,0,232,18,250,250,0,0
30976,2019-08-16,1001,0,1001,79,1080,1080,0,0
30977,2019-08-16,1362,0,1362,108,1470,1470,0,0
30978,2019-08-16,2889,0,2889,231,3120,3120,0,0
30979,2019-08-16,167,0,167,13,180,180,0,0
30980,2019-08-16,723,0,723,57,780,780,0,0
30981,2019-08-16,741,0,741,59,800,800,0,0
30982,2019-08-16,491,0,491,39,530,530,0,0
30983,2019-08-16,1815,0,1815,145,1960,1960,0,0
30984,2019-08-16,1362,0,1362,108,1470,1470,0,0
30985,2019-08-16,926,0,926,74,1000,1000,0,0
30986,2019-08-16,2065,0,2065,165,2230,2230,0,0
30987,2019-08-16,1334,0,1334,106,1440,1440,0,0
30988,2019-08-16,713,0,713,57,770,770,0,0
30989,2019-08-16,204,0,204,16,220,220,0,0
30990,2019-08-16,991,0,991,79,1070,0,1070,0
30991,2019-08-16,556,0,556,44,600,600,0,0
30992,2019-08-16,501,0,501,39,540,540,0,0
30993,2019-08-16,593,0,593,47,640,0,0,640
30994,2019-08-16,704,0,704,56,760,760,0,0
30995,2019-08-16,635,-68,567,45,612,612,0,0
30996,2019-08-16,556,0,556,44,600,600,0,0
30997,2019-08-16,149,0,149,11,160,160,0,0
30998,2019-08-16,889,0,889,71,960,960,0,0
30999,2019-08-16,954,0,954,76,1030,1030,0,0
31000,2019-08-16,519,0,519,41,560,0,0,560
31001,2019-08-16,630,0,630,50,680,680,0,0
31002,2019-08-16,269,0,269,21,290,290,0,0
31003,2019-08-16,602,0,602,48,650,650,0,0
31004,2019-08-16,676,0,676,54,730,730,0,0
31005,2019-08-16,1121,0,1121,89,1210,1210,0,0
31006,2019-08-16,658,0,658,52,710,710,0,0
31007,2019-08-16,1380,0,1380,110,1490,1490,0,0
31008,2019-08-16,510,0,510,40,550,550,0,0
31009,2019-08-16,112,0,112,8,120,120,0,0
31010,2019-08-16,1491,0,1491,119,1610,1610,0,0
31011,2019-08-16,1176,0,1176,94,1270,1270,0,0
31012,2019-08-16,121,0,121,9,130,130,0,0
31013,2019-08-16,288,0,288,22,310,310,0,0
31014,2019-08-16,478,0,478,38,516,516,0,0
31015,2019-08-16,1538,0,1538,122,1660,1660,0,0
31016,2019-08-16,880,0,880,70,950,950,0,0
31017,2019-08-16,204,0,204,16,220,220,0,0
31018,2019-08-16,3630,0,3630,290,3920,3920,0,0
31019,2019-08-16,648,0,648,42,690,690,0,0
31020,2019-08-16,1362,0,1362,108,1470,1470,0,0
31021,2019-08-16,760,0,760,60,820,820,0,0
31022,2019-08-16,149,0,149,11,160,160,0,0
31023,2019-08-16,1408,0,1408,112,1520,1520,0,0
31024,2019-08-16,93,0,93,7,100,100,0,0
31025,2019-08-16,1815,0,1815,145,1960,1960,0,0
31026,2019-08-16,325,0,325,25,350,350,0,0
31027,2019-08-16,954,0,954,76,1030,1030,0,0
31028,2019-08-16,2630,0,2630,210,2840,2840,0,0
31029,2019-08-16,371,0,371,29,400,400,0,0
31030,2019-08-16,908,0,908,72,980,980,0,0
31031,2019-08-16,362,0,362,28,390,390,0,0
31032,2019-08-16,186,0,186,14,200,200,0,0
31033,2019-08-16,250,0,250,20,270,270,0,0
31034,2019-08-16,325,0,325,25,350,350,0,0
31035,2019-08-16,982,0,982,78,1060,1060,0,0
31036,2019-08-16,3556,0,3556,284,3840,3840,0,0
31037,2019-08-16,1408,0,1408,112,1520,1520,0,0
31038,2019-08-16,547,0,547,43,590,590,0,0
31039,2019-08-16,954,0,954,76,1030,1030,0,0
31040,2019-08-16,204,0,204,16,220,220,0,0
31041,2019-08-16,1676,0,1676,134,1810,1810,0,0
31042,2019-08-16,501,0,501,39,540,540,0,0
31043,2019-08-16,1815,0,1815,145,1960,1960,0,0
31044,2019-08-16,667,0,667,53,720,720,0,0
31045,2019-08-16,732,0,732,58,790,790,0,0
31046,2019-08-16,2575,0,2575,205,2780,2780,0,0
31047,2019-08-16,602,0,602,48,650,650,0,0
31048,2019-08-16,1815,0,1815,145,1960,1960,0,0
31049,2019-08-16,277,0,277,13,290,290,0,0
31050,2019-08-16,445,0,445,35,480,480,0,0
31051,2019-08-16,778,0,778,62,840,840,0,0
31052,2019-08-16,463,0,463,37,500,500,0,0
31053,2019-08-16,898,0,898,62,960,0,960,0
31054,2019-08-16,1815,0,1815,145,1960,1960,0,0
31055,2019-08-16,1815,0,1815,145,1960,1960,0,0
31056,2019-08-16,556,0,556,44,600,600,0,0
31057,2019-08-16,1815,0,1815,145,1960,1960,0,0
31058,2019-08-16,583,0,583,37,620,620,0,0
31059,2019-08-16,602,0,602,48,650,650,0,0
31060,2019-08-16,1815,0,1815,145,1960,0,1960,0
31061,2019-08-16,389,0,389,31,420,420,0,0
31062,2019-08-16,389,0,389,31,420,420,0,0
31063,2019-08-16,445,0,445,35,480,480,0,0
31064,2019-08-16,1130,0,1130,90,1220,1220,0,0
31065,2019-08-16,4482,0,4482,358,4840,4840,0,0
31066,2019-08-16,2426,0,2426,194,2620,2620,0,0
31067,2019-08-16,1036,0,1036,74,1110,1110,0,0
31068,2019-08-16,584,0,584,46,630,630,0,0
31069,2019-08-16,491,0,491,39,530,530,0,0
31070,2019-08-16,334,0,334,26,360,360,0,0
31071,2019-08-16,167,0,167,13,180,180,0,0
31072,2019-08-16,251,0,251,19,270,270,0,0
31073,2019-08-16,112,0,112,8,120,120,0,0
31074,2019-08-16,112,0,112,8,120,120,0,0
31075,2019-08-16,491,0,491,39,530,530,0,0
31076,2019-08-16,695,0,695,55,750,750,0,0
31077,2019-08-16,788,0,788,62,850,850,0,0
31078,2019-08-16,426,0,426,34,460,460,0,0
31079,2019-08-16,278,0,278,22,300,300,0,0
31080,2019-08-16,751,0,751,59,810,810,0,0
31081,2019-08-16,1815,0,1815,145,1960,1960,0,0
31082,2019-08-16,602,0,602,48,650,650,0,0
31083,2019-08-16,1815,0,1815,145,1960,1960,0,0
31084,2019-08-16,963,0,963,77,1040,1040,0,0
31085,2019-08-16,1815,0,1815,145,1960,1960,0,0
31086,2019-08-16,1815,0,1815,145,1960,1960,0,0
31087,2019-08-16,306,0,306,24,330,330,0,0
31088,2019-08-17,1778,0,1778,142,1920,1920,0,0
31089,2019-08-17,139,0,139,11,150,150,0,0
31090,2019-08-17,1556,0,1556,124,1680,1680,0,0
31091,2019-08-17,389,0,389,31,420,420,0,0
31092,2019-08-17,399,0,399,31,430,430,0,0
31093,2019-08-17,630,0,630,50,680,680,0,0
31094,2019-08-17,269,0,269,21,290,290,0,0
31095,2019-08-17,621,0,621,49,670,670,0,0
31096,2019-08-17,1352,0,1352,108,1460,0,0,1460
31097,2019-08-17,417,0,417,33,450,450,0,0
31098,2019-08-17,612,0,612,48,660,0,660,0
31099,2019-08-17,1010,0,1010,80,1090,1090,0,0
31100,2019-08-17,889,0,889,71,960,960,0,0
31101,2019-08-17,926,0,926,74,1000,1000,0,0
31102,2019-08-17,1038,0,1038,82,1120,1120,0,0
31103,2019-08-17,510,0,510,40,550,550,0,0
31104,2019-08-17,411,-44,367,29,396,396,0,0
31105,2019-08-17,908,0,908,72,980,980,0,0
31106,2019-08-17,1288,0,1288,102,1390,1390,0,0
31107,2019-08-17,917,0,917,73,990,990,0,0
31108,2019-08-17,186,0,186,14,200,200,0,0
31109,2019-08-17,1815,0,1815,145,1960,1960,0,0
31110,2019-08-17,1815,0,1815,145,1960,1960,0,0
31111,2019-08-17,408,0,408,32,440,440,0,0
31112,2019-08-17,1834,0,1834,146,1980,0,1980,0
31113,2019-08-17,933,0,933,57,990,0,990,0
31114,2019-08-17,249,0,249,11,260,260,0,0
31115,2019-08-17,1028,0,1028,82,1110,1110,0,0
31116,2019-08-17,908,0,908,72,980,0,980,0
31117,2019-08-17,908,0,908,72,980,980,0,0
31118,2019-08-17,1102,-118,984,78,1062,0,0,1062
31119,2019-08-17,482,0,482,38,520,520,0,0
31120,2019-08-17,1815,0,1815,145,1960,1960,0,0
31121,2019-08-17,241,0,241,19,260,260,0,0
31122,2019-08-17,3389,0,3389,271,3660,3660,0,0
31123,2019-08-17,1213,0,1213,97,1310,1310,0,0
31124,2019-08-17,1815,0,1815,145,1960,1960,0,0
31125,2019-08-17,1815,0,1815,145,1960,1960,0,0
31126,2019-08-17,1686,0,1686,134,1820,1820,0,0
31127,2019-08-17,908,0,908,72,980,980,0,0
31128,2019-08-17,908,0,908,72,980,980,0,0
31129,2019-08-17,501,0,501,39,540,540,0,0
31130,2019-08-17,908,0,908,72,980,980,0,0
31131,2019-08-17,908,0,908,72,980,980,0,0
31132,2019-08-17,343,0,343,27,370,370,0,0
31133,2019-08-17,116,0,116,9,125,125,0,0
31134,2019-08-17,760,0,760,60,820,820,0,0
31135,2019-08-17,778,0,778,62,840,840,0,0
31136,2019-08-17,722,0,722,48,770,770,0,0
31137,2019-08-17,778,0,778,62,840,840,0,0
31138,2019-08-17,306,0,306,24,330,330,0,0
31139,2019-08-17,334,0,334,26,360,360,0,0
31140,2019-08-17,1815,0,1815,145,1960,1960,0,0
31141,2019-08-17,769,0,769,61,830,830,0,0
31142,2019-08-17,565,0,565,45,610,610,0,0
31143,2019-08-17,1639,0,1639,131,1770,1770,0,0
31144,2019-08-17,936,0,936,74,1010,1010,0,0
31145,2019-08-17,1038,0,1038,82,1120,1120,0,0
31146,2019-08-17,880,0,880,70,950,950,0,0
31147,2019-08-17,723,0,723,57,780,780,0,0
31148,2019-08-17,389,0,389,31,420,420,0,0
31149,2019-08-17,260,0,260,20,280,280,0,0
31150,2019-08-17,584,0,584,46,630,630,0,0
31151,2019-08-17,556,0,556,44,600,600,0,0
31152,2019-08-17,426,0,426,34,460,460,0,0
31153,2019-08-17,408,0,408,32,440,440,0,0
31154,2019-08-17,815,0,815,65,880,880,0,0
31155,2019-08-17,1232,0,1232,98,1330,1330,0,0
31156,2019-08-17,751,0,751,59,810,810,0,0
31157,2019-08-17,908,0,908,72,980,980,0,0
31158,2019-08-17,908,0,908,72,980,980,0,0
31159,2019-08-17,1815,0,1815,145,1960,1960,0,0
31160,2019-08-17,168,-18,150,12,162,162,0,0
31161,2019-08-17,1084,0,1084,86,1170,1170,0,0
31162,2019-08-17,1371,0,1371,109,1480,1480,0,0
31163,2019-08-17,249,0,249,11,260,260,0,0
31164,2019-08-17,1815,0,1815,145,1960,0,1960,0
31165,2019-08-17,1482,0,1482,118,1600,1600,0,0
31166,2019-08-17,501,0,501,39,540,540,0,0
31167,2019-08-17,269,0,269,21,290,290,0,0
31168,2019-08-17,1936,0,1936,154,2090,2090,0,0
31169,2019-08-17,2047,0,2047,163,2210,2210,0,0
31170,2019-08-17,181,0,181,14,195,195,0,0
31171,2019-08-17,510,0,510,40,550,550,0,0
31172,2019-08-17,232,0,232,18,250,250,0,0
31173,2019-08-17,2028,0,2028,162,2190,0,2190,0
31174,2019-08-17,575,0,575,45,620,620,0,0
31175,2019-08-17,584,0,584,46,630,630,0,0
31176,2019-08-17,686,0,686,54,740,740,0,0
31177,2019-08-17,1065,0,1065,85,1150,1150,0,0
31178,2019-08-17,139,0,139,11,150,150,0,0
31179,2019-08-17,788,0,788,62,850,850,0,0
31180,2019-08-17,1917,0,1917,153,2070,2070,0,0
31181,2019-08-17,315,0,315,25,340,340,0,0
31182,2019-08-17,945,0,945,75,1020,1020,0,0
31183,2019-08-17,149,0,149,11,160,160,0,0
31184,2019-08-17,630,0,630,50,680,0,680,0
31185,2019-08-17,297,0,297,23,320,320,0,0
31186,2019-08-17,2843,0,2843,227,3070,3070,0,0
31187,2019-08-17,315,0,315,25,340,340,0,0
31188,2019-08-17,399,0,399,31,430,430,0,0
31189,2019-08-17,1344,-144,1200,96,1296,1296,0,0
31190,2019-08-17,278,0,278,22,300,300,0,0
31191,2019-08-17,371,0,371,29,400,400,0,0
31192,2019-08-17,1158,0,1158,92,1250,1250,0,0
31193,2019-08-17,510,0,510,40,550,550,0,0
31194,2019-08-17,93,0,93,7,100,100,0,0
31195,2019-08-17,1630,0,1630,130,1760,1760,0,0
31196,2019-08-17,852,0,852,68,920,920,0,0
31197,2019-08-17,769,0,769,61,830,830,0,0
31198,2019-08-17,1056,0,1056,84,1140,1140,0,0
31199,2019-08-17,1213,0,1213,97,1310,1310,0,0
31200,2019-08-17,278,0,278,22,300,300,0,0
31201,2019-08-17,251,0,251,19,270,270,0,0
31202,2019-08-17,710,-76,634,50,684,684,0,0
31203,2019-08-17,631,-134,497,39,536,536,0,0
31204,2019-08-17,389,0,389,31,420,420,0,0
31205,2019-08-17,991,0,991,79,1070,1070,0,0
31206,2019-08-17,1815,0,1815,145,1960,1960,0,0
31207,2019-08-17,1379,0,1379,101,1480,0,0,1480
31208,2019-08-17,908,0,908,72,980,980,0,0
31209,2019-08-17,4538,0,4538,362,4900,4900,0,0
31210,2019-08-17,2454,0,2454,196,2650,2650,0,0
31211,2019-08-17,1334,0,1334,106,1440,1440,0,0
31212,2019-08-17,2723,0,2723,217,2940,2940,0,0
31213,2019-08-17,1926,0,1926,154,2080,0,2080,0
31214,2019-08-17,2260,0,2260,180,2440,2440,0,0
31215,2019-08-17,204,0,204,16,220,220,0,0
31216,2019-08-17,2963,0,2963,237,3200,0,3200,0
31217,2019-08-17,269,0,269,21,290,290,0,0
31218,2019-08-17,612,0,612,48,660,660,0,0
31219,2019-08-17,954,0,954,76,1030,1030,0,0
31220,2019-08-17,1473,0,1473,117,1590,1590,0,0
31221,2019-08-17,778,0,778,62,840,840,0,0
31222,2019-08-17,2176,0,2176,174,2350,2350,0,0
31223,2019-08-17,593,0,593,47,640,0,640,0
31224,2019-08-17,1815,0,1815,145,1960,1960,0,0
31225,2019-08-17,1223,0,1223,97,1320,0,0,1320
31226,2019-08-17,389,0,389,31,420,420,0,0
31227,2019-08-17,1815,0,1815,145,1960,1960,0,0
31228,2019-08-17,174,0,174,13,187,187,0,0
31229,2019-08-17,232,0,232,18,250,250,0,0
31230,2019-08-17,181,0,181,14,195,195,0,0
31231,2019-08-17,1686,0,1686,134,1820,0,1820,0
31232,2019-08-17,352,0,352,28,380,380,0,0
31233,2019-08-17,4538,0,4538,362,4900,4900,0,0
31234,2019-08-17,251,0,251,19,270,270,0,0
31235,2019-08-17,399,0,399,31,430,430,0,0
31236,2019-08-17,908,0,908,72,980,980,0,0
31237,2019-08-17,908,0,908,72,980,980,0,0
31238,2019-08-17,908,0,908,72,980,980,0,0
31239,2019-08-17,908,0,908,72,980,980,0,0
31240,2019-08-17,908,0,908,72,980,980,0,0
31241,2019-08-17,1278,0,1278,102,1380,0,0,1380
31242,2019-08-17,1815,0,1815,145,1960,1960,0,0
31243,2019-08-18,797,0,797,63,860,860,0,0
31244,2019-08-18,1649,0,1649,131,1780,1780,0,0
31245,2019-08-18,1232,0,1232,98,1330,1330,0,0
31246,2019-08-18,908,0,908,72,980,980,0,0
31247,2019-08-18,908,0,908,72,980,980,0,0
31248,2019-08-18,299,-32,267,21,288,288,0,0
31249,2019-08-18,547,0,547,43,590,590,0,0
31250,2019-08-18,1815,0,1815,145,1960,1960,0,0
31251,2019-08-18,408,0,408,32,440,440,0,0
31252,2019-08-18,1565,0,1565,125,1690,1690,0,0
31253,2019-08-18,380,0,380,30,410,410,0,0
31254,2019-08-18,1158,0,1158,92,1250,1250,0,0
31255,2019-08-18,713,0,713,57,770,770,0,0
31256,2019-08-18,1010,0,1010,80,1090,1090,0,0
31257,2019-08-18,352,0,352,28,380,380,0,0
31258,2019-08-18,704,0,704,56,760,760,0,0
31259,2019-08-18,408,0,408,32,440,440,0,0
31260,2019-08-18,1158,0,1158,92,1250,1250,0,0
31261,2019-08-18,380,0,380,30,410,410,0,0
31262,2019-08-18,899,0,899,71,970,970,0,0
31263,2019-08-18,241,0,241,19,260,260,0,0
31264,2019-08-18,1176,0,1176,94,1270,1270,0,0
31265,2019-08-18,788,0,788,62,850,850,0,0
31266,2019-08-18,908,0,908,72,980,980,0,0
31267,2019-08-18,260,0,260,20,280,280,0,0
31268,2019-08-18,908,0,908,72,980,980,0,0
31269,2019-08-18,362,0,362,28,390,390,0,0
31270,2019-08-18,2251,0,2251,179,2430,2430,0,0
31271,2019-08-18,889,0,889,71,960,960,0,0
31272,2019-08-18,1038,0,1038,82,1120,1120,0,0
31273,2019-08-18,778,0,778,62,840,840,0,0
31274,2019-08-18,945,0,945,75,1020,1020,0,0
31275,2019-08-18,371,0,371,29,400,400,0,0
31276,2019-08-18,1788,0,1788,142,1930,1930,0,0
31277,2019-08-18,306,0,306,24,330,330,0,0
31278,2019-08-18,250,0,250,20,270,270,0,0
31279,2019-08-18,704,0,704,56,760,760,0,0
31280,2019-08-18,908,0,908,72,980,980,0,0
31281,2019-08-18,149,0,149,11,160,160,0,0
31282,2019-08-18,778,0,778,62,840,840,0,0
31283,2019-08-18,834,0,834,66,900,900,0,0
31284,2019-08-18,1232,0,1232,98,1330,1330,0,0
31285,2019-08-18,1815,0,1815,145,1960,1960,0,0
31286,2019-08-18,1815,0,1815,145,1960,1960,0,0
31287,2019-08-18,1861,0,1861,139,2000,2000,0,0
31288,2019-08-18,1815,0,1815,145,1960,1960,0,0
31289,2019-08-18,649,0,649,51,700,700,0,0
31290,2019-08-18,232,0,232,18,250,250,0,0
31291,2019-08-18,1297,0,1297,103,1400,0,1400,0
31292,2019-08-18,621,0,621,49,670,670,0,0
31293,2019-08-18,1815,0,1815,145,1960,1960,0,0
31294,2019-08-18,417,0,417,33,450,450,0,0
31295,2019-08-18,991,0,991,79,1070,1070,0,0
31296,2019-08-18,908,0,908,72,980,980,0,0
31297,2019-08-18,575,0,575,45,620,620,0,0
31298,2019-08-18,260,0,260,20,280,280,0,0
31299,2019-08-18,476,-51,425,34,459,459,0,0
31300,2019-08-18,1686,0,1686,134,1820,1820,0,0
31301,2019-08-18,1463,0,1463,117,1580,1580,0,0
31302,2019-08-18,538,0,538,42,580,580,0,0
31303,2019-08-18,732,0,732,58,790,790,0,0
31304,2019-08-18,768,0,768,52,820,820,0,0
31305,2019-08-18,1129,0,1129,81,1210,1210,0,0
31306,2019-08-18,176,0,176,14,190,190,0,0
31307,2019-08-18,908,0,908,72,980,980,0,0
31308,2019-08-18,249,0,249,11,260,260,0,0
31309,2019-08-18,1815,0,1815,145,1960,1960,0,0
31310,2019-08-18,908,0,908,72,980,980,0,0
31311,2019-08-18,186,0,186,14,200,200,0,0
31312,2019-08-18,167,0,167,13,180,180,0,0
31313,2019-08-18,908,0,908,72,980,980,0,0
31314,2019-08-18,908,0,908,72,980,980,0,0
31315,2019-08-18,908,0,908,72,980,980,0,0
31316,2019-08-18,1176,0,1176,94,1270,1270,0,0
31317,2019-08-18,741,0,741,59,800,800,0,0
31318,2019-08-18,676,0,676,54,730,730,0,0
31319,2019-08-18,1575,0,1575,125,1700,1700,0,0
31320,2019-08-18,241,0,241,19,260,260,0,0
31321,2019-08-18,1445,0,1445,115,1560,1560,0,0
31322,2019-08-18,676,0,676,54,730,0,730,0
31323,2019-08-18,676,0,676,54,730,730,0,0
31324,2019-08-18,797,0,797,63,860,860,0,0
31325,2019-08-18,398,0,398,22,420,420,0,0
31326,2019-08-18,417,0,417,33,450,450,0,0
31327,2019-08-18,658,0,658,52,710,710,0,0
31328,2019-08-18,167,0,167,13,180,180,0,0
31329,2019-08-18,139,0,139,11,150,150,0,0
31330,2019-08-18,399,0,399,31,430,430,0,0
31331,2019-08-18,399,0,399,31,430,430,0,0
31332,2019-08-18,269,0,269,21,290,290,0,0
31333,2019-08-18,998,-212,786,62,848,848,0,0
31334,2019-08-18,834,0,834,66,900,900,0,0
31335,2019-08-18,408,0,408,32,440,440,0,0
31336,2019-08-18,649,0,649,51,700,700,0,0
31337,2019-08-18,1825,0,1825,145,1970,1970,0,0
31338,2019-08-18,1556,0,1556,124,1680,1680,0,0
31339,2019-08-18,973,0,973,77,1050,1050,0,0
31340,2019-08-18,491,0,491,39,530,530,0,0
31341,2019-08-18,453,-48,405,32,437,437,0,0
31342,2019-08-18,371,0,371,29,400,400,0,0
31343,2019-08-18,491,0,491,39,530,530,0,0
31344,2019-08-18,667,0,667,53,720,720,0,0
31345,2019-08-18,542,-58,484,38,522,522,0,0
31346,2019-08-18,630,0,630,50,680,680,0,0
31347,2019-08-18,908,0,908,72,980,980,0,0
31348,2019-08-18,445,0,445,35,480,480,0,0
31349,2019-08-18,232,0,232,18,250,250,0,0
31350,2019-08-18,232,0,232,18,250,250,0,0
31351,2019-08-18,565,0,565,45,610,610,0,0
31352,2019-08-18,1139,0,1139,91,1230,1230,0,0
31353,2019-08-18,271,-29,242,19,261,261,0,0
31354,2019-08-18,658,0,658,52,710,710,0,0
31355,2019-08-18,1038,0,1038,82,1120,1120,0,0
31356,2019-08-18,936,0,936,74,1010,1010,0,0
31357,2019-08-18,334,0,334,26,360,360,0,0
31358,2019-08-18,325,0,325,25,350,350,0,0
31359,2019-08-18,1575,0,1575,125,1700,1700,0,0
31360,2019-08-18,788,0,788,62,850,850,0,0
31361,2019-08-18,297,0,297,23,320,320,0,0
31362,2019-08-18,1575,0,1575,125,1700,1700,0,0
31363,2019-08-18,1575,0,1575,125,1700,1700,0,0
31364,2019-08-18,139,0,139,11,150,150,0,0
31365,2019-08-18,621,0,621,49,670,670,0,0
31366,2019-08-18,167,0,167,13,180,180,0,0
31367,2019-08-18,1352,0,1352,108,1460,1460,0,0
31368,2019-08-18,954,0,954,76,1030,1030,0,0
31369,2019-08-18,1112,0,1112,88,1200,1200,0,0
31370,2019-08-18,973,0,973,77,1050,1050,0,0
31371,2019-08-18,232,0,232,18,250,250,0,0
31372,2019-08-18,241,0,241,19,260,260,0,0
31373,2019-08-18,778,0,778,62,840,840,0,0
31374,2019-08-18,1342,0,1342,98,1440,1440,0,0
31375,2019-08-18,1575,0,1575,125,1700,1700,0,0
31376,2019-08-18,2362,0,2362,188,2550,2550,0,0
31377,2019-08-18,1889,0,1889,151,2040,2040,0,0
31378,2019-08-18,924,0,924,56,980,980,0,0
31379,2019-08-18,334,0,334,26,360,360,0,0
31380,2019-08-18,1575,0,1575,125,1700,1700,0,0
31381,2019-08-18,1575,0,1575,125,1700,1700,0,0
31382,2019-08-18,519,0,519,41,560,560,0,0
31383,2019-08-18,565,0,565,45,610,610,0,0
31384,2019-08-18,547,0,547,43,590,590,0,0
31385,2019-08-18,482,0,482,38,520,520,0,0
31386,2019-08-18,788,0,788,62,850,850,0,0
31387,2019-08-18,788,0,788,62,850,850,0,0
31388,2019-08-18,436,0,436,34,470,470,0,0
31389,2019-08-18,963,0,963,77,1040,1040,0,0
31390,2019-08-18,649,0,649,51,700,700,0,0
31391,2019-08-18,1334,0,1334,106,1440,1440,0,0
31392,2019-08-18,2399,0,2399,191,2590,0,2590,0
31393,2019-08-18,2362,0,2362,188,2550,2550,0,0
31394,2019-08-18,788,0,788,62,850,0,850,0
31395,2019-08-18,2362,0,2362,188,2550,2550,0,0
31396,2019-08-19,75,0,75,5,80,80,0,0
31397,2019-08-19,1815,0,1815,145,1960,1960,0,0
31398,2019-08-19,575,0,575,45,620,620,0,0
31399,2019-08-19,797,0,797,63,860,860,0,0
31400,2019-08-19,621,0,621,49,670,670,0,0
31401,2019-08-19,436,0,436,34,470,470,0,0
31402,2019-08-19,334,0,334,26,360,360,0,0
31403,2019-08-19,1830,-196,1634,130,1764,1764,0,0
31404,2019-08-19,454,0,454,36,490,490,0,0
31405,2019-08-19,380,0,380,30,410,410,0,0
31406,2019-08-19,445,0,445,35,480,480,0,0
31407,2019-08-19,593,0,593,47,640,0,0,640
31408,2019-08-19,426,0,426,34,460,460,0,0
31409,2019-08-19,899,0,899,71,970,970,0,0
31410,2019-08-19,1119,0,1119,71,1190,1190,0,0
31411,2019-08-19,1815,0,1815,145,1960,1960,0,0
31412,2019-08-19,769,0,769,61,830,830,0,0
31413,2019-08-19,945,0,945,75,1020,0,1020,0
31414,2019-08-19,704,0,704,56,760,760,0,0
31415,2019-08-19,176,0,176,14,190,190,0,0
31416,2019-08-19,213,0,213,17,230,230,0,0
31417,2019-08-19,426,0,426,34,460,460,0,0
31418,2019-08-19,389,0,389,31,420,420,0,0
31419,2019-08-19,167,0,167,13,180,180,0,0
31420,2019-08-19,1621,0,1621,129,1750,1750,0,0
31421,2019-08-19,1538,0,1538,122,1660,1660,0,0
31422,2019-08-19,445,0,445,35,480,480,0,0
31423,2019-08-19,352,0,352,28,380,380,0,0
31424,2019-08-19,1695,0,1695,135,1830,1830,0,0
31425,2019-08-19,908,0,908,72,980,980,0,0
31426,2019-08-19,1815,0,1815,145,1960,1960,0,0
31427,2019-08-19,1167,0,1167,93,1260,1260,0,0
31428,2019-08-19,862,0,862,68,930,930,0,0
31429,2019-08-19,528,0,528,42,570,0,570,0
31430,2019-08-19,491,0,491,39,530,530,0,0
31431,2019-08-19,352,0,352,28,380,380,0,0
31432,2019-08-19,371,0,371,29,400,400,0,0
31433,2019-08-19,3999,0,3999,311,4310,4310,0,0
31434,2019-08-19,362,0,362,28,390,390,0,0
31435,2019-08-19,491,0,491,39,530,530,0,0
31436,2019-08-19,926,0,926,74,1000,1000,0,0
31437,2019-08-19,772,-164,608,48,656,656,0,0
31438,2019-08-19,686,0,686,54,740,740,0,0
31439,2019-08-19,602,0,602,48,650,650,0,0
31440,2019-08-19,973,0,973,77,1050,1050,0,0
31441,2019-08-19,945,0,945,75,1020,1020,0,0
31442,2019-08-19,426,0,426,34,460,460,0,0
31443,2019-08-19,454,0,454,36,490,490,0,0
31444,2019-08-19,1027,0,1027,73,1100,1100,0,0
31445,2019-08-19,630,0,630,50,680,680,0,0
31446,2019-08-19,1047,0,1047,83,1130,1130,0,0
31447,2019-08-19,1047,0,1047,83,1130,1130,0,0
31448,2019-08-19,908,0,908,72,980,980,0,0
31449,2019-08-19,1815,0,1815,145,1960,1960,0,0
31450,2019-08-19,630,0,630,50,680,680,0,0
31451,2019-08-19,982,0,982,78,1060,1060,0,0
31452,2019-08-19,630,0,630,50,680,680,0,0
31453,2019-08-19,621,0,621,49,670,670,0,0
31454,2019-08-19,1843,0,1843,147,1990,1990,0,0
31455,2019-08-19,954,0,954,76,1030,1030,0,0
31456,2019-08-19,1019,0,1019,81,1100,1100,0,0
31457,2019-08-19,759,0,759,51,810,810,0,0
31458,2019-08-19,806,0,806,64,870,870,0,0
31459,2019-08-19,788,0,788,62,850,850,0,0
31460,2019-08-19,232,0,232,18,250,250,0,0
31461,2019-08-19,249,0,249,11,260,260,0,0
31462,2019-08-19,565,-120,445,35,480,480,0,0
31463,2019-08-19,556,0,556,44,600,600,0,0
31464,2019-08-19,528,0,528,42,570,570,0,0
31465,2019-08-19,186,0,186,14,200,200,0,0
31466,2019-08-19,24,0,24,1,25,25,0,0
31467,2019-08-19,1186,0,1186,94,1280,1280,0,0
31468,2019-08-19,1093,0,1093,87,1180,1180,0,0
31469,2019-08-19,1158,0,1158,92,1250,0,1250,0
31470,2019-08-19,1325,0,1325,105,1430,1430,0,0
31471,2019-08-19,2158,0,2158,172,2330,0,2330,0
31472,2019-08-19,620,0,620,40,660,660,0,0
31473,2019-08-19,389,0,389,31,420,420,0,0
31474,2019-08-19,288,0,288,22,310,310,0,0
31475,2019-08-19,1510,0,1510,120,1630,1630,0,0
31476,2019-08-19,222,0,222,8,230,230,0,0
31477,2019-08-19,778,0,778,62,840,840,0,0
31478,2019-08-19,907,0,907,63,970,970,0,0
31479,2019-08-19,343,0,343,27,370,0,370,0
31480,2019-08-19,102,0,102,8,110,110,0,0
31481,2019-08-19,2611,0,2611,199,2810,2810,0,0
31482,2019-08-19,1017,-216,801,63,864,864,0,0
31483,2019-08-19,370,0,370,20,390,390,0,0
31484,2019-08-19,306,0,306,24,330,330,0,0
31485,2019-08-19,797,0,797,63,860,860,0,0
31486,2019-08-19,1575,0,1575,125,1700,1700,0,0
31487,2019-08-19,908,0,908,72,980,980,0,0
31488,2019-08-19,1371,0,1371,109,1480,1480,0,0
31489,2019-08-19,538,0,538,42,580,580,0,0
31490,2019-08-19,288,0,288,22,310,310,0,0
31491,2019-08-19,306,0,306,24,330,330,0,0
31492,2019-08-19,343,0,343,27,370,370,0,0
31493,2019-08-19,621,0,621,49,670,670,0,0
31494,2019-08-19,668,-142,526,42,568,568,0,0
31495,2019-08-19,917,0,917,73,990,990,0,0
31496,2019-08-19,121,0,121,9,130,130,0,0
31497,2019-08-19,1112,0,1112,88,1200,0,1200,0
31498,2019-08-19,1297,0,1297,103,1400,1400,0,0
31499,2019-08-19,788,0,788,62,850,850,0,0
31500,2019-08-19,1176,0,1176,94,1270,1270,0,0
31501,2019-08-19,463,0,463,37,500,500,0,0
31502,2019-08-19,1380,0,1380,110,1490,1490,0,0
31503,2019-08-19,2028,0,2028,162,2190,2190,0,0
31504,2019-08-19,556,0,556,44,600,600,0,0
31505,2019-08-19,954,0,954,76,1030,1030,0,0
31506,2019-08-19,766,-82,684,54,738,738,0,0
31507,2019-08-19,1575,0,1575,125,1700,1700,0,0
31508,2019-08-19,1575,0,1575,125,1700,1700,0,0
31509,2019-08-19,2195,0,2195,175,2370,2370,0,0
31510,2019-08-19,204,0,204,16,220,220,0,0
31511,2019-08-19,1204,0,1204,96,1300,1300,0,0
31512,2019-08-19,1723,0,1723,137,1860,1860,0,0
31513,2019-08-19,269,0,269,21,290,290,0,0
31514,2019-08-19,481,0,481,29,510,510,0,0
31515,2019-08-20,269,0,269,21,290,290,0,0
31516,2019-08-20,536,0,536,34,570,570,0,0
31517,2019-08-20,982,0,982,78,1060,1060,0,0
31518,2019-08-20,667,0,667,53,720,720,0,0
31519,2019-08-20,-260,0,-260,-20,-280,-280,0,0
31520,2019-08-20,213,0,213,17,230,230,0,0
31521,2019-08-20,917,0,917,73,990,990,0,0
31522,2019-08-20,269,0,269,21,290,290,0,0
31523,2019-08-20,334,0,334,26,360,360,0,0
31524,2019-08-20,47,0,47,3,50,50,0,0
31525,2019-08-20,621,0,621,49,670,670,0,0
31526,2019-08-20,102,0,102,8,110,110,0,0
31527,2019-08-20,621,0,621,49,670,670,0,0
31528,2019-08-20,1565,0,1565,125,1690,1690,0,0
31529,2019-08-20,408,0,408,32,440,440,0,0
31530,2019-08-20,314,0,314,16,330,330,0,0
31531,2019-08-20,936,0,936,74,1010,1010,0,0
31532,2019-08-20,232,0,232,18,250,250,0,0
31533,2019-08-20,463,0,463,37,500,500,0,0
31534,2019-08-20,112,0,112,8,120,120,0,0
31535,2019-08-20,894,-190,704,56,760,760,0,0
31536,2019-08-20,249,0,249,11,260,260,0,0
31537,2019-08-20,871,0,871,69,940,940,0,0
31538,2019-08-20,463,0,463,37,500,500,0,0
31539,2019-08-20,454,0,454,36,490,490,0,0
31540,2019-08-20,501,0,501,39,540,540,0,0
31541,2019-08-20,778,0,778,62,840,840,0,0
31542,2019-08-20,1917,0,1917,153,2070,2070,0,0
31543,2019-08-20,417,0,417,33,450,450,0,0
31544,2019-08-20,509,0,509,31,540,540,0,0
31545,2019-08-20,908,0,908,72,980,980,0,0
31546,2019-08-20,703,0,703,47,750,750,0,0
31547,2019-08-20,593,0,593,47,640,640,0,0
31548,2019-08-20,612,0,612,48,660,660,0,0
31549,2019-08-20,815,0,815,65,880,880,0,0
31550,2019-08-20,260,0,260,20,280,280,0,0
31551,2019-08-20,584,0,584,46,630,630,0,0
31552,2019-08-20,325,0,325,25,350,350,0,0
31553,2019-08-20,408,0,408,32,440,440,0,0
31554,2019-08-20,364,-39,325,26,351,351,0,0
31555,2019-08-20,1092,0,1092,78,1170,1170,0,0
31556,2019-08-20,343,0,343,27,370,370,0,0
31557,2019-08-20,1213,0,1213,97,1310,1310,0,0
31558,2019-08-20,1380,0,1380,110,1490,1490,0,0
31559,2019-08-21,250,0,250,20,270,270,0,0
31560,2019-08-21,658,0,658,52,710,710,0,0
31561,2019-08-21,686,0,686,54,740,0,0,740
31562,2019-08-21,463,0,463,37,500,500,0,0
31563,2019-08-21,954,0,954,76,1030,1030,0,0
31564,2019-08-21,704,0,704,56,760,0,760,0
31565,2019-08-21,908,0,908,72,980,980,0,0
31566,2019-08-21,713,0,713,57,770,770,0,0
31567,2019-08-21,1073,0,1073,77,1150,0,1150,0
31568,2019-08-21,917,0,917,73,990,0,0,990
31569,2019-08-21,1195,0,1195,95,1290,1290,0,0
31570,2019-08-21,1352,0,1352,108,1460,1460,0,0
31571,2019-08-21,399,0,399,31,430,430,0,0
31572,2019-08-21,362,0,362,28,390,390,0,0
31573,2019-08-21,1815,0,1815,145,1960,1960,0,0
31574,2019-08-21,704,0,704,56,760,760,0,0
31575,2019-08-21,2723,0,2723,217,2940,2940,0,0
31576,2019-08-21,435,0,435,25,460,460,0,0
31577,2019-08-21,473,0,473,37,510,510,0,0
31578,2019-08-21,1279,-137,1142,91,1233,0,0,1233
31579,2019-08-21,149,0,149,11,160,160,0,0
31580,2019-08-21,250,0,250,20,270,270,0,0
31581,2019-08-21,908,0,908,72,980,980,0,0
31582,2019-08-21,593,0,593,47,640,640,0,0
31583,2019-08-21,167,0,167,13,180,180,0,0
31584,2019-08-21,482,0,482,38,520,520,0,0
31585,2019-08-21,685,0,685,45,730,730,0,0
31586,2019-08-21,482,0,482,38,520,520,0,0
31587,2019-08-21,1315,0,1315,105,1420,1420,0,0
31588,2019-08-21,130,0,130,10,140,140,0,0
31589,2019-08-21,538,0,538,42,580,580,0,0
31590,2019-08-21,1788,0,1788,142,1930,0,1930,0
31591,2019-08-21,704,0,704,56,760,760,0,0
31592,2019-08-21,1204,0,1204,96,1300,1300,0,0
31593,2019-08-21,806,0,806,64,870,870,0,0
31594,2019-08-21,908,0,908,72,980,980,0,0
31595,2019-08-21,908,0,908,72,980,980,0,0
31596,2019-08-21,815,0,815,65,880,880,0,0
31597,2019-08-21,769,0,769,61,830,830,0,0
31598,2019-08-21,945,0,945,75,1020,1020,0,0
31599,2019-08-21,2769,0,2769,221,2990,0,2990,0
31600,2019-08-21,926,0,926,74,1000,1000,0,0
31601,2019-08-21,649,0,649,51,700,700,0,0
31602,2019-08-21,1704,0,1704,136,1840,1840,0,0
31603,2019-08-21,880,0,880,70,950,950,0,0
31604,2019-08-21,1121,0,1121,89,1210,1210,0,0
31605,2019-08-21,908,0,908,72,980,980,0,0
31606,2019-08-21,167,0,167,13,180,180,0,0
31607,2019-08-21,982,0,982,78,1060,1060,0,0
31608,2019-08-21,871,0,871,69,940,940,0,0
31609,2019-08-21,536,0,536,34,570,570,0,0
31610,2019-08-21,621,0,621,49,670,670,0,0
31611,2019-08-21,325,0,325,25,350,350,0,0
31612,2019-08-21,908,0,908,72,980,980,0,0
31613,2019-08-21,362,0,362,28,390,390,0,0
31614,2019-08-21,649,0,649,51,700,700,0,0
31615,2019-08-21,1510,0,1510,120,1630,1630,0,0
31616,2019-08-21,491,0,491,39,530,530,0,0
31617,2019-08-21,426,0,426,34,460,460,0,0
31618,2019-08-21,704,0,704,56,760,760,0,0
31619,2019-08-21,5519,0,5519,441,5960,0,5960,0
31620,2019-08-21,538,0,538,42,580,580,0,0
31621,2019-08-21,1575,0,1575,125,1700,1700,0,0
31622,2019-08-21,630,0,630,50,680,680,0,0
31623,2019-08-21,639,0,639,51,690,690,0,0
31624,2019-08-21,788,0,788,62,850,850,0,0
31625,2019-08-21,704,0,704,56,760,760,0,0
31626,2019-08-21,788,0,788,62,850,850,0,0
31627,2019-08-21,1575,0,1575,125,1700,1700,0,0
31628,2019-08-21,389,0,389,31,420,420,0,0
31629,2019-08-21,1575,0,1575,125,1700,1700,0,0
31630,2019-08-21,788,0,788,62,850,850,0,0
31631,2019-08-21,788,0,788,62,850,850,0,0
31632,2019-08-21,1426,0,1426,114,1540,1540,0,0
31633,2019-08-21,926,0,926,74,1000,1000,0,0
31634,2019-08-21,1315,0,1315,105,1420,1420,0,0
31635,2019-08-21,584,0,584,46,630,630,0,0
31636,2019-08-21,414,-88,326,26,352,352,0,0
31637,2019-08-21,499,-106,393,31,424,424,0,0
31638,2019-08-21,371,0,371,29,400,400,0,0
31639,2019-08-21,788,0,788,62,850,850,0,0
31640,2019-08-21,1047,0,1047,83,1130,1130,0,0
31641,2019-08-21,1417,0,1417,113,1530,1530,0,0
31642,2019-08-21,1815,0,1815,145,1960,0,1960,0
31643,2019-08-21,510,0,510,40,550,550,0,0
31644,2019-08-21,1575,0,1575,125,1700,1700,0,0
31645,2019-08-21,361,0,361,19,380,380,0,0
31646,2019-08-21,510,0,510,40,550,550,0,0
31647,2019-08-21,908,0,908,72,980,980,0,0
31648,2019-08-21,297,0,297,23,320,320,0,0
31649,2019-08-21,288,0,288,22,310,310,0,0
31650,2019-08-21,1815,0,1815,145,1960,1960,0,0
31651,2019-08-21,908,0,908,72,980,980,0,0
31652,2019-08-21,769,0,769,61,830,830,0,0
31653,2019-08-21,1953,0,1953,147,2100,2100,0,0
31654,2019-08-21,288,0,288,22,310,310,0,0
31655,2019-08-21,649,0,649,51,700,700,0,0
31656,2019-08-21,741,0,741,59,800,800,0,0
31657,2019-08-21,3630,0,3630,290,3920,3920,0,0
31658,2019-08-21,1019,0,1019,81,1100,1100,0,0
31659,2019-08-21,723,0,723,57,780,780,0,0
31660,2019-08-21,556,0,556,44,600,600,0,0
31661,2019-08-21,575,0,575,45,620,620,0,0
31662,2019-08-21,695,0,695,55,750,750,0,0
31663,2019-08-21,343,0,343,27,370,370,0,0
31664,2019-08-21,593,0,593,47,640,640,0,0
31665,2019-08-21,945,0,945,75,1020,1020,0,0
31666,2019-08-21,1815,0,1815,145,1960,1960,0,0
31667,2019-08-22,1815,0,1815,145,1960,1960,0,0
31668,2019-08-22,417,0,417,33,450,450,0,0
31669,2019-08-22,908,0,908,72,980,980,0,0
31670,2019-08-22,1429,-153,1276,101,1377,0,1377,0
31671,2019-08-22,852,0,852,68,920,920,0,0
31672,2019-08-22,1167,0,1167,93,1260,1260,0,0
31673,2019-08-22,991,0,991,79,1070,1070,0,0
31674,2019-08-22,1815,0,1815,145,1960,0,0,1960
31675,2019-08-22,908,0,908,72,980,980,0,0
31676,2019-08-22,343,0,343,27,370,370,0,0
31677,2019-08-22,167,0,167,13,180,180,0,0
31678,2019-08-22,926,0,926,74,1000,0,0,1000
31679,2019-08-22,700,-75,625,50,675,675,0,0
31680,2019-08-22,1212,0,1212,88,1300,1300,0,0
31681,2019-08-22,1575,0,1575,125,1700,1700,0,0
31682,2019-08-22,1001,0,1001,79,1080,1080,0,0
31683,2019-08-22,1028,0,1028,82,1110,1110,0,0
31684,2019-08-22,204,0,204,16,220,220,0,0
31685,2019-08-22,936,0,936,74,1010,1010,0,0
31686,2019-08-22,278,0,278,22,300,300,0,0
31687,2019-08-22,1575,0,1575,125,1700,1700,0,0
31688,2019-08-22,1575,0,1575,125,1700,0,1700,0
31689,2019-08-22,297,0,297,23,320,0,0,320
31690,2019-08-22,445,0,445,35,480,480,0,0
31691,2019-08-22,1167,0,1167,93,1260,1260,0,0
31692,2019-08-22,2723,0,2723,217,2940,2940,0,0
31693,2019-08-22,899,0,899,71,970,0,0,970
31694,2019-08-22,454,0,454,36,490,490,0,0
31695,2019-08-22,686,0,686,54,740,740,0,0
31696,2019-08-22,583,0,583,37,620,620,0,0
31697,2019-08-22,1305,0,1305,95,1400,1400,0,0
31698,2019-08-22,908,0,908,72,980,980,0,0
31699,2019-08-22,1389,0,1389,111,1500,1500,0,0
31700,2019-08-22,744,-158,586,46,632,632,0,0
31701,2019-08-22,834,0,834,66,900,900,0,0
31702,2019-08-22,482,0,482,38,520,520,0,0
31703,2019-08-22,593,0,593,47,640,640,0,0
31704,2019-08-22,556,0,556,44,600,600,0,0
31705,2019-08-22,330,0,330,0,330,330,0,0
31706,2019-08-22,408,0,408,32,440,440,0,0
31707,2019-08-22,167,0,167,13,180,180,0,0
31708,2019-08-22,2288,0,2288,182,2470,2470,0,0
31709,2019-08-22,778,0,778,62,840,840,0,0
31710,2019-08-22,1028,0,1028,82,1110,1110,0,0
31711,2019-08-22,1101,-234,867,69,936,936,0,0
31712,2019-08-22,352,0,352,28,380,380,0,0
31713,2019-08-22,389,0,389,31,420,0,420,0
31714,2019-08-22,695,0,695,55,750,750,0,0
31715,2019-08-22,473,0,473,37,510,510,0,0
31716,2019-08-22,926,0,926,74,1000,0,1000,0
31717,2019-08-22,366,0,366,29,395,395,0,0
31718,2019-08-22,2723,0,2723,217,2940,0,2940,0
31719,2019-08-22,473,0,473,37,510,510,0,0
31720,2019-08-22,908,0,908,72,980,980,0,0
31721,2019-08-22,1223,0,1223,97,1320,1320,0,0
31722,2019-08-22,741,0,741,59,800,800,0,0
31723,2019-08-22,2723,0,2723,217,2940,2940,0,0
31724,2019-08-22,908,0,908,72,980,980,0,0
31725,2019-08-22,1815,0,1815,145,1960,1960,0,0
31726,2019-08-22,139,0,139,11,150,150,0,0
31727,2019-08-22,334,0,334,26,360,360,0,0
31728,2019-08-22,139,0,139,11,150,150,0,0
31729,2019-08-22,482,0,482,38,520,520,0,0
31730,2019-08-22,1417,0,1417,113,1530,1530,0,0
31731,2019-08-22,334,0,334,26,360,360,0,0
31732,2019-08-22,1538,0,1538,122,1660,1660,0,0
31733,2019-08-22,1426,0,1426,114,1540,1540,0,0
31734,2019-08-22,260,0,260,20,280,280,0,0
31735,2019-08-22,1815,0,1815,145,1960,1960,0,0
31736,2019-08-22,547,0,547,43,590,590,0,0
31737,2019-08-22,732,0,732,58,790,790,0,0
31738,2019-08-22,1278,0,1278,102,1380,1380,0,0
31739,2019-08-22,408,0,408,32,440,440,0,0
31740,2019-08-22,139,0,139,11,150,150,0,0
31741,2019-08-22,477,0,477,38,515,515,0,0
31742,2019-08-22,2056,0,2056,164,2220,2220,0,0
31743,2019-08-22,713,0,713,57,770,770,0,0
31744,2019-08-22,241,0,241,19,260,260,0,0
31745,2019-08-22,260,0,260,20,280,280,0,0
31746,2019-08-22,241,0,241,19,260,260,0,0
31747,2019-08-22,362,0,362,28,390,390,0,0
31748,2019-08-22,-473,0,-473,-37,-510,-510,0,0
31749,2019-08-22,473,0,473,37,510,510,0,0
31750,2019-08-22,186,0,186,14,200,200,0,0
31751,2019-08-22,1519,0,1519,121,1640,1640,0,0
31752,2019-08-22,362,0,362,28,390,390,0,0
31753,2019-08-22,426,0,426,34,460,460,0,0
31754,2019-08-22,6445,0,6445,515,6960,6960,0,0
31755,2019-08-22,260,0,260,20,280,280,0,0
31756,2019-08-22,315,0,315,25,340,340,0,0
31757,2019-08-22,538,0,538,42,580,580,0,0
31758,2019-08-22,260,0,260,20,280,280,0,0
31759,2019-08-22,389,0,389,31,420,420,0,0
31760,2019-08-22,2028,0,2028,162,2190,2190,0,0
31761,2019-08-22,1463,0,1463,117,1580,0,0,1580
31762,2019-08-22,365,-39,326,25,351,0,0,351
31763,2019-08-22,519,0,519,41,560,560,0,0
31764,2019-08-22,676,0,676,54,730,730,0,0
31765,2019-08-22,269,0,269,21,290,290,0,0
31766,2019-08-22,1815,0,1815,145,1960,1960,0,0
31767,2019-08-22,640,-136,504,40,544,544,0,0
31768,2019-08-22,389,0,389,31,420,420,0,0
31769,2019-08-22,399,0,399,31,430,430,0,0
31770,2019-08-22,1019,0,1019,81,1100,1100,0,0
31771,2019-08-22,788,0,788,62,850,0,0,850
31772,2019-08-22,389,0,389,31,420,420,0,0
31773,2019-08-22,278,0,278,22,300,300,0,0
31774,2019-08-22,1575,0,1575,125,1700,1700,0,0
31775,2019-08-22,2362,0,2362,188,2550,2550,0,0
31776,2019-08-22,399,0,399,31,430,430,0,0
31777,2019-08-22,963,0,963,77,1040,1040,0,0
31778,2019-08-22,528,0,528,42,570,570,0,0
31779,2019-08-22,306,0,306,24,330,330,0,0
31780,2019-08-22,1296,0,1296,94,1390,1390,0,0
31781,2019-08-22,788,0,788,62,850,850,0,0
31782,2019-08-22,897,-96,801,63,864,864,0,0
31783,2019-08-22,269,0,269,21,290,290,0,0
31784,2019-08-22,1575,0,1575,125,1700,1700,0,0
31785,2019-08-22,788,0,788,62,850,850,0,0
31786,2019-08-22,788,0,788,62,850,850,0,0
31787,2019-08-22,788,0,788,62,850,850,0,0
31788,2019-08-22,1741,0,1741,139,1880,1880,0,0
31789,2019-08-22,575,0,575,45,620,620,0,0
31790,2019-08-22,334,0,334,26,360,360,0,0
31791,2019-08-22,741,0,741,59,800,800,0,0
31792,2019-08-22,195,0,195,15,210,210,0,0
31793,2019-08-22,778,0,778,62,840,840,0,0
31794,2019-08-22,1214,-130,1084,86,1170,0,1170,0
31795,2019-08-22,195,0,195,15,210,210,0,0
31796,2019-08-22,445,0,445,35,480,480,0,0
31797,2019-08-22,889,0,889,71,960,960,0,0
31798,2019-08-22,695,0,695,55,750,750,0,0
31799,2019-08-22,0,0,0,0,0,0,0,0
31800,2019-08-22,1575,0,1575,125,1700,1700,0,0
31801,2019-08-22,510,0,510,40,550,550,0,0
31802,2019-08-22,528,0,528,42,570,570,0,0
31803,2019-08-23,612,0,612,48,660,660,0,0
31804,2019-08-23,1482,0,1482,118,1600,1600,0,0
31805,2019-08-23,1352,0,1352,108,1460,1460,0,0
31806,2019-08-23,2676,0,2676,214,2890,0,2890,0
31807,2019-08-23,1065,0,1065,85,1150,1150,0,0
31808,2019-08-23,769,0,769,61,830,830,0,0
31809,2019-08-23,417,0,417,33,450,450,0,0
31810,2019-08-23,3630,0,3630,290,3920,3920,0,0
31811,2019-08-23,769,0,769,61,830,830,0,0
31812,2019-08-23,797,0,797,63,860,860,0,0
31813,2019-08-23,667,0,667,53,720,720,0,0
31814,2019-08-23,769,0,769,61,830,830,0,0
31815,2019-08-23,575,0,575,45,620,0,620,0
31816,2019-08-23,1630,0,1630,130,1760,1760,0,0
31817,2019-08-23,593,0,593,47,640,640,0,0
31818,2019-08-23,908,0,908,72,980,980,0,0
31819,2019-08-23,803,-86,717,57,774,774,0,0
31820,2019-08-23,814,0,814,56,870,870,0,0
31821,2019-08-23,392,-42,350,28,378,378,0,0
31822,2019-08-23,436,0,436,34,470,470,0,0
31823,2019-08-23,3630,0,3630,290,3920,3920,0,0
31824,2019-08-23,306,0,306,24,330,330,0,0
31825,2019-08-23,778,0,778,62,840,0,840,0
31826,2019-08-23,778,0,778,62,840,840,0,0
31827,2019-08-23,334,0,334,26,360,360,0,0
31828,2019-08-23,371,0,371,29,400,400,0,0
31829,2019-08-23,723,0,723,57,780,780,0,0
31830,2019-08-23,399,0,399,31,430,430,0,0
31831,2019-08-23,805,0,805,55,860,0,860,0
31832,2019-08-23,963,0,963,77,1040,1040,0,0
31833,2019-08-23,621,0,621,49,670,670,0,0
31834,2019-08-23,621,0,621,49,670,670,0,0
31835,2019-08-23,408,0,408,32,440,440,0,0
31836,2019-08-23,519,0,519,41,560,560,0,0
31837,2019-08-23,519,0,519,41,560,560,0,0
31838,2019-08-23,665,0,665,35,700,700,0,0
31839,2019-08-23,556,0,556,44,600,600,0,0
31840,2019-08-23,352,0,352,28,380,380,0,0
31841,2019-08-23,741,0,741,59,800,800,0,0
31842,2019-08-23,732,0,732,58,790,790,0,0
31843,2019-08-23,305,0,305,15,320,320,0,0
31844,2019-08-23,260,0,260,20,280,280,0,0
31845,2019-08-23,1815,0,1815,145,1960,1960,0,0
31846,2019-08-23,2186,0,2186,174,2360,2360,0,0
31847,2019-08-23,917,0,917,73,990,990,0,0
31848,2019-08-23,778,0,778,62,840,840,0,0
31849,2019-08-23,741,0,741,59,800,800,0,0
31850,2019-08-23,732,0,732,58,790,790,0,0
31851,2019-08-23,1815,0,1815,145,1960,1960,0,0
31852,2019-08-23,1001,0,1001,79,1080,1080,0,0
31853,2019-08-23,806,0,806,64,870,870,0,0
31854,2019-08-23,1139,0,1139,91,1230,1230,0,0
31855,2019-08-23,2723,0,2723,217,2940,2940,0,0
31856,2019-08-23,593,0,593,47,640,640,0,0
31857,2019-08-23,325,0,325,25,350,350,0,0
31858,2019-08-23,547,0,547,43,590,590,0,0
31859,2019-08-23,667,0,667,53,720,720,0,0
31860,2019-08-23,751,0,751,59,810,810,0,0
31861,2019-08-23,908,0,908,72,980,980,0,0
31862,2019-08-23,667,0,667,53,720,0,720,0
31863,2019-08-23,510,0,510,40,550,550,0,0
31864,2019-08-23,908,0,908,72,980,980,0,0
31865,2019-08-23,973,0,973,77,1050,1050,0,0
31866,2019-08-23,732,0,732,58,790,790,0,0
31867,2019-08-23,1027,0,1027,73,1100,1100,0,0
31868,2019-08-23,-371,0,-371,-29,-400,-400,0,0
31869,2019-08-23,399,0,399,31,430,430,0,0
31870,2019-08-23,269,0,269,21,290,290,0,0
31871,2019-08-23,908,0,908,72,980,0,0,980
31872,2019-08-23,501,0,501,39,540,540,0,0
31873,2019-08-23,908,0,908,72,980,0,0,980
31874,2019-08-23,908,0,908,72,980,0,980,0
31875,2019-08-23,149,0,149,11,160,160,0,0
31876,2019-08-23,139,0,139,11,150,150,0,0
31877,2019-08-23,1426,0,1426,114,1540,1540,0,0
31878,2019-08-23,2723,0,2723,217,2940,2940,0,0
31879,2019-08-23,1815,0,1815,145,1960,0,1960,0
31880,2019-08-23,436,0,436,34,470,470,0,0
31881,2019-08-23,2723,0,2723,217,2940,2940,0,0
31882,2019-08-23,732,0,732,58,790,790,0,0
31883,2019-08-23,3630,0,3630,290,3920,3920,0,0
31884,2019-08-23,417,0,417,33,450,450,0,0
31885,2019-08-23,306,0,306,24,330,330,0,0
31886,2019-08-23,491,0,491,39,530,530,0,0
31887,2019-08-23,288,0,288,22,310,310,0,0
31888,2019-08-23,954,0,954,76,1030,1030,0,0
31889,2019-08-23,445,0,445,35,480,480,0,0
31890,2019-08-23,704,0,704,56,760,760,0,0
31891,2019-08-23,1389,0,1389,111,1500,1500,0,0
31892,2019-08-23,362,0,362,28,390,390,0,0
31893,2019-08-23,658,0,658,52,710,710,0,0
31894,2019-08-23,1547,0,1547,123,1670,1670,0,0
31895,2019-08-23,538,0,538,42,580,580,0,0
31896,2019-08-23,870,0,870,60,930,930,0,0
31897,2019-08-23,426,0,426,34,460,460,0,0
31898,2019-08-23,297,0,297,23,320,320,0,0
31899,2019-08-23,408,0,408,32,440,440,0,0
31900,2019-08-23,644,-69,575,46,621,621,0,0
31901,2019-08-23,2362,0,2362,188,2550,2550,0,0
31902,2019-08-23,788,0,788,62,850,850,0,0
31903,2019-08-23,880,0,880,70,950,950,0,0
31904,2019-08-23,575,0,575,45,620,620,0,0
31905,2019-08-23,364,-39,325,26,351,351,0,0
31906,2019-08-23,1297,0,1297,103,1400,1400,0,0
31907,2019-08-23,399,0,399,31,430,430,0,0
31908,2019-08-23,528,0,528,42,570,570,0,0
31909,2019-08-23,139,0,139,11,150,150,0,0
31910,2019-08-23,223,0,223,17,240,240,0,0
31911,2019-08-23,1825,0,1825,145,1970,1970,0,0
31912,2019-08-23,1214,-130,1084,86,1170,1170,0,0
31913,2019-08-23,486,0,486,29,515,515,0,0
31914,2019-08-23,473,0,473,37,510,510,0,0
31915,2019-08-23,260,0,260,20,280,280,0,0
31916,2019-08-23,260,0,260,20,280,280,0,0
31917,2019-08-23,760,0,760,60,820,820,0,0
31918,2019-08-23,547,0,547,43,590,590,0,0
31919,2019-08-23,130,0,130,10,140,140,0,0
31920,2019-08-23,963,0,963,77,1040,1040,0,0
31921,2019-08-23,112,0,112,8,120,120,0,0
31922,2019-08-23,908,0,908,72,980,980,0,0
31923,2019-08-23,682,-73,609,48,657,0,657,0
31924,2019-08-23,788,0,788,62,850,850,0,0
31925,2019-08-23,260,0,260,20,280,280,0,0
31926,2019-08-23,2130,0,2130,170,2300,2300,0,0
31927,2019-08-23,797,0,797,63,860,860,0,0
31928,2019-08-23,1260,0,1260,100,1360,1360,0,0
31929,2019-08-23,751,0,751,59,810,810,0,0
31930,2019-08-23,1575,0,1575,125,1700,1700,0,0
31931,2019-08-23,1621,0,1621,129,1750,1750,0,0
31932,2019-08-23,788,0,788,62,850,0,0,850
31933,2019-08-23,1051,0,1051,39,1090,1090,0,0
31934,2019-08-23,1149,0,1149,91,1240,1240,0,0
31935,2019-08-23,1889,0,1889,151,2040,2040,0,0
31936,2019-08-23,251,0,251,19,270,270,0,0
31937,2019-08-23,343,0,343,27,370,370,0,0
31938,2019-08-23,788,0,788,62,850,850,0,0
31939,2019-08-23,769,0,769,61,830,830,0,0
31940,2019-08-23,1269,0,1269,101,1370,1370,0,0
31941,2019-08-23,371,0,371,29,400,400,0,0
31942,2019-08-23,334,0,334,26,360,360,0,0
31943,2019-08-23,788,0,788,62,850,850,0,0
31944,2019-08-23,695,0,695,55,750,750,0,0
31945,2019-08-23,1278,0,1278,102,1380,1380,0,0
31946,2019-08-23,473,0,473,37,510,510,0,0
31947,2019-08-23,1092,0,1092,78,1170,1170,0,0
31948,2019-08-23,1575,0,1575,125,1700,1700,0,0
31949,2019-08-23,473,0,473,37,510,0,0,510
31950,2019-08-23,306,0,306,24,330,330,0,0
31951,2019-08-23,2288,0,2288,182,2470,0,2470,0
31952,2019-08-23,1575,0,1575,125,1700,1700,0,0
31953,2019-08-23,139,0,139,11,150,150,0,0
31954,2019-08-23,2334,0,2334,186,2520,2520,0,0
31955,2019-08-23,1788,0,1788,142,1930,1930,0,0
31956,2019-08-23,556,0,556,44,600,600,0,0
31957,2019-08-23,278,0,278,22,300,300,0,0
31958,2019-08-23,510,0,510,40,550,550,0,0
31959,2019-08-23,2130,0,2130,170,2300,2300,0,0
31960,2019-08-23,815,0,815,65,880,0,880,0
31961,2019-08-23,556,0,556,44,600,600,0,0
31962,2019-08-23,658,0,658,52,710,0,710,0
31963,2019-08-23,1251,0,1251,99,1350,1350,0,0
31964,2019-08-23,1575,0,1575,125,1700,1700,0,0
31965,2019-08-23,788,0,788,62,850,850,0,0
31966,2019-08-24,648,0,648,42,690,690,0,0
31967,2019-08-24,723,0,723,57,780,780,0,0
31968,2019-08-24,232,0,232,18,250,250,0,0
31969,2019-08-24,1306,0,1306,104,1410,1410,0,0
31970,2019-08-24,371,0,371,29,400,400,0,0
31971,2019-08-24,908,0,908,72,980,0,0,980
31972,2019-08-24,325,0,325,25,350,350,0,0
31973,2019-08-24,908,0,908,72,980,0,980,0
31974,2019-08-24,1815,0,1815,145,1960,1960,0,0
31975,2019-08-24,547,0,547,43,590,590,0,0
31976,2019-08-24,297,0,297,23,320,320,0,0
31977,2019-08-24,3334,0,3334,266,3600,3600,0,0
31978,2019-08-24,528,0,528,42,570,570,0,0
31979,2019-08-24,1815,0,1815,145,1960,1960,0,0
31980,2019-08-24,565,0,565,45,610,610,0,0
31981,2019-08-24,1629,0,1629,121,1750,0,1750,0
31982,2019-08-24,593,0,593,47,640,640,0,0
31983,2019-08-24,1548,-165,1383,102,1485,1485,0,0
31984,2019-08-24,1334,0,1334,106,1440,0,1440,0
31985,2019-08-24,1954,0,1954,156,2110,2110,0,0
31986,2019-08-24,1213,0,1213,97,1310,1310,0,0
31987,2019-08-24,1426,0,1426,114,1540,1540,0,0
31988,2019-08-24,1176,0,1176,94,1270,1270,0,0
31989,2019-08-24,852,0,852,68,920,0,920,0
31990,2019-08-24,1481,0,1481,109,1590,1590,0,0
31991,2019-08-24,538,0,538,42,580,580,0,0
31992,2019-08-24,360,0,360,20,380,380,0,0
31993,2019-08-24,1973,0,1973,157,2130,2130,0,0
31994,2019-08-24,1065,0,1065,85,1150,1150,0,0
31995,2019-08-24,334,0,334,26,360,360,0,0
31996,2019-08-24,1889,0,1889,151,2040,2040,0,0
31997,2019-08-24,1473,0,1473,117,1590,1590,0,0
31998,2019-08-24,565,0,565,45,610,610,0,0
31999,2019-08-24,2047,0,2047,163,2210,2210,0,0
32000,2019-08-24,676,0,676,54,730,730,0,0
32001,2019-08-24,426,0,426,34,460,460,0,0
32002,2019-08-24,260,0,260,20,280,280,0,0
32003,2019-08-24,704,0,704,56,760,760,0,0
32004,2019-08-24,584,0,584,46,630,630,0,0
32005,2019-08-24,889,0,889,71,960,960,0,0
32006,2019-08-24,1815,0,1815,145,1960,1960,0,0
32007,2019-08-24,251,0,251,19,270,270,0,0
32008,2019-08-24,3175,0,3175,245,3420,3420,0,0
32009,2019-08-24,1223,0,1223,97,1320,1320,0,0
32010,2019-08-24,981,0,981,69,1050,1050,0,0
32011,2019-08-24,760,0,760,60,820,820,0,0
32012,2019-08-24,676,0,676,54,730,730,0,0
32013,2019-08-24,389,0,389,31,420,420,0,0
32014,2019-08-24,204,0,204,16,220,220,0,0
32015,2019-08-24,565,0,565,45,610,610,0,0
32016,2019-08-24,954,0,954,76,1030,1030,0,0
32017,2019-08-24,1047,0,1047,83,1130,1130,0,0
32018,2019-08-24,491,0,491,39,530,530,0,0
32019,2019-08-24,278,0,278,22,300,300,0,0
32020,2019-08-24,463,0,463,37,500,500,0,0
32021,2019-08-24,288,0,288,22,310,310,0,0
32022,2019-08-24,686,0,686,54,740,740,0,0
32023,2019-08-24,1578,-169,1409,112,1521,1521,0,0
32024,2019-08-24,528,0,528,42,570,570,0,0
32025,2019-08-24,1473,0,1473,117,1590,1590,0,0
32026,2019-08-24,1473,0,1473,117,1590,0,1590,0
32027,2019-08-24,1556,0,1556,124,1680,1680,0,0
32028,2019-08-24,880,0,880,70,950,950,0,0
32029,2019-08-24,463,0,463,37,500,500,0,0
32030,2019-08-24,704,0,704,56,760,760,0,0
32031,2019-08-24,926,0,926,74,1000,1000,0,0
32032,2019-08-24,306,0,306,24,330,0,330,0
32033,2019-08-24,538,0,538,42,580,580,0,0
32034,2019-08-24,1547,0,1547,123,1670,1670,0,0
32035,2019-08-24,1871,0,1871,149,2020,2020,0,0
32036,2019-08-24,908,0,908,72,980,980,0,0
32037,2019-08-24,139,0,139,11,150,150,0,0
32038,2019-08-24,260,0,260,20,280,280,0,0
32039,2019-08-24,547,0,547,43,590,590,0,0
32040,2019-08-24,1815,0,1815,145,1960,1960,0,0
32041,2019-08-24,1167,0,1167,93,1260,1260,0,0
32042,2019-08-24,1241,0,1241,99,1340,1340,0,0
32043,2019-08-24,593,0,593,47,640,640,0,0
32044,2019-08-24,2723,0,2723,217,2940,2940,0,0
32045,2019-08-24,2723,0,2723,217,2940,0,2940,0
32046,2019-08-24,445,0,445,35,480,480,0,0
32047,2019-08-24,1047,0,1047,83,1130,1130,0,0
32048,2019-08-24,686,0,686,54,740,0,740,0
32049,2019-08-24,1186,0,1186,94,1280,1280,0,0
32050,2019-08-24,1075,0,1075,85,1160,1160,0,0
32051,2019-08-24,343,0,343,27,370,0,370,0
32052,2019-08-24,2093,0,2093,167,2260,2260,0,0
32053,2019-08-24,315,0,315,25,340,340,0,0
32054,2019-08-24,2399,0,2399,191,2590,2590,0,0
32055,2019-08-24,149,0,149,11,160,160,0,0
32056,2019-08-24,250,0,250,20,270,270,0,0
32057,2019-08-24,936,0,936,74,1010,0,1010,0
32058,2019-08-24,343,0,343,27,370,370,0,0
32059,2019-08-24,195,0,195,15,210,210,0,0
32060,2019-08-24,269,0,269,21,290,290,0,0
32061,2019-08-24,2769,0,2769,221,2990,2990,0,0
32062,2019-08-24,389,0,389,31,420,0,420,0
32063,2019-08-24,139,0,139,11,150,150,0,0
32064,2019-08-24,269,0,269,21,290,290,0,0
32065,2019-08-24,954,0,954,76,1030,1030,0,0
32066,2019-08-24,1889,0,1889,151,2040,2040,0,0
32067,2019-08-24,1792,-192,1600,128,1728,1728,0,0
32068,2019-08-24,269,0,269,21,290,290,0,0
32069,2019-08-24,751,0,751,59,810,810,0,0
32070,2019-08-24,232,0,232,18,250,250,0,0
32071,2019-08-24,1158,0,1158,92,1250,1250,0,0
32072,2019-08-24,1575,0,1575,125,1700,1700,0,0
32073,2019-08-24,788,0,788,62,850,850,0,0
32074,2019-08-24,250,0,250,20,270,270,0,0
32075,2019-08-24,1760,0,1760,140,1900,1900,0,0
32076,2019-08-24,334,0,334,26,360,360,0,0
32077,2019-08-24,1575,0,1575,125,1700,1700,0,0
32078,2019-08-24,426,0,426,34,460,460,0,0
32079,2019-08-24,3769,0,3769,301,4070,4070,0,0
32080,2019-08-24,907,0,907,63,970,970,0,0
32081,2019-08-24,843,0,843,67,910,0,0,910
32082,2019-08-24,593,0,593,47,640,0,0,640
32083,2019-08-24,1830,-196,1634,130,1764,1764,0,0
32084,2019-08-24,269,0,269,21,290,290,0,0
32085,2019-08-24,193,0,193,15,208,208,0,0
32086,2019-08-24,343,0,343,27,370,370,0,0
32087,2019-08-24,1158,0,1158,92,1250,1250,0,0
32088,2019-08-24,519,0,519,41,560,560,0,0
32089,2019-08-24,945,0,945,75,1020,1020,0,0
32090,2019-08-24,908,0,908,72,980,980,0,0
32091,2019-08-24,2723,0,2723,217,2940,2940,0,0
32092,2019-08-24,797,0,797,63,860,860,0,0
32093,2019-08-24,343,0,343,27,370,370,0,0
32094,2019-08-24,862,0,862,68,930,930,0,0
32095,2019-08-24,889,0,889,71,960,960,0,0
32096,2019-08-24,234,-25,209,16,225,225,0,0
32097,2019-08-24,297,0,297,23,320,320,0,0
32098,2019-08-24,371,0,371,29,400,400,0,0
32099,2019-08-24,213,0,213,17,230,230,0,0
32100,2019-08-24,362,0,362,28,390,390,0,0
32101,2019-08-24,1926,0,1926,154,2080,2080,0,0
32102,2019-08-24,1491,0,1491,119,1610,1610,0,0
32103,2019-08-24,389,0,389,31,420,420,0,0
32104,2019-08-24,555,0,555,35,590,590,0,0
32105,2019-08-24,482,0,482,38,520,520,0,0
32106,2019-08-24,788,0,788,62,850,850,0,0
32107,2019-08-24,362,0,362,28,390,390,0,0
32108,2019-08-24,538,0,538,42,580,580,0,0
32109,2019-08-24,667,0,667,53,720,720,0,0
32110,2019-08-24,269,0,269,21,290,290,0,0
32111,2019-08-24,815,0,815,65,880,880,0,0
32112,2019-08-24,1325,0,1325,105,1430,1430,0,0
32113,2019-08-24,759,0,759,51,810,810,0,0
32114,2019-08-24,612,0,612,48,660,660,0,0
32115,2019-08-24,1575,0,1575,125,1700,1700,0,0
32116,2019-08-24,288,0,288,22,310,310,0,0
32117,2019-08-24,1667,0,1667,133,1800,1800,0,0
32118,2019-08-24,1575,0,1575,125,1700,1700,0,0
32119,2019-08-24,926,0,926,74,1000,1000,0,0
32120,2019-08-24,1593,0,1593,127,1720,1720,0,0
32121,2019-08-24,1575,0,1575,125,1700,1700,0,0
32122,2019-08-24,723,0,723,57,780,780,0,0
32123,2019-08-24,556,0,556,44,600,600,0,0
32124,2019-08-24,1249,-133,1116,81,1197,1197,0,0
32125,2019-08-24,953,0,953,67,1020,0,1020,0
32126,2019-08-24,1075,0,1075,85,1160,1160,0,0
32127,2019-08-24,399,0,399,31,430,430,0,0
32128,2019-08-24,1047,0,1047,83,1130,1130,0,0
32129,2019-08-24,389,0,389,31,420,420,0,0
32130,2019-08-24,389,0,389,31,420,420,0,0
32131,2019-08-24,1575,0,1575,125,1700,1700,0,0
32132,2019-08-24,-788,0,-788,-62,-850,-850,0,0
32133,2019-08-24,908,0,908,72,980,980,0,0
32134,2019-08-24,1889,0,1889,151,2040,2040,0,0
32135,2019-08-24,556,0,556,44,600,600,0,0
32136,2019-08-24,1575,0,1575,125,1700,1700,0,0
32137,2019-08-24,1019,0,1019,81,1100,1100,0,0
32138,2019-08-24,1575,0,1575,125,1700,1700,0,0
32139,2019-08-24,1232,0,1232,98,1330,1330,0,0
32140,2019-08-24,297,0,297,23,320,320,0,0
32141,2019-08-24,334,0,334,26,360,360,0,0
32142,2019-08-24,1667,0,1667,133,1800,1800,0,0
32143,2019-08-24,741,0,741,59,800,800,0,0
32144,2019-08-24,278,0,278,22,300,300,0,0
32145,2019-08-24,371,0,371,29,400,400,0,0
32146,2019-08-24,788,0,788,62,850,850,0,0
32147,2019-08-25,1815,0,1815,145,1960,0,1960,0
32148,2019-08-25,1825,0,1825,145,1970,0,1970,0
32149,2019-08-25,973,0,973,77,1050,1050,0,0
32150,2019-08-25,1426,0,1426,114,1540,1540,0,0
32151,2019-08-25,454,0,454,36,490,490,0,0
32152,2019-08-25,1737,-186,1551,123,1674,1674,0,0
32153,2019-08-25,649,0,649,51,700,700,0,0
32154,2019-08-25,1601,0,1601,119,1720,1720,0,0
32155,2019-08-25,259,0,259,11,270,270,0,0
32156,2019-08-25,1231,0,1231,89,1320,1320,0,0
32157,2019-08-25,1249,0,1249,91,1340,1340,0,0
32158,2019-08-25,1815,0,1815,145,1960,1960,0,0
32159,2019-08-25,490,0,490,30,520,520,0,0
32160,2019-08-25,1149,0,1149,91,1240,1240,0,0
32161,2019-08-25,908,0,908,72,980,980,0,0
32162,2019-08-25,528,0,528,42,570,570,0,0
32163,2019-08-25,417,0,417,33,450,450,0,0
32164,2019-08-25,1815,0,1815,145,1960,1960,0,0
32165,2019-08-25,926,0,926,74,1000,1000,0,0
32166,2019-08-25,510,0,510,40,550,550,0,0
32167,2019-08-25,621,0,621,49,670,670,0,0
32168,2019-08-25,3630,0,3630,290,3920,3920,0,0
32169,2019-08-25,445,0,445,35,480,480,0,0
32170,2019-08-25,538,0,538,42,580,580,0,0
32171,2019-08-25,1536,0,1536,114,1650,1650,0,0
32172,2019-08-25,963,0,963,77,1040,1040,0,0
32173,2019-08-25,878,0,878,52,930,0,930,0
32174,2019-08-25,908,0,908,72,980,980,0,0
32175,2019-08-25,908,0,908,72,980,980,0,0
32176,2019-08-25,908,0,908,72,980,980,0,0
32177,2019-08-25,93,0,93,7,100,100,0,0
32178,2019-08-25,1815,0,1815,145,1960,1960,0,0
32179,2019-08-25,3630,0,3630,290,3920,3920,0,0
32180,2019-08-25,593,0,593,47,640,640,0,0
32181,2019-08-25,908,0,908,72,980,980,0,0
32182,2019-08-25,784,-84,700,56,756,756,0,0
32183,2019-08-25,1028,0,1028,82,1110,1110,0,0
32184,2019-08-25,825,0,825,65,890,890,0,0
32185,2019-08-25,3991,0,3991,319,4310,4310,0,0
32186,2019-08-25,686,0,686,54,740,740,0,0
32187,2019-08-25,510,0,510,40,550,550,0,0
32188,2019-08-25,1815,0,1815,145,1960,0,1960,0
32189,2019-08-25,251,0,251,19,270,270,0,0
32190,2019-08-25,519,0,519,41,560,560,0,0
32191,2019-08-25,1047,0,1047,83,1130,1130,0,0
32192,2019-08-25,547,0,547,43,590,590,0,0
32193,2019-08-25,612,0,612,48,660,660,0,0
32194,2019-08-25,2038,0,2038,162,2200,2200,0,0
32195,2019-08-25,149,0,149,11,160,160,0,0
32196,2019-08-25,241,0,241,19,260,260,0,0
32197,2019-08-25,806,0,806,64,870,870,0,0
32198,2019-08-25,527,-112,415,33,448,448,0,0
32199,2019-08-25,-778,0,-778,-62,-840,-840,0,0
32200,2019-08-25,908,0,908,72,980,980,0,0
32201,2019-08-25,778,0,778,62,840,840,0,0
32202,2019-08-25,908,0,908,72,980,980,0,0
32203,2019-08-25,908,0,908,72,980,980,0,0
32204,2019-08-25,362,0,362,28,390,390,0,0
32205,2019-08-25,880,0,880,70,950,950,0,0
32206,2019-08-25,915,-98,817,65,882,0,0,882
32207,2019-08-25,908,0,908,72,980,980,0,0
32208,2019-08-25,501,0,501,39,540,540,0,0
32209,2019-08-25,445,0,445,35,480,480,0,0
32210,2019-08-25,445,0,445,35,480,480,0,0
32211,2019-08-25,2723,0,2723,217,2940,2940,0,0
32212,2019-08-25,473,0,473,37,510,510,0,0
32213,2019-08-25,1297,0,1297,103,1400,1400,0,0
32214,2019-08-25,371,0,371,29,400,400,0,0
32215,2019-08-25,389,0,389,31,420,420,0,0
32216,2019-08-25,980,-105,875,70,945,945,0,0
32217,2019-08-25,260,0,260,20,280,280,0,0
32218,2019-08-25,908,0,908,72,980,980,0,0
32219,2019-08-25,519,0,519,41,560,560,0,0
32220,2019-08-25,278,0,278,22,300,300,0,0
32221,2019-08-25,364,-39,325,26,351,351,0,0
32222,2019-08-25,788,0,788,62,850,850,0,0
32223,2019-08-25,593,0,593,47,640,640,0,0
32224,2019-08-25,102,0,102,8,110,110,0,0
32225,2019-08-25,778,0,778,62,840,840,0,0
32226,2019-08-25,1445,0,1445,115,1560,1560,0,0
32227,2019-08-25,547,0,547,43,590,590,0,0
32228,2019-08-25,500,0,500,40,540,540,0,0
32229,2019-08-25,-778,0,-778,-62,-840,-840,0,0
32230,2019-08-25,-500,0,-500,-40,-540,-540,0,0
32231,2019-08-25,1278,0,1278,102,1380,1380,0,0
32232,2019-08-25,723,0,723,57,780,780,0,0
32233,2019-08-25,426,0,426,34,460,460,0,0
32234,2019-08-25,278,0,278,22,300,300,0,0
32235,2019-08-25,204,0,204,16,220,220,0,0
32236,2019-08-25,334,0,334,26,360,360,0,0
32237,2019-08-25,445,0,445,35,480,480,0,0
32238,2019-08-25,1149,0,1149,91,1240,1240,0,0
32239,2019-08-25,1575,0,1575,125,1700,0,1700,0
32240,2019-08-25,473,0,473,37,510,510,0,0
32241,2019-08-25,556,0,556,44,600,600,0,0
32242,2019-08-25,260,0,260,20,280,280,0,0
32243,2019-08-25,2593,0,2593,207,2800,2800,0,0
32244,2019-08-25,186,0,186,14,200,200,0,0
32245,2019-08-25,723,0,723,57,780,780,0,0
32246,2019-08-25,232,0,232,18,250,250,0,0
32247,2019-08-25,1436,0,1436,114,1550,1550,0,0
32248,2019-08-25,1639,0,1639,131,1770,1770,0,0
32249,2019-08-25,778,0,778,62,840,840,0,0
32250,2019-08-25,93,0,93,7,100,100,0,0
32251,2019-08-25,380,0,380,30,410,410,0,0
32252,2019-08-25,426,0,426,34,460,460,0,0
32253,2019-08-25,2010,0,2010,160,2170,2170,0,0
32254,2019-08-25,278,0,278,22,300,300,0,0
32255,2019-08-25,232,0,232,18,250,0,0,250
32256,2019-08-25,778,0,778,62,840,840,0,0
32257,2019-08-25,186,0,186,14,200,200,0,0
32258,2019-08-25,3741,0,3741,299,4040,4040,0,0
32259,2019-08-25,482,0,482,38,520,520,0,0
32260,2019-08-25,362,0,362,28,390,390,0,0
32261,2019-08-25,277,0,277,13,290,290,0,0
32262,2019-08-25,649,0,649,51,700,700,0,0
32263,2019-08-25,334,0,334,26,360,360,0,0
32264,2019-08-25,528,0,528,42,570,570,0,0
32265,2019-08-25,1075,0,1075,85,1160,1160,0,0
32266,2019-08-25,788,0,788,62,850,850,0,0
32267,2019-08-25,788,0,788,62,850,850,0,0
32268,2019-08-25,1500,0,1500,120,1620,1620,0,0
32269,2019-08-25,1371,0,1371,109,1480,1480,0,0
32270,2019-08-25,1371,0,1371,109,1480,1480,0,0
32271,2019-08-25,232,0,232,18,250,250,0,0
32272,2019-08-25,306,0,306,24,330,330,0,0
32273,2019-08-25,491,0,491,39,530,530,0,0
32274,2019-08-25,269,0,269,21,290,290,0,0
32275,2019-08-25,510,0,510,40,550,550,0,0
32276,2019-08-25,788,0,788,62,850,850,0,0
32277,2019-08-25,1010,0,1010,80,1090,1090,0,0
32278,2019-08-25,788,0,788,62,850,850,0,0
32279,2019-08-25,399,0,399,31,430,430,0,0
32280,2019-08-25,723,0,723,57,780,780,0,0
32281,2019-08-25,250,0,250,20,270,270,0,0
32282,2019-08-25,547,0,547,43,590,590,0,0
32283,2019-08-25,1575,0,1575,125,1700,1700,0,0
32284,2019-08-25,1575,0,1575,125,1700,1700,0,0
32285,2019-08-25,501,0,501,39,540,540,0,0
32286,2019-08-25,2362,0,2362,188,2550,0,2550,0
32287,2019-08-25,352,0,352,28,380,380,0,0
32288,2019-08-25,538,0,538,42,580,580,0,0
32289,2019-08-25,1297,0,1297,103,1400,1400,0,0
32290,2019-08-25,448,-48,400,32,432,432,0,0
32291,2019-08-25,399,0,399,31,430,430,0,0
32292,2019-08-25,751,0,751,59,810,0,810,0
32293,2019-08-25,704,0,704,56,760,760,0,0
32294,2019-08-25,2130,0,2130,170,2300,2300,0,0
32295,2019-08-26,250,0,250,20,270,270,0,0
32296,2019-08-26,297,0,297,23,320,320,0,0
32297,2019-08-26,417,0,417,33,450,450,0,0
32298,2019-08-26,2723,0,2723,217,2940,2940,0,0
32299,2019-08-26,1834,0,1834,146,1980,1980,0,0
32300,2019-08-26,723,0,723,57,780,780,0,0
32301,2019-08-26,297,0,297,23,320,320,0,0
32302,2019-08-26,1333,-142,1191,87,1278,1278,0,0
32303,2019-08-26,232,0,232,18,250,250,0,0
32304,2019-08-26,2899,0,2899,231,3130,0,3130,0
32305,2019-08-26,1019,0,1019,81,1100,1100,0,0
32306,2019-08-26,473,0,473,37,510,510,0,0
32307,2019-08-26,908,0,908,72,980,980,0,0
32308,2019-08-26,676,0,676,54,730,730,0,0
32309,2019-08-26,675,0,675,45,720,720,0,0
32310,2019-08-26,399,0,399,31,430,430,0,0
32311,2019-08-26,1232,0,1232,98,1330,1330,0,0
32312,2019-08-26,2019,0,2019,161,2180,2180,0,0
32313,2019-08-26,352,0,352,28,380,380,0,0
32314,2019-08-26,1269,0,1269,101,1370,1370,0,0
32315,2019-08-26,445,0,445,35,480,480,0,0
32316,2019-08-26,723,0,723,57,780,780,0,0
32317,2019-08-26,1047,0,1047,83,1130,1130,0,0
32318,2019-08-26,667,0,667,53,720,720,0,0
32319,2019-08-26,315,0,315,25,340,340,0,0
32320,2019-08-26,417,0,417,33,450,450,0,0
32321,2019-08-26,269,0,269,21,290,290,0,0
32322,2019-08-26,1815,0,1815,145,1960,1960,0,0
32323,2019-08-26,1417,0,1417,113,1530,1530,0,0
32324,2019-08-26,278,0,278,22,300,300,0,0
32325,2019-08-26,278,0,278,22,300,300,0,0
32326,2019-08-26,330,0,330,0,330,330,0,0
32327,2019-08-26,426,0,426,34,460,460,0,0
32328,2019-08-26,130,0,130,10,140,140,0,0
32329,2019-08-26,112,0,112,8,120,120,0,0
32330,2019-08-26,297,0,297,23,320,320,0,0
32331,2019-08-26,621,0,621,49,670,670,0,0
32332,2019-08-26,306,0,306,24,330,330,0,0
32333,2019-08-26,-185,0,-185,-15,-200,-200,0,0
32334,2019-08-26,260,0,260,20,280,280,0,0
32335,2019-08-26,408,0,408,32,440,440,0,0
32336,2019-08-26,195,0,195,15,210,210,0,0
32337,2019-08-26,352,0,352,28,380,380,0,0
32338,2019-08-26,1001,0,1001,79,1080,1080,0,0
32339,2019-08-26,908,0,908,72,980,980,0,0
32340,2019-08-26,565,0,565,45,610,610,0,0
32341,2019-08-26,528,0,528,42,570,570,0,0
32342,2019-08-26,426,0,426,34,460,460,0,0
32343,2019-08-26,232,0,232,18,250,250,0,0
32344,2019-08-26,251,0,251,19,270,270,0,0
32345,2019-08-26,639,0,639,51,690,690,0,0
32346,2019-08-26,639,0,639,51,690,690,0,0
32347,2019-08-26,936,0,936,74,1010,1010,0,0
32348,2019-08-26,510,0,510,40,550,550,0,0
32349,2019-08-26,445,0,445,35,480,480,0,0
32350,2019-08-26,1815,0,1815,145,1960,1960,0,0
32351,2019-08-26,1815,0,1815,145,1960,1960,0,0
32352,2019-08-26,1445,0,1445,115,1560,1560,0,0
32353,2019-08-26,2186,0,2186,174,2360,2360,0,0
32354,2019-08-26,297,0,297,23,320,320,0,0
32355,2019-08-26,963,0,963,77,1040,1040,0,0
32356,2019-08-26,223,0,223,17,240,240,0,0
32357,2019-08-26,556,0,556,44,600,600,0,0
32358,2019-08-26,1028,0,1028,82,1110,1110,0,0
32359,2019-08-26,751,0,751,59,810,810,0,0
32360,2019-08-26,3630,0,3630,290,3920,0,0,3920
32361,2019-08-26,213,0,213,17,230,230,0,0
32362,2019-08-26,943,-101,842,67,909,909,0,0
32363,2019-08-26,852,0,852,68,920,920,0,0
32364,2019-08-26,630,0,630,50,680,680,0,0
32365,2019-08-26,676,0,676,54,730,730,0,0
32366,2019-08-26,565,0,565,45,610,610,0,0
32367,2019-08-26,1186,0,1186,94,1280,1280,0,0
32368,2019-08-26,241,0,241,19,260,260,0,0
32369,2019-08-26,158,0,158,12,170,170,0,0
32370,2019-08-26,908,0,908,72,980,980,0,0
32371,2019-08-26,602,0,602,48,650,650,0,0
32372,2019-08-26,501,0,501,39,540,540,0,0
32373,2019-08-26,167,0,167,13,180,180,0,0
32374,2019-08-26,1038,0,1038,82,1120,1120,0,0
32375,2019-08-26,232,0,232,18,250,250,0,0
32376,2019-08-26,593,0,593,47,640,640,0,0
32377,2019-08-26,364,-39,325,26,351,351,0,0
32378,2019-08-26,236,-50,186,14,200,200,0,0
32379,2019-08-26,7408,0,7408,592,8000,0,8000,0
32380,2019-08-26,416,0,416,24,440,440,0,0
32381,2019-08-26,473,0,473,37,510,510,0,0
32382,2019-08-26,1667,0,1667,133,1800,1800,0,0
32383,2019-08-26,2130,0,2130,170,2300,2300,0,0
32384,2019-08-26,3380,0,3380,270,3650,3650,0,0
32385,2019-08-26,1963,0,1963,157,2120,2120,0,0
32386,2019-08-26,56,0,56,4,60,60,0,0
32387,2019-08-26,-1963,0,-1963,-157,-2120,-2120,0,0
32388,2019-08-26,584,0,584,46,630,630,0,0
32389,2019-08-26,2269,0,2269,181,2450,2450,0,0
32390,2019-08-26,630,0,630,50,680,680,0,0
32391,2019-08-26,639,0,639,51,690,690,0,0
32392,2019-08-26,399,0,399,31,430,430,0,0
32393,2019-08-26,654,-70,584,46,630,630,0,0
32394,2019-08-26,234,-25,209,16,225,225,0,0
32395,2019-08-26,1176,0,1176,94,1270,1270,0,0
32396,2019-08-26,871,0,871,69,940,940,0,0
32397,2019-08-26,232,0,232,18,250,250,0,0
32398,2019-08-26,343,0,343,27,370,370,0,0
32399,2019-08-26,269,0,269,21,290,290,0,0
32400,2019-08-26,371,0,371,29,400,400,0,0
32401,2019-08-26,269,0,269,21,290,290,0,0
32402,2019-08-26,1038,0,1038,82,1120,1120,0,0
32403,2019-08-26,1075,0,1075,85,1160,0,1160,0
32404,2019-08-26,676,0,676,54,730,730,0,0
32405,2019-08-26,325,0,325,25,350,350,0,0
32406,2019-08-26,1963,0,1963,157,2120,0,0,2120
32407,2019-08-26,3149,0,3149,251,3400,3400,0,0
32408,2019-08-26,788,0,788,62,850,850,0,0
32409,2019-08-26,269,0,269,21,290,290,0,0
32410,2019-08-26,251,0,251,19,270,270,0,0
32411,2019-08-26,510,0,510,40,550,550,0,0
32412,2019-08-26,612,0,612,48,660,660,0,0
32413,2019-08-26,1028,0,1028,82,1110,0,1110,0
32414,2019-08-26,1797,0,1797,143,1940,1940,0,0
32415,2019-08-26,768,0,768,52,820,820,0,0
32416,2019-08-26,963,0,963,77,1040,1040,0,0
32417,2019-08-26,788,0,788,62,850,850,0,0
32418,2019-08-26,760,0,760,60,820,820,0,0
32419,2019-08-26,741,0,741,59,800,800,0,0
32420,2019-08-26,936,0,936,74,1010,1010,0,0
32421,2019-08-26,315,0,315,25,340,340,0,0
32422,2019-08-26,1232,0,1232,98,1330,1330,0,0
32423,2019-08-26,445,0,445,35,480,480,0,0
32424,2019-08-26,232,0,232,18,250,250,0,0
32425,2019-08-26,371,0,371,29,400,400,0,0
32426,2019-08-26,630,0,630,50,680,680,0,0
32427,2019-08-26,1575,0,1575,125,1700,0,1700,0
32428,2019-08-26,436,0,436,34,470,470,0,0
32429,2019-08-26,241,0,241,19,260,260,0,0
32430,2019-08-26,1130,0,1130,90,1220,1220,0,0
32431,2019-08-26,1315,0,1315,105,1420,1420,0,0
32432,2019-08-26,167,0,167,13,180,180,0,0
32433,2019-08-26,334,0,334,26,360,360,0,0
32434,2019-08-26,1575,0,1575,125,1700,1700,0,0
32435,2019-08-26,112,0,112,8,120,120,0,0
32436,2019-08-26,528,0,528,42,570,570,0,0
32437,2019-08-26,982,0,982,78,1060,1060,0,0
32438,2019-08-26,510,0,510,40,550,550,0,0
32439,2019-08-26,999,0,999,71,1070,1070,0,0
32440,2019-08-26,491,0,491,39,530,530,0,0
32441,2019-08-26,806,0,806,64,870,870,0,0
32442,2019-08-26,788,0,788,62,850,850,0,0
32443,2019-08-26,788,0,788,62,850,850,0,0
32444,2019-08-27,639,0,639,51,690,690,0,0
32445,2019-08-27,639,0,639,51,690,690,0,0
32446,2019-08-27,556,0,556,44,600,600,0,0
32447,2019-08-27,1528,0,1528,122,1650,1650,0,0
32448,2019-08-27,232,0,232,18,250,250,0,0
32449,2019-08-27,306,0,306,24,330,330,0,0
32450,2019-08-27,546,-116,430,34,464,0,0,464
32451,2019-08-27,362,0,362,28,390,390,0,0
32452,2019-08-27,232,0,232,18,250,250,0,0
32453,2019-08-27,306,0,306,24,330,330,0,0
32454,2019-08-27,232,0,232,18,250,250,0,0
32455,2019-08-27,93,0,93,7,100,100,0,0
32456,2019-08-27,232,0,232,18,250,250,0,0
32457,2019-08-27,639,0,639,51,690,690,0,0
32458,2019-08-27,297,0,297,23,320,320,0,0
32459,2019-08-27,639,0,639,51,690,690,0,0
32460,2019-08-27,260,0,260,20,280,280,0,0
32461,2019-08-27,232,0,232,18,250,250,0,0
32462,2019-08-27,556,0,556,44,600,600,0,0
32463,2019-08-27,213,0,213,17,230,230,0,0
32464,2019-08-27,1362,0,1362,108,1470,1470,0,0
32465,2019-08-27,389,0,389,31,420,420,0,0
32466,2019-08-27,260,0,260,20,280,280,0,0
32467,2019-08-27,269,0,269,21,290,290,0,0
32468,2019-08-27,2084,0,2084,166,2250,2250,0,0
32469,2019-08-27,593,0,593,47,640,640,0,0
32470,2019-08-27,510,0,510,40,550,550,0,0
32471,2019-08-27,232,0,232,18,250,250,0,0
32472,2019-08-27,278,0,278,22,300,300,0,0
32473,2019-08-27,908,0,908,72,980,980,0,0
32474,2019-08-27,251,0,251,19,270,270,0,0
32475,2019-08-27,482,0,482,38,520,520,0,0
32476,2019-08-27,649,0,649,51,700,700,0,0
32477,2019-08-28,223,0,223,17,240,240,0,0
32478,2019-08-28,1019,0,1019,81,1100,1100,0,0
32479,2019-08-28,953,0,953,67,1020,1020,0,0
32480,2019-08-28,834,0,834,66,900,900,0,0
32481,2019-08-28,519,0,519,41,560,560,0,0
32482,2019-08-28,621,0,621,49,670,670,0,0
32483,2019-08-28,676,0,676,54,730,730,0,0
32484,2019-08-28,778,0,778,62,840,840,0,0
32485,2019-08-28,3239,-347,2892,231,3123,3123,0,0
32486,2019-08-28,343,0,343,27,370,370,0,0
32487,2019-08-28,2065,0,2065,165,2230,2230,0,0
32488,2019-08-28,602,0,602,48,650,650,0,0
32489,2019-08-28,1075,0,1075,85,1160,1160,0,0
32490,2019-08-28,704,0,704,56,760,760,0,0
32491,2019-08-28,1158,0,1158,92,1250,1250,0,0
32492,2019-08-28,315,0,315,25,340,340,0,0
32493,2019-08-28,1575,0,1575,125,1700,1700,0,0
32494,2019-08-28,352,0,352,28,380,380,0,0
32495,2019-08-28,1815,0,1815,145,1960,1960,0,0
32496,2019-08-28,1343,0,1343,107,1450,1450,0,0
32497,2019-08-28,1251,0,1251,99,1350,1350,0,0
32498,2019-08-28,556,0,556,44,600,600,0,0
32499,2019-08-28,251,0,251,19,270,270,0,0
32500,2019-08-28,167,0,167,13,180,180,0,0
32501,2019-08-28,426,0,426,34,460,460,0,0
32502,2019-08-28,519,0,519,41,560,560,0,0
32503,2019-08-28,2212,0,2212,168,2380,2380,0,0
32504,2019-08-28,538,0,538,42,580,580,0,0
32505,2019-08-28,260,0,260,20,280,280,0,0
32506,2019-08-28,509,0,509,31,540,540,0,0
32507,2019-08-28,834,0,834,66,900,900,0,0
32508,2019-08-28,1815,0,1815,145,1960,1960,0,0
32509,2019-08-28,741,0,741,59,800,800,0,0
32510,2019-08-28,315,0,315,25,340,340,0,0
32511,2019-08-28,1433,0,1433,97,1530,1530,0,0
32512,2019-08-28,139,0,139,11,150,150,0,0
32513,2019-08-28,250,0,250,20,270,0,270,0
32514,2019-08-28,223,0,223,17,240,240,0,0
32515,2019-08-28,686,0,686,54,740,740,0,0
32516,2019-08-28,686,0,686,54,740,740,0,0
32517,2019-08-28,306,0,306,24,330,330,0,0
32518,2019-08-28,306,0,306,24,330,330,0,0
32519,2019-08-28,806,0,806,64,870,870,0,0
32520,2019-08-28,973,0,973,77,1050,1050,0,0
32521,2019-08-28,1019,0,1019,81,1100,1100,0,0
32522,2019-08-28,538,0,538,42,580,580,0,0
32523,2019-08-28,417,0,417,33,450,450,0,0
32524,2019-08-28,315,0,315,25,340,340,0,0
32525,2019-08-28,463,0,463,37,500,500,0,0
32526,2019-08-28,1815,0,1815,145,1960,1960,0,0
32527,2019-08-28,1575,0,1575,125,1700,1700,0,0
32528,2019-08-28,788,0,788,62,850,0,850,0
32529,2019-08-28,1075,0,1075,85,1160,1160,0,0
32530,2019-08-28,788,0,788,62,850,850,0,0
32531,2019-08-28,362,0,362,28,390,390,0,0
32532,2019-08-28,788,0,788,62,850,850,0,0
32533,2019-08-28,343,0,343,27,370,370,0,0
32534,2019-08-28,2556,0,2556,204,2760,0,2760,0
32535,2019-08-28,1852,0,1852,148,2000,2000,0,0
32536,2019-08-28,-1491,0,-1491,-119,-1610,-1610,0,0
32537,2019-08-28,278,0,278,22,300,300,0,0
32538,2019-08-28,1315,0,1315,105,1420,0,1420,0
32539,2019-08-28,139,0,139,11,150,150,0,0
32540,2019-08-28,139,0,139,11,150,150,0,0
32541,2019-08-28,389,0,389,31,420,420,0,0
32542,2019-08-28,139,0,139,11,150,150,0,0
32543,2019-08-28,676,0,676,54,730,730,0,0
32544,2019-08-28,593,0,593,47,640,640,0,0
32545,2019-08-28,898,0,898,62,960,960,0,0
32546,2019-08-28,1297,0,1297,103,1400,0,1400,0
32547,2019-08-28,1491,0,1491,119,1610,1610,0,0
32548,2019-08-28,389,0,389,31,420,420,0,0
32549,2019-08-28,1575,0,1575,125,1700,1700,0,0
32550,2019-08-28,584,0,584,46,630,630,0,0
32551,2019-08-28,1491,0,1491,119,1610,1610,0,0
32552,2019-08-28,445,0,445,35,480,480,0,0
32553,2019-08-28,1158,0,1158,92,1250,1250,0,0
32554,2019-08-28,825,0,825,65,890,890,0,0
32555,2019-08-28,-825,0,-825,-65,-890,-890,0,0
32556,2019-08-28,825,0,825,65,890,890,0,0
32557,2019-08-28,899,0,899,71,970,970,0,0
32558,2019-08-28,612,0,612,48,660,660,0,0
32559,2019-08-28,405,-86,319,25,344,344,0,0
32560,2019-08-28,1139,0,1139,91,1230,1230,0,0
32561,2019-08-28,167,0,167,13,180,180,0,0
32562,2019-08-28,788,0,788,62,850,850,0,0
32563,2019-08-28,788,0,788,62,850,850,0,0
32564,2019-08-28,908,0,908,72,980,980,0,0
32565,2019-08-28,871,0,871,69,940,940,0,0
32566,2019-08-28,584,0,584,46,630,630,0,0
32567,2019-08-28,963,0,963,77,1040,1040,0,0
32568,2019-08-28,445,0,445,35,480,480,0,0
32569,2019-08-28,292,-62,230,18,248,248,0,0
32570,2019-08-28,426,0,426,34,460,460,0,0
32571,2019-08-28,399,0,399,31,430,430,0,0
32572,2019-08-28,491,0,491,39,530,530,0,0
32573,2019-08-28,880,0,880,70,950,950,0,0
32574,2019-08-28,445,0,445,35,480,480,0,0
32575,2019-08-28,639,0,639,51,690,690,0,0
32576,2019-08-29,908,0,908,72,980,980,0,0
32577,2019-08-29,908,0,908,72,980,980,0,0
32578,2019-08-29,334,0,334,26,360,360,0,0
32579,2019-08-29,908,0,908,72,980,980,0,0
32580,2019-08-29,1473,0,1473,117,1590,1590,0,0
32581,2019-08-29,1288,0,1288,102,1390,1390,0,0
32582,2019-08-29,306,0,306,24,330,330,0,0
32583,2019-08-29,1815,0,1815,145,1960,1960,0,0
32584,2019-08-29,260,0,260,20,280,280,0,0
32585,2019-08-29,658,0,658,52,710,710,0,0
32586,2019-08-29,501,0,501,39,540,540,0,0
32587,2019-08-29,852,0,852,68,920,920,0,0
32588,2019-08-29,547,0,547,43,590,590,0,0
32589,2019-08-29,871,0,871,69,940,940,0,0
32590,2019-08-29,371,0,371,29,400,400,0,0
32591,2019-08-29,908,0,908,72,980,980,0,0
32592,2019-08-29,362,0,362,28,390,390,0,0
32593,2019-08-29,1815,0,1815,145,1960,1960,0,0
32594,2019-08-29,297,0,297,23,320,320,0,0
32595,2019-08-29,908,0,908,72,980,980,0,0
32596,2019-08-29,380,0,380,30,410,410,0,0
32597,2019-08-29,908,0,908,72,980,980,0,0
32598,2019-08-29,723,0,723,57,780,780,0,0
32599,2019-08-29,518,0,518,32,550,550,0,0
32600,2019-08-29,501,0,501,39,540,540,0,0
32601,2019-08-29,1843,0,1843,147,1990,1990,0,0
32602,2019-08-29,1760,0,1760,140,1900,1900,0,0
32603,2019-08-29,1653,-177,1476,117,1593,1593,0,0
32604,2019-08-29,1815,0,1815,145,1960,1960,0,0
32605,2019-08-29,306,0,306,24,330,330,0,0
32606,2019-08-29,436,0,436,34,470,470,0,0
32607,2019-08-29,1426,0,1426,114,1540,1540,0,0
32608,2019-08-29,1538,0,1538,122,1660,1660,0,0
32609,2019-08-29,1834,0,1834,146,1980,0,1980,0
32610,2019-08-29,852,0,852,68,920,920,0,0
32611,2019-08-29,908,0,908,72,980,980,0,0
32612,2019-08-29,945,0,945,75,1020,1020,0,0
32613,2019-08-29,889,0,889,71,960,0,0,960
32614,2019-08-29,288,0,288,22,310,310,0,0
32615,2019-08-29,584,0,584,46,630,630,0,0
32616,2019-08-29,3084,0,3084,246,3330,3330,0,0
32617,2019-08-29,186,0,186,14,200,200,0,0
32618,2019-08-29,260,0,260,20,280,280,0,0
32619,2019-08-29,908,0,908,72,980,980,0,0
32620,2019-08-29,732,0,732,58,790,790,0,0
32621,2019-08-29,399,0,399,31,430,430,0,0
32622,2019-08-29,1436,0,1436,114,1550,1550,0,0
32623,2019-08-29,1815,0,1815,145,1960,1960,0,0
32624,2019-08-29,612,0,612,48,660,660,0,0
32625,2019-08-29,528,0,528,42,570,570,0,0
32626,2019-08-29,232,0,232,18,250,250,0,0
32627,2019-08-29,399,0,399,31,430,430,0,0
32628,2019-08-29,926,0,926,74,1000,0,1000,0
32629,2019-08-29,158,0,158,12,170,170,0,0
32630,2019-08-29,739,0,739,41,780,780,0,0
32631,2019-08-29,1538,0,1538,122,1660,1660,0,0
32632,2019-08-29,1129,0,1129,81,1210,1210,0,0
32633,2019-08-29,1926,0,1926,154,2080,2080,0,0
32634,2019-08-29,630,0,630,50,680,680,0,0
32635,2019-08-29,388,0,388,22,410,410,0,0
32636,2019-08-29,778,0,778,62,840,840,0,0
32637,2019-08-29,334,0,334,26,360,360,0,0
32638,2019-08-29,676,0,676,54,730,730,0,0
32639,2019-08-29,232,0,232,18,250,250,0,0
32640,2019-08-29,241,0,241,19,260,260,0,0
32641,2019-08-29,1149,0,1149,91,1240,1240,0,0
32642,2019-08-29,362,0,362,28,390,390,0,0
32643,2019-08-29,260,0,260,20,280,280,0,0
32644,2019-08-29,296,0,296,14,310,310,0,0
32645,2019-08-29,639,0,639,51,690,690,0,0
32646,2019-08-29,1870,0,1870,140,2010,2010,0,0
32647,2019-08-29,399,0,399,31,430,430,0,0
32648,2019-08-29,908,0,908,72,980,980,0,0
32649,2019-08-29,741,0,741,59,800,800,0,0
32650,2019-08-29,408,0,408,32,440,440,0,0
32651,2019-08-29,833,0,833,57,890,0,0,890
32652,2019-08-29,139,0,139,11,150,150,0,0
32653,2019-08-29,501,0,501,39,540,540,0,0
32654,2019-08-29,732,0,732,58,790,790,0,0
32655,2019-08-29,269,0,269,21,290,290,0,0
32656,2019-08-29,2672,-568,2104,168,2272,2272,0,0
32657,2019-08-29,139,0,139,11,150,150,0,0
32658,2019-08-29,417,0,417,33,450,450,0,0
32659,2019-08-29,334,0,334,26,360,360,0,0
32660,2019-08-29,314,0,314,16,330,330,0,0
32661,2019-08-29,630,0,630,50,680,680,0,0
32662,2019-08-29,405,-86,319,25,344,344,0,0
32663,2019-08-29,500,0,500,40,540,540,0,0
32664,2019-08-29,334,0,334,26,360,360,0,0
32665,2019-08-29,1510,0,1510,120,1630,1630,0,0
32666,2019-08-29,2362,0,2362,188,2550,2550,0,0
32667,2019-08-29,260,0,260,20,280,280,0,0
32668,2019-08-29,1519,0,1519,121,1640,1640,0,0
32669,2019-08-29,788,0,788,62,850,850,0,0
32670,2019-08-29,528,0,528,42,570,570,0,0
32671,2019-08-29,1575,0,1575,125,1700,1700,0,0
32672,2019-08-29,399,0,399,31,430,430,0,0
32673,2019-08-29,1575,0,1575,125,1700,1700,0,0
32674,2019-08-30,1797,0,1797,143,1940,0,0,1940
32675,2019-08-30,538,0,538,42,580,580,0,0
32676,2019-08-30,695,0,695,55,750,750,0,0
32677,2019-08-30,528,0,528,42,570,570,0,0
32678,2019-08-30,352,0,352,28,380,380,0,0
32679,2019-08-30,973,0,973,77,1050,1050,0,0
32680,2019-08-30,426,0,426,34,460,460,0,0
32681,2019-08-30,1815,0,1815,145,1960,1960,0,0
32682,2019-08-30,1288,0,1288,102,1390,1390,0,0
32683,2019-08-30,908,0,908,72,980,980,0,0
32684,2019-08-30,1158,0,1158,92,1250,1250,0,0
32685,2019-08-30,1556,0,1556,124,1680,1680,0,0
32686,2019-08-30,584,0,584,46,630,630,0,0
32687,2019-08-30,389,0,389,31,420,420,0,0
32688,2019-08-30,584,0,584,46,630,0,630,0
32689,2019-08-30,741,0,741,59,800,800,0,0
32690,2019-08-30,260,0,260,20,280,280,0,0
32691,2019-08-30,667,0,667,53,720,720,0,0
32692,2019-08-30,1842,0,1842,138,1980,1980,0,0
32693,2019-08-30,658,0,658,52,710,710,0,0
32694,2019-08-30,112,0,112,8,120,120,0,0
32695,2019-08-30,880,0,880,70,950,950,0,0
32696,2019-08-30,241,0,241,19,260,260,0,0
32697,2019-08-30,3630,0,3630,290,3920,3920,0,0
32698,2019-08-30,908,0,908,72,980,980,0,0
32699,2019-08-30,436,0,436,34,470,470,0,0
32700,2019-08-30,352,0,352,28,380,380,0,0
32701,2019-08-30,908,0,908,72,980,980,0,0
32702,2019-08-30,1380,0,1380,110,1490,1490,0,0
32703,2019-08-30,1713,0,1713,137,1850,0,1850,0
32704,2019-08-30,538,0,538,42,580,0,580,0
32705,2019-08-30,334,0,334,26,360,360,0,0
32706,2019-08-30,1389,0,1389,111,1500,1500,0,0
32707,2019-08-30,1856,-198,1658,124,1782,1782,0,0
32708,2019-08-30,1830,-196,1634,130,1764,1764,0,0
32709,2019-08-30,908,0,908,72,980,980,0,0
32710,2019-08-30,1073,0,1073,77,1150,1150,0,0
32711,2019-08-30,1815,0,1815,145,1960,1960,0,0
32712,2019-08-30,334,0,334,26,360,360,0,0
32713,2019-08-30,519,0,519,41,560,560,0,0
32714,2019-08-30,260,0,260,20,280,280,0,0
32715,2019-08-30,703,0,703,47,750,750,0,0
32716,2019-08-30,1454,0,1454,116,1570,0,1570,0
32717,2019-08-30,389,0,389,31,420,420,0,0
32718,2019-08-30,445,0,445,35,480,480,0,0
32719,2019-08-30,3676,0,3676,294,3970,3970,0,0
32720,2019-08-30,1073,0,1073,77,1150,1150,0,0
32721,2019-08-30,879,0,879,61,940,940,0,0
32722,2019-08-30,546,0,546,34,580,580,0,0
32723,2019-08-30,991,0,991,79,1070,1070,0,0
32724,2019-08-30,899,0,899,71,970,970,0,0
32725,2019-08-30,1260,0,1260,100,1360,1360,0,0
32726,2019-08-30,1797,0,1797,143,1940,1940,0,0
32727,2019-08-30,352,0,352,28,380,380,0,0
32728,2019-08-30,411,-44,367,29,396,396,0,0
32729,2019-08-30,556,0,556,44,600,600,0,0
32730,2019-08-30,1454,0,1454,116,1570,1570,0,0
32731,2019-08-30,777,0,777,53,830,830,0,0
32732,2019-08-30,3389,0,3389,271,3660,3660,0,0
32733,2019-08-30,584,0,584,46,630,630,0,0
32734,2019-08-30,1815,0,1815,145,1960,1960,0,0
32735,2019-08-30,806,0,806,64,870,870,0,0
32736,2019-08-30,1186,0,1186,94,1280,1280,0,0
32737,2019-08-30,917,0,917,73,990,990,0,0
32738,2019-08-30,399,0,399,31,430,0,430,0
32739,2019-08-30,399,0,399,31,430,430,0,0
32740,2019-08-30,1343,0,1343,107,1450,1450,0,0
32741,2019-08-30,788,0,788,62,850,850,0,0
32742,2019-08-30,269,0,269,21,290,290,0,0
32743,2019-08-30,-1842,0,-1842,-138,-1980,-1980,0,0
32744,2019-08-30,806,0,806,64,870,870,0,0
32745,2019-08-30,908,0,908,72,980,980,0,0
32746,2019-08-30,417,0,417,33,450,450,0,0
32747,2019-08-30,264,-56,208,16,224,224,0,0
32748,2019-08-30,1510,0,1510,120,1630,1630,0,0
32749,2019-08-30,251,0,251,19,270,270,0,0
32750,2019-08-30,1751,0,1751,139,1890,1890,0,0
32751,2019-08-30,241,0,241,19,260,260,0,0
32752,2019-08-30,973,0,973,77,1050,1050,0,0
32753,2019-08-30,195,0,195,15,210,210,0,0
32754,2019-08-30,561,-60,501,39,540,540,0,0
32755,2019-08-30,528,0,528,42,570,570,0,0
32756,2019-08-30,278,0,278,22,300,300,0,0
32757,2019-08-30,686,0,686,54,740,0,740,0
32758,2019-08-30,2825,0,2825,225,3050,3050,0,0
32759,2019-08-30,181,0,181,14,195,195,0,0
32760,2019-08-30,1575,0,1575,125,1700,1700,0,0
32761,2019-08-30,1186,0,1186,94,1280,0,1280,0
32762,2019-08-30,195,0,195,15,210,210,0,0
32763,2019-08-30,2167,0,2167,173,2340,2340,0,0
32764,2019-08-30,250,0,250,20,270,270,0,0
32765,2019-08-30,871,0,871,69,940,940,0,0
32766,2019-08-30,139,0,139,11,150,150,0,0
32767,2019-08-30,1362,0,1362,108,1470,1470,0,0
32768,2019-08-30,797,0,797,63,860,860,0,0
32769,2019-08-30,195,0,195,15,210,210,0,0
32770,2019-08-30,908,0,908,72,980,980,0,0
32771,2019-08-30,343,0,343,27,370,370,0,0
32772,2019-08-30,1343,0,1343,107,1450,1450,0,0
32773,2019-08-30,426,0,426,34,460,460,0,0
32774,2019-08-30,852,0,852,68,920,920,0,0
32775,2019-08-30,2973,0,2973,237,3210,3210,0,0
32776,2019-08-30,260,0,260,20,280,280,0,0
32777,2019-08-30,167,0,167,13,180,180,0,0
32778,2019-08-30,241,0,241,19,260,260,0,0
32779,2019-08-30,1889,0,1889,151,2040,2040,0,0
32780,2019-08-30,788,0,788,62,850,850,0,0
32781,2019-08-30,1621,0,1621,129,1750,1750,0,0
32782,2019-08-30,1167,0,1167,93,1260,1260,0,0
32783,2019-08-30,2130,0,2130,170,2300,2300,0,0
32784,2019-08-30,788,0,788,62,850,850,0,0
32785,2019-08-30,278,0,278,22,300,300,0,0
32786,2019-08-30,1454,0,1454,116,1570,1570,0,0
32787,2019-08-30,325,0,325,25,350,350,0,0
32788,2019-08-30,788,0,788,62,850,850,0,0
32789,2019-08-30,501,0,501,39,540,540,0,0
32790,2019-08-30,788,0,788,62,850,850,0,0
32791,2019-08-30,713,0,713,57,770,770,0,0
32792,2019-08-30,1575,0,1575,125,1700,1700,0,0
32793,2019-08-30,1575,0,1575,125,1700,1700,0,0
32794,2019-08-30,584,0,584,46,630,630,0,0
32795,2019-08-30,436,0,436,34,470,470,0,0
32796,2019-08-30,463,0,463,37,500,500,0,0
32797,2019-08-30,416,0,416,24,440,440,0,0
32798,2019-08-30,788,0,788,62,850,850,0,0
32799,2019-08-30,463,0,463,37,500,500,0,0
32800,2019-08-30,232,0,232,18,250,250,0,0
32801,2019-08-30,788,0,788,62,850,850,0,0
32802,2019-08-30,788,0,788,62,850,850,0,0
32803,2019-08-30,315,0,315,25,340,340,0,0
32804,2019-08-30,1575,0,1575,125,1700,1700,0,0
32805,2019-08-30,269,0,269,21,290,290,0,0
32806,2019-08-30,815,0,815,65,880,880,0,0
32807,2019-08-30,788,0,788,62,850,850,0,0
32808,2019-08-30,213,0,213,17,230,230,0,0
32809,2019-08-30,1575,0,1575,125,1700,1700,0,0
32810,2019-08-30,686,0,686,54,740,740,0,0
32811,2019-08-30,788,0,788,62,850,850,0,0
32812,2019-08-30,788,0,788,62,850,850,0,0
32813,2019-08-30,1575,0,1575,125,1700,1700,0,0
32814,2019-08-30,593,0,593,47,640,640,0,0
32815,2019-08-30,1084,0,1084,86,1170,1170,0,0
32816,2019-08-30,334,0,334,26,360,360,0,0
32817,2019-08-30,1575,0,1575,125,1700,1700,0,0
32818,2019-08-31,547,0,547,43,590,590,0,0
32819,2019-08-31,167,0,167,13,180,180,0,0
32820,2019-08-31,538,0,538,42,580,580,0,0
32821,2019-08-31,815,0,815,65,880,880,0,0
32822,2019-08-31,889,0,889,71,960,960,0,0
32823,2019-08-31,1877,-201,1676,133,1809,0,0,1809
32824,2019-08-31,528,0,528,42,570,570,0,0
32825,2019-08-31,2723,0,2723,217,2940,2940,0,0
32826,2019-08-31,1167,0,1167,93,1260,1260,0,0
32827,2019-08-31,445,0,445,35,480,480,0,0
32828,2019-08-31,510,0,510,40,550,550,0,0
32829,2019-08-31,1815,0,1815,145,1960,1960,0,0
32830,2019-08-31,2232,0,2232,178,2410,2410,0,0
32831,2019-08-31,658,0,658,52,710,710,0,0
32832,2019-08-31,2723,0,2723,217,2940,0,2940,0
32833,2019-08-31,621,0,621,49,670,670,0,0
32834,2019-08-31,362,0,362,28,390,390,0,0
32835,2019-08-31,637,-134,503,33,536,536,0,0
32836,2019-08-31,982,0,982,78,1060,0,1060,0
32837,2019-08-31,1075,0,1075,85,1160,1160,0,0
32838,2019-08-31,2223,0,2223,177,2400,2400,0,0
32839,2019-08-31,982,0,982,78,1060,0,1060,0
32840,2019-08-31,1575,0,1575,125,1700,0,1700,0
32841,2019-08-31,491,0,491,39,530,530,0,0
32842,2019-08-31,1001,0,1001,79,1080,1080,0,0
32843,2019-08-31,1315,0,1315,105,1420,0,1420,0
32844,2019-08-31,945,0,945,75,1020,1020,0,0
32845,2019-08-31,389,0,389,31,420,420,0,0
32846,2019-08-31,843,0,843,67,910,910,0,0
32847,2019-08-31,788,0,788,62,850,850,0,0
32848,2019-08-31,1130,0,1130,90,1220,1220,0,0
32849,2019-08-31,1010,0,1010,80,1090,1090,0,0
32850,2019-08-31,491,0,491,39,530,530,0,0
32851,2019-08-31,1575,0,1575,125,1700,1700,0,0
32852,2019-08-31,778,0,778,62,840,840,0,0
32853,2019-08-31,1723,0,1723,137,1860,0,1860,0
32854,2019-08-31,1575,0,1575,125,1700,0,0,1700
32855,2019-08-31,1211,0,1211,79,1290,1290,0,0
32856,2019-08-31,334,0,334,26,360,360,0,0
32857,2019-08-31,1815,0,1815,145,1960,1960,0,0
32858,2019-08-31,334,0,334,26,360,360,0,0
32859,2019-08-31,806,0,806,64,870,870,0,0
32860,2019-08-31,417,0,417,33,450,450,0,0
32861,2019-08-31,306,0,306,24,330,330,0,0
32862,2019-08-31,899,0,899,71,970,970,0,0
32863,2019-08-31,399,0,399,31,430,430,0,0
32864,2019-08-31,1158,0,1158,92,1250,1250,0,0
32865,2019-08-31,417,0,417,33,450,450,0,0
32866,2019-08-31,584,0,584,46,630,630,0,0
32867,2019-08-31,556,0,556,44,600,600,0,0
32868,2019-08-31,1815,0,1815,145,1960,1960,0,0
32869,2019-08-31,788,0,788,62,850,850,0,0
32870,2019-08-31,908,0,908,72,980,980,0,0
32871,2019-08-31,473,0,473,37,510,510,0,0
32872,2019-08-31,945,0,945,75,1020,1020,0,0
32873,2019-08-31,1362,0,1362,108,1470,1470,0,0
32874,2019-08-31,1815,0,1815,145,1960,1960,0,0
32875,2019-08-31,1454,0,1454,116,1570,1570,0,0
32876,2019-08-31,797,0,797,63,860,860,0,0
32877,2019-08-31,1297,0,1297,103,1400,1400,0,0
32878,2019-08-31,908,0,908,72,980,980,0,0
32879,2019-08-31,232,0,232,18,250,250,0,0
32880,2019-08-31,1232,0,1232,98,1330,1330,0,0
32881,2019-08-31,1158,0,1158,92,1250,1250,0,0
32882,2019-08-31,297,0,297,23,320,320,0,0
32883,2019-08-31,575,0,575,45,620,620,0,0
32884,2019-08-31,2297,0,2297,183,2480,2480,0,0
32885,2019-08-31,1195,0,1195,95,1290,1290,0,0
32886,2019-08-31,2491,0,2491,199,2690,2690,0,0
32887,2019-08-31,908,0,908,72,980,980,0,0
32888,2019-08-31,1038,0,1038,82,1120,1120,0,0
32889,2019-08-31,1130,0,1130,90,1220,1220,0,0
32890,2019-08-31,908,0,908,72,980,980,0,0
32891,2019-08-31,1075,0,1075,85,1160,1160,0,0
32892,2019-08-31,1815,0,1815,145,1960,1960,0,0
32893,2019-08-31,639,0,639,51,690,690,0,0
32894,2019-08-31,408,0,408,32,440,440,0,0
32895,2019-08-31,880,0,880,70,950,950,0,0
32896,2019-08-31,704,0,704,56,760,760,0,0
32897,2019-08-31,512,-54,458,28,486,486,0,0
32898,2019-08-31,1658,0,1658,132,1790,1790,0,0
32899,2019-08-31,842,0,842,58,900,900,0,0
32900,2019-08-31,760,0,760,60,820,820,0,0
32901,2019-08-31,362,0,362,28,390,390,0,0
32902,2019-08-31,565,0,565,45,610,610,0,0
32903,2019-08-31,223,0,223,17,240,240,0,0
32904,2019-08-31,1584,0,1584,126,1710,1710,0,0
32905,2019-08-31,491,0,491,39,530,530,0,0
32906,2019-08-31,630,0,630,50,680,680,0,0
32907,2019-08-31,936,0,936,74,1010,1010,0,0
32908,2019-08-31,325,0,325,25,350,350,0,0
32909,2019-08-31,538,0,538,42,580,580,0,0
32910,2019-08-31,519,0,519,41,560,560,0,0
32911,2019-08-31,1815,0,1815,145,1960,1960,0,0
32912,2019-08-31,343,0,343,27,370,370,0,0
32913,2019-08-31,788,0,788,62,850,850,0,0
32914,2019-08-31,380,0,380,30,410,410,0,0
32915,2019-08-31,305,0,305,15,320,320,0,0
32916,2019-08-31,1343,0,1343,107,1450,1450,0,0
32917,2019-08-31,193,0,193,15,208,208,0,0
32918,2019-08-31,269,0,269,21,290,290,0,0
32919,2019-08-31,232,0,232,18,250,250,0,0
32920,2019-08-31,723,0,723,57,780,780,0,0
32921,2019-08-31,1612,0,1612,128,1740,1740,0,0
32922,2019-08-31,149,0,149,11,160,160,0,0
32923,2019-08-31,519,0,519,41,560,560,0,0
32924,2019-08-31,297,0,297,23,320,320,0,0
32925,2019-08-31,232,0,232,18,250,250,0,0
32926,2019-08-31,1723,0,1723,137,1860,1860,0,0
32927,2019-08-31,584,0,584,46,630,630,0,0
32928,2019-08-31,491,0,491,39,530,530,0,0
32929,2019-08-31,621,0,621,49,670,670,0,0
32930,2019-08-31,269,0,269,21,290,290,0,0
32931,2019-08-31,362,0,362,28,390,390,0,0
32932,2019-08-31,1334,0,1334,106,1440,1440,0,0
32933,2019-08-31,130,0,130,10,140,140,0,0
32934,2019-08-31,260,0,260,20,280,280,0,0
32935,2019-08-31,686,0,686,54,740,740,0,0
32936,2019-08-31,663,0,663,52,715,0,0,715
32937,2019-08-31,556,0,556,44,600,600,0,0
32938,2019-08-31,232,0,232,18,250,250,0,0
32939,2019-08-31,788,0,788,62,850,850,0,0
32940,2019-08-31,945,0,945,75,1020,0,0,1020
32941,2019-08-31,47,0,47,3,50,50,0,0
32942,2019-08-31,1926,0,1926,154,2080,2080,0,0
32943,2019-08-31,778,0,778,62,840,840,0,0
32944,2019-08-31,536,0,536,34,570,570,0,0
32945,2019-08-31,260,0,260,20,280,280,0,0
32946,2019-08-31,380,0,380,30,410,410,0,0
32947,2019-08-31,564,0,564,36,600,600,0,0
32948,2019-08-31,778,0,778,62,840,840,0,0
32949,2019-08-31,1093,0,1093,87,1180,1180,0,0
32950,2019-08-31,741,0,741,59,800,800,0,0
32951,2019-08-31,788,0,788,62,850,850,0,0
32952,2019-08-31,2723,0,2723,217,2940,2940,0,0
32953,2019-08-31,149,0,149,11,160,160,0,0
32954,2019-08-31,723,0,723,57,780,780,0,0
32955,2019-08-31,704,0,704,56,760,760,0,0
32956,2019-08-31,415,0,415,33,448,448,0,0
32957,2019-08-31,889,0,889,71,960,960,0,0
32958,2019-08-31,519,0,519,41,560,560,0,0
32959,2019-08-31,1195,0,1195,95,1290,1290,0,0
32960,2019-08-31,2158,0,2158,172,2330,2330,0,0
32961,2019-08-31,2760,0,2760,220,2980,0,2980,0
32962,2019-08-31,612,0,612,48,660,660,0,0
32963,2019-08-31,186,0,186,14,200,200,0,0
32964,2019-08-31,1575,0,1575,125,1700,0,1700,0
32965,2019-08-31,1575,0,1575,125,1700,1700,0,0
32966,2019-08-31,1019,0,1019,81,1100,1100,0,0
32967,2019-08-31,399,0,399,31,430,430,0,0
32968,2019-08-31,269,0,269,21,290,290,0,0
32969,2019-08-31,917,0,917,73,990,990,0,0
32970,2019-08-31,741,0,741,59,800,800,0,0
32971,2019-08-31,482,0,482,38,520,520,0,0
32972,2019-08-31,454,0,454,36,490,490,0,0
32973,2019-08-31,251,0,251,19,270,270,0,0
32974,2019-08-31,686,0,686,54,740,740,0,0
32975,2019-08-31,667,0,667,53,720,720,0,0
32976,2019-08-31,473,0,473,37,510,510,0,0
32977,2019-08-31,788,0,788,62,850,850,0,0
32978,2019-08-31,547,0,547,43,590,590,0,0
32979,2019-08-31,1575,0,1575,125,1700,1700,0,0
32980,2019-08-31,751,0,751,59,810,810,0,0
32981,2019-08-31,788,0,788,62,850,850,0,0
32982,2019-08-31,1575,0,1575,125,1700,1700,0,0
32983,2019-08-31,1575,0,1575,125,1700,1700,0,0
32984,2019-08-31,510,0,510,40,550,550,0,0
32985,2019-08-31,1084,0,1084,86,1170,1170,0,0
32986,2019-08-31,1047,0,1047,83,1130,1130,0,0
32987,2019-08-31,1408,0,1408,112,1520,1520,0,0
32988,2019-08-31,686,0,686,54,740,740,0,0
32989,2019-08-31,269,0,269,21,290,290,0,0
32990,2019-08-31,1575,0,1575,125,1700,1700,0,0
32991,2019-08-31,299,-32,267,21,288,288,0,0
32992,2019-08-31,2362,0,2362,188,2550,2550,0,0
32993,2019-08-31,788,0,788,62,850,850,0,0
32994,2019-08-31,788,0,788,62,850,850,0,0
32995,2019-08-31,788,0,788,62,850,850,0,0
32996,2019-08-31,1065,0,1065,85,1150,1150,0,0
32997,2019-08-31,788,0,788,62,850,850,0,0
32998,2019-08-31,788,0,788,62,850,850,0,0
32999,2019-08-31,2130,0,2130,170,2300,2300,0,0
33000,2019-08-31,482,0,482,38,520,520,0,0
33001,2019-08-31,1186,0,1186,94,1280,1280,0,0
33002,2019-08-31,1575,0,1575,125,1700,1700,0,0
33003,2019-08-31,1186,0,1186,94,1280,1280,0,0
33004,2019-08-31,509,0,509,31,540,540,0,0
33005,2019-08-31,593,0,593,47,640,0,0,640
33006,2019-08-31,2362,0,2362,188,2550,2550,0,0
33007,2019-08-31,181,0,181,14,195,195,0,0
33008,2019-08-31,362,0,362,28,390,390,0,0
33009,2019-08-31,1575,0,1575,125,1700,1700,0,0
33010,2019-08-31,2130,0,2130,170,2300,2300,0,0
33011,2019-08-31,788,0,788,62,850,850,0,0
33012,2019-09-01,1518,0,1518,112,1630,1630,0,0
33013,2019-09-01,510,0,510,40,550,550,0,0
33014,2019-09-01,362,0,362,28,390,390,0,0
33015,2019-09-01,1297,0,1297,103,1400,1400,0,0
33016,2019-09-01,1010,0,1010,80,1090,1090,0,0
33017,2019-09-01,1723,0,1723,137,1860,1860,0,0
33018,2019-09-01,806,0,806,64,870,870,0,0
33019,2019-09-01,1676,0,1676,134,1810,1810,0,0
33020,2019-09-01,834,0,834,66,900,900,0,0
33021,2019-09-01,658,0,658,52,710,710,0,0
33022,2019-09-01,234,-25,209,16,225,225,0,0
33023,2019-09-01,536,0,536,34,570,570,0,0
33024,2019-09-01,741,0,741,59,800,800,0,0
33025,2019-09-01,547,0,547,43,590,590,0,0
33026,2019-09-01,306,0,306,24,330,330,0,0
33027,2019-09-01,584,0,584,46,630,630,0,0
33028,2019-09-01,473,0,473,37,510,510,0,0
33029,2019-09-01,667,0,667,53,720,720,0,0
33030,2019-09-01,1259,0,1259,91,1350,1350,0,0
33031,2019-09-01,1575,0,1575,125,1700,0,1700,0
33032,2019-09-01,556,0,556,44,600,600,0,0
33033,2019-09-01,1121,0,1121,89,1210,1210,0,0
33034,2019-09-01,121,0,121,9,130,130,0,0
33035,2019-09-01,473,0,473,37,510,510,0,0
33036,2019-09-01,917,0,917,73,990,990,0,0
33037,2019-09-01,788,0,788,62,850,850,0,0
33038,2019-09-01,1176,0,1176,94,1270,1270,0,0
33039,2019-09-01,362,0,362,28,390,390,0,0
33040,2019-09-01,649,0,649,51,700,700,0,0
33041,2019-09-01,686,0,686,54,740,740,0,0
33042,2019-09-01,565,0,565,45,610,610,0,0
33043,2019-09-01,491,0,491,39,530,530,0,0
33044,2019-09-01,686,0,686,54,740,740,0,0
33045,2019-09-01,260,0,260,20,280,280,0,0
33046,2019-09-01,500,0,500,40,540,540,0,0
33047,2019-09-01,880,0,880,70,950,950,0,0
33048,2019-09-01,769,0,769,61,830,830,0,0
33049,2019-09-01,2047,0,2047,163,2210,2210,0,0
33050,2019-09-01,519,0,519,41,560,560,0,0
33051,2019-09-01,343,0,343,27,370,370,0,0
33052,2019-09-01,420,-45,375,30,405,405,0,0
33053,2019-09-01,621,0,621,49,670,670,0,0
33054,2019-09-01,444,0,444,26,470,470,0,0
33055,2019-09-01,1501,0,1501,119,1620,1620,0,0
33056,2019-09-01,1769,0,1769,141,1910,1910,0,0
33057,2019-09-01,130,0,130,10,140,140,0,0
33058,2019-09-01,249,0,249,11,260,260,0,0
33059,2019-09-01,350,0,350,10,360,360,0,0
33060,2019-09-01,278,0,278,22,300,300,0,0
33061,2019-09-01,139,0,139,11,150,150,0,0
33062,2019-09-01,723,0,723,57,780,780,0,0
33063,2019-09-01,195,0,195,15,210,210,0,0
33064,2019-09-01,408,0,408,32,440,440,0,0
33065,2019-09-01,908,0,908,72,980,980,0,0
33066,2019-09-01,232,0,232,18,250,250,0,0
33067,2019-09-01,1213,0,1213,97,1310,1310,0,0
33068,2019-09-01,1333,0,1333,97,1430,1430,0,0
33069,2019-09-01,638,0,638,42,680,680,0,0
33070,2019-09-01,1001,0,1001,79,1080,1080,0,0
33071,2019-09-01,334,0,334,26,360,360,0,0
33072,2019-09-01,1075,0,1075,85,1160,1160,0,0
33073,2019-09-01,963,0,963,77,1040,1040,0,0
33074,2019-09-01,480,0,480,20,500,500,0,0
33075,2019-09-01,389,0,389,31,420,420,0,0
33076,2019-09-01,1249,0,1249,91,1340,1340,0,0
33077,2019-09-01,260,0,260,20,280,280,0,0
33078,2019-09-01,528,0,528,42,570,570,0,0
33079,2019-09-01,602,0,602,48,650,650,0,0
33080,2019-09-01,1325,0,1325,105,1430,1430,0,0
33081,2019-09-01,917,0,917,73,990,990,0,0
33082,2019-09-01,1102,0,1102,88,1190,1190,0,0
33083,2019-09-01,315,0,315,25,340,340,0,0
33084,2019-09-01,704,0,704,56,760,760,0,0
33085,2019-09-01,1065,0,1065,85,1150,1150,0,0
33086,2019-09-01,269,0,269,21,290,290,0,0
33087,2019-09-01,1501,0,1501,119,1620,1620,0,0
33088,2019-09-01,963,0,963,77,1040,1040,0,0
33089,2019-09-01,477,-51,426,33,459,459,0,0
33090,2019-09-01,593,0,593,47,640,640,0,0
33091,2019-09-01,1686,0,1686,134,1820,1820,0,0
33092,2019-09-01,399,0,399,31,430,430,0,0
33093,2019-09-01,528,0,528,42,570,570,0,0
33094,2019-09-01,260,0,260,20,280,280,0,0
33095,2019-09-01,538,0,538,42,580,580,0,0
33096,2019-09-01,204,0,204,16,220,220,0,0
33097,2019-09-01,1213,0,1213,97,1310,0,1310,0
33098,2019-09-01,500,0,500,40,540,540,0,0
33099,2019-09-01,417,0,417,33,450,450,0,0
33100,2019-09-01,778,0,778,62,840,840,0,0
33101,2019-09-01,1001,0,1001,79,1080,1080,0,0
33102,2019-09-01,399,0,399,31,430,430,0,0
33103,2019-09-01,380,0,380,30,410,410,0,0
33104,2019-09-01,1723,0,1723,137,1860,1860,0,0
33105,2019-09-01,926,0,926,74,1000,1000,0,0
33106,2019-09-01,555,0,555,35,590,590,0,0
33107,2019-09-01,176,0,176,14,190,190,0,0
33108,2019-09-01,1038,0,1038,82,1120,1120,0,0
33109,2019-09-01,658,0,658,52,710,710,0,0
33110,2019-09-01,260,0,260,20,280,280,0,0
33111,2019-09-01,473,0,473,37,510,510,0,0
33112,2019-09-01,315,0,315,25,340,340,0,0
33113,2019-09-01,833,0,833,57,890,890,0,0
33114,2019-09-01,473,0,473,37,510,510,0,0
33115,2019-09-01,1241,0,1241,99,1340,1340,0,0
33116,2019-09-01,362,0,362,28,390,390,0,0
33117,2019-09-01,1065,0,1065,85,1150,1150,0,0
33118,2019-09-01,648,0,648,42,690,690,0,0
33119,2019-09-01,325,0,325,25,350,350,0,0
33120,2019-09-01,110,0,110,0,110,110,0,0
33121,2019-09-01,325,0,325,25,350,350,0,0
33122,2019-09-01,575,0,575,45,620,620,0,0
33123,2019-09-01,575,0,575,45,620,620,0,0
33124,2019-09-01,760,0,760,60,820,820,0,0
33125,2019-09-01,149,0,149,11,160,160,0,0
33126,2019-09-01,880,0,880,70,950,950,0,0
33127,2019-09-01,1223,0,1223,97,1320,1320,0,0
33128,2019-09-01,2769,0,2769,221,2990,2990,0,0
33129,2019-09-01,445,0,445,35,480,480,0,0
33130,2019-09-01,1454,0,1454,116,1570,1570,0,0
33131,2019-09-01,1167,0,1167,93,1260,1260,0,0
33132,2019-09-01,732,0,732,58,790,790,0,0
33133,2019-09-01,306,0,306,24,330,330,0,0
33134,2019-09-01,2593,0,2593,207,2800,2800,0,0
33135,2019-09-01,788,0,788,62,850,850,0,0
33136,2019-09-01,1297,0,1297,103,1400,1400,0,0
33137,2019-09-01,806,0,806,64,870,870,0,0
33138,2019-09-01,556,0,556,44,600,600,0,0
33139,2019-09-01,1575,0,1575,125,1700,1700,0,0
33140,2019-09-01,112,0,112,8,120,120,0,0
33141,2019-09-01,510,0,510,40,550,550,0,0
33142,2019-09-01,732,0,732,58,790,790,0,0
33143,2019-09-01,306,0,306,24,330,330,0,0
33144,2019-09-01,815,0,815,65,880,880,0,0
33145,2019-09-01,380,0,380,30,410,410,0,0
33146,2019-09-01,788,0,788,62,850,850,0,0
33147,2019-09-01,1139,0,1139,91,1230,1230,0,0
33148,2019-09-01,241,0,241,19,260,260,0,0
33149,2019-09-01,232,0,232,18,250,250,0,0
33150,2019-09-01,278,0,278,22,300,300,0,0
33151,2019-09-01,149,0,149,11,160,160,0,0
33152,2019-09-01,2500,0,2500,200,2700,2700,0,0
33153,2019-09-01,463,0,463,37,500,500,0,0
33154,2019-09-01,371,0,371,29,400,400,0,0
33155,2019-09-01,1482,0,1482,118,1600,1600,0,0
33156,2019-09-01,788,0,788,62,850,850,0,0
33157,2019-09-01,167,0,167,13,180,180,0,0
33158,2019-09-01,1852,0,1852,148,2000,2000,0,0
33159,2019-09-01,788,0,788,62,850,850,0,0
33160,2019-09-01,343,0,343,27,370,370,0,0
33161,2019-09-01,1075,0,1075,85,1160,1160,0,0
33162,2019-09-02,704,0,704,56,760,760,0,0
33163,2019-09-02,667,0,667,53,720,720,0,0
33164,2019-09-02,1815,0,1815,145,1960,1960,0,0
33165,2019-09-02,834,0,834,66,900,900,0,0
33166,2019-09-02,-593,0,-593,-47,-640,-640,0,0
33167,2019-09-02,500,0,500,40,540,540,0,0
33168,2019-09-02,268,0,268,12,280,280,0,0
33169,2019-09-02,204,0,204,16,220,220,0,0
33170,2019-09-02,982,0,982,78,1060,1060,0,0
33171,2019-09-02,306,0,306,24,330,0,0,330
33172,2019-09-02,454,0,454,36,490,490,0,0
33173,2019-09-02,1815,0,1815,145,1960,1960,0,0
33174,2019-09-02,1399,0,1399,111,1510,0,1510,0
33175,2019-09-02,908,0,908,72,980,0,0,980
33176,2019-09-02,593,0,593,47,640,640,0,0
33177,2019-09-02,593,0,593,47,640,640,0,0
33178,2019-09-02,556,0,556,44,600,600,0,0
33179,2019-09-02,2167,0,2167,173,2340,2340,0,0
33180,2019-09-02,1038,0,1038,82,1120,1120,0,0
33181,2019-09-02,1815,0,1815,145,1960,1960,0,0
33182,2019-09-02,426,0,426,34,460,460,0,0
33183,2019-09-02,3630,0,3630,290,3920,3920,0,0
33184,2019-09-02,399,0,399,31,430,430,0,0
33185,2019-09-02,1388,0,1388,102,1490,1490,0,0
33186,2019-09-02,852,0,852,68,920,920,0,0
33187,2019-09-02,362,0,362,28,390,0,0,390
33188,2019-09-02,436,0,436,34,470,470,0,0
33189,2019-09-02,186,0,186,14,200,200,0,0
33190,2019-09-02,408,0,408,32,440,440,0,0
33191,2019-09-02,621,0,621,49,670,670,0,0
33192,2019-09-02,0,0,0,0,-100,-100,0,0
33193,2019-09-02,788,0,788,62,850,850,0,0
33194,2019-09-02,269,0,269,21,290,290,0,0
33195,2019-09-02,315,0,315,25,340,340,0,0
33196,2019-09-02,186,0,186,14,200,200,0,0
33197,2019-09-02,408,0,408,32,440,440,0,0
33198,2019-09-02,667,0,667,53,720,720,0,0
33199,2019-09-02,371,0,371,29,400,400,0,0
33200,2019-09-02,759,0,759,51,810,810,0,0
33201,2019-09-02,315,0,315,25,340,340,0,0
33202,2019-09-02,916,0,916,64,980,980,0,0
33203,2019-09-02,1019,0,1019,81,1100,1100,0,0
33204,2019-09-02,241,0,241,19,260,260,0,0
33205,2019-09-02,417,0,417,33,450,450,0,0
33206,2019-09-02,935,0,935,65,1000,1000,0,0
33207,2019-09-02,297,0,297,23,320,320,0,0
33208,2019-09-02,760,0,760,60,820,820,0,0
33209,2019-09-02,232,0,232,18,250,250,0,0
33210,2019-09-02,334,0,334,26,360,360,0,0
33211,2019-09-02,917,0,917,73,990,990,0,0
33212,2019-09-02,1232,0,1232,98,1330,1330,0,0
33213,2019-09-02,1139,0,1139,91,1230,1230,0,0
33214,2019-09-02,1366,0,1366,109,1475,1475,0,0
33215,2019-09-02,686,0,686,54,740,740,0,0
33216,2019-09-02,463,0,463,37,500,500,0,0
33217,2019-09-02,602,0,602,48,650,650,0,0
33218,2019-09-02,1084,0,1084,86,1170,1170,0,0
33219,2019-09-02,1732,0,1732,138,1870,1870,0,0
33220,2019-09-02,426,0,426,34,460,460,0,0
33221,2019-09-02,343,0,343,27,370,370,0,0
33222,2019-09-02,788,0,788,62,850,850,0,0
33223,2019-09-02,278,0,278,22,300,300,0,0
33224,2019-09-02,788,0,788,62,850,850,0,0
33225,2019-09-02,473,0,473,37,510,510,0,0
33226,2019-09-02,1334,0,1334,106,1440,1440,0,0
33227,2019-09-02,3028,0,3028,242,3270,3270,0,0
33228,2019-09-02,982,0,982,78,1060,1060,0,0
33229,2019-09-02,806,0,806,64,870,870,0,0
33230,2019-09-02,260,0,260,20,280,280,0,0
33231,2019-09-02,556,0,556,44,600,600,0,0
33232,2019-09-02,1084,0,1084,86,1170,1170,0,0
33233,2019-09-02,288,0,288,22,310,310,0,0
33234,2019-09-02,3112,0,3112,248,3360,3360,0,0
33235,2019-09-02,778,0,778,62,840,840,0,0
33236,2019-09-02,260,0,260,20,280,280,0,0
33237,2019-09-02,269,0,269,21,290,290,0,0
33238,2019-09-02,362,0,362,28,390,390,0,0
33239,2019-09-02,1001,0,1001,79,1080,1080,0,0
33240,2019-09-02,519,0,519,41,560,560,0,0
33241,2019-09-02,371,0,371,29,400,400,0,0
33242,2019-09-02,556,0,556,44,600,600,0,0
33243,2019-09-02,769,0,769,61,830,830,0,0
33244,2019-09-02,1139,0,1139,91,1230,1230,0,0
33245,2019-09-02,630,0,630,50,680,680,0,0
33246,2019-09-02,186,0,186,14,200,200,0,0
33247,2019-09-02,908,0,908,72,980,980,0,0
33248,2019-09-02,352,0,352,28,380,380,0,0
33249,2019-09-02,297,0,297,23,320,320,0,0
33250,2019-09-02,260,0,260,20,280,280,0,0
33251,2019-09-02,1923,0,1923,145,2068,2068,0,0
33252,2019-09-02,788,0,788,62,850,850,0,0
33253,2019-09-02,732,0,732,58,790,790,0,0
33254,2019-09-02,158,0,158,12,170,170,0,0
33255,2019-09-02,778,0,778,62,840,840,0,0
33256,2019-09-02,482,0,482,38,520,520,0,0
33257,2019-09-02,686,0,686,54,740,740,0,0
33258,2019-09-02,788,0,788,62,850,0,850,0
33259,2019-09-02,658,0,658,52,710,710,0,0
33260,2019-09-02,389,0,389,31,420,420,0,0
33261,2019-09-02,1222,0,1222,88,1310,1310,0,0
33262,2019-09-02,738,-79,659,52,711,711,0,0
33263,2019-09-02,389,0,389,31,420,420,0,0
33264,2019-09-02,760,0,760,60,820,820,0,0
33265,2019-09-02,2251,0,2251,179,2430,2430,0,0
33266,2019-09-02,1241,0,1241,99,1340,1340,0,0
33267,2019-09-02,695,0,695,55,750,750,0,0
33268,2019-09-02,362,0,362,28,390,390,0,0
33269,2019-09-02,1417,0,1417,113,1530,1530,0,0
33270,2019-09-02,334,0,334,26,360,360,0,0
33271,2019-09-02,676,0,676,54,730,730,0,0
33272,2019-09-02,241,0,241,19,260,260,0,0
33273,2019-09-02,1575,0,1575,125,1700,1700,0,0
33274,2019-09-02,176,0,176,14,190,190,0,0
33275,2019-09-02,612,0,612,48,660,660,0,0
33276,2019-09-02,926,0,926,74,1000,1000,0,0
33277,2019-09-02,612,0,612,48,660,660,0,0
33278,2019-09-02,102,0,102,8,110,0,0,110
33279,2019-09-02,-102,0,-102,-8,-110,0,0,-110
33280,2019-09-02,-612,0,-612,-48,-660,-660,0,0
33281,2019-09-02,612,0,612,48,660,660,0,0
33282,2019-09-02,788,0,788,62,850,850,0,0
33283,2019-09-02,788,0,788,62,850,850,0,0
33284,2019-09-02,417,0,417,33,450,450,0,0
33285,2019-09-02,639,0,639,51,690,690,0,0
33286,2019-09-02,847,-180,667,53,720,720,0,0
33287,2019-09-03,500,0,500,40,540,540,0,0
33288,2019-09-03,625,0,625,50,675,675,0,0
33289,2019-09-03,361,0,361,19,380,380,0,0
33290,2019-09-03,482,0,482,38,520,520,0,0
33291,2019-09-03,1121,0,1121,89,1210,1210,0,0
33292,2019-09-03,806,0,806,64,870,870,0,0
33293,2019-09-03,871,0,871,69,940,940,0,0
33294,2019-09-03,288,0,288,22,310,310,0,0
33295,2019-09-03,232,0,232,18,250,250,0,0
33296,2019-09-03,638,0,638,42,680,680,0,0
33297,2019-09-03,732,0,732,58,790,790,0,0
33298,2019-09-03,399,0,399,31,430,430,0,0
33299,2019-09-03,899,0,899,71,970,970,0,0
33300,2019-09-03,473,0,473,37,510,510,0,0
33301,2019-09-03,223,0,223,17,240,240,0,0
33302,2019-09-03,232,0,232,18,250,250,0,0
33303,2019-09-03,217,0,217,17,234,234,0,0
33304,2019-09-03,362,0,362,28,390,390,0,0
33305,2019-09-04,439,-47,392,31,423,423,0,0
33306,2019-09-04,-234,25,-209,-16,-225,-225,0,0
33307,2019-09-04,501,0,501,39,540,540,0,0
33308,2019-09-04,166,0,166,4,170,170,0,0
33309,2019-09-04,926,0,926,74,1000,1000,0,0
33310,2019-09-04,639,0,639,51,690,690,0,0
33311,2019-09-04,778,0,778,62,840,840,0,0
33312,2019-09-04,260,0,260,20,280,280,0,0
33313,2019-09-04,880,0,880,70,950,950,0,0
33314,2019-09-04,968,0,968,77,1045,1045,0,0
33315,2019-09-04,1260,0,1260,100,1360,1360,0,0
33316,2019-09-04,704,0,704,56,760,760,0,0
33317,2019-09-04,186,0,186,14,200,200,0,0
33318,2019-09-04,454,0,454,36,490,490,0,0
33319,2019-09-04,630,0,630,50,680,680,0,0
33320,2019-09-04,908,0,908,72,980,980,0,0
33321,2019-09-04,-690,0,-690,-55,-745,-745,0,0
33322,2019-09-04,491,0,491,39,530,530,0,0
33323,2019-09-04,1079,0,1079,86,1165,1165,0,0
33324,2019-09-04,352,0,352,28,380,380,0,0
33325,2019-09-04,334,0,334,26,360,360,0,0
33326,2019-09-04,1075,0,1075,85,1160,0,1160,0
33327,2019-09-04,704,0,704,56,760,760,0,0
33328,2019-09-04,139,0,139,11,150,150,0,0
33329,2019-09-04,325,0,325,25,350,350,0,0
33330,2019-09-04,851,0,851,59,910,910,0,0
33331,2019-09-04,834,0,834,66,900,900,0,0
33332,2019-09-04,1121,0,1121,89,1210,1210,0,0
33333,2019-09-04,1269,0,1269,101,1370,1370,0,0
33334,2019-09-04,649,0,649,51,700,700,0,0
33335,2019-09-04,2186,0,2186,174,2360,2360,0,0
33336,2019-09-04,1584,0,1584,126,1710,1710,0,0
33337,2019-09-04,306,0,306,24,330,330,0,0
33338,2019-09-04,1297,0,1297,103,1400,1400,0,0
33339,2019-09-04,2723,0,2723,217,2940,2940,0,0
33340,2019-09-04,630,0,630,50,680,680,0,0
33341,2019-09-04,741,0,741,59,800,800,0,0
33342,2019-09-04,908,0,908,72,980,980,0,0
33343,2019-09-04,908,0,908,72,980,980,0,0
33344,2019-09-04,371,0,371,29,400,400,0,0
33345,2019-09-04,306,0,306,24,330,330,0,0
33346,2019-09-04,2223,0,2223,177,2400,2400,0,0
33347,2019-09-04,547,0,547,43,590,590,0,0
33348,2019-09-04,315,0,315,25,340,340,0,0
33349,2019-09-04,527,0,527,33,560,560,0,0
33350,2019-09-04,889,0,889,71,960,960,0,0
33351,2019-09-04,528,0,528,42,570,570,0,0
33352,2019-09-04,741,0,741,59,800,800,0,0
33353,2019-09-04,676,0,676,54,730,730,0,0
33354,2019-09-04,408,0,408,32,440,440,0,0
33355,2019-09-04,972,0,972,68,1040,1040,0,0
33356,2019-09-04,1121,0,1121,89,1210,1210,0,0
33357,2019-09-04,889,0,889,71,960,960,0,0
33358,2019-09-04,788,0,788,62,850,850,0,0
33359,2019-09-04,1473,0,1473,117,1590,1590,0,0
33360,2019-09-04,167,0,167,13,180,180,0,0
33361,2019-09-04,1065,0,1065,85,1150,1150,0,0
33362,2019-09-04,278,0,278,22,300,300,0,0
33363,2019-09-04,788,0,788,62,850,850,0,0
33364,2019-09-04,1575,0,1575,125,1700,1700,0,0
33365,2019-09-04,788,0,788,62,850,850,0,0
33366,2019-09-04,362,0,362,28,390,390,0,0
33367,2019-09-04,1278,0,1278,102,1380,1380,0,0
33368,2019-09-04,584,0,584,46,630,630,0,0
33369,2019-09-04,371,0,371,29,400,400,0,0
33370,2019-09-04,491,0,491,39,530,530,0,0
33371,2019-09-04,510,0,510,40,550,550,0,0
33372,2019-09-04,1575,0,1575,125,1700,1700,0,0
33373,2019-09-04,880,0,880,70,950,950,0,0
33374,2019-09-04,690,0,690,55,745,745,0,0
33375,2019-09-04,1195,0,1195,95,1290,1290,0,0
33376,2019-09-04,422,0,422,33,455,455,0,0
33377,2019-09-04,121,0,121,9,130,130,0,0
33378,2019-09-04,667,0,667,53,720,720,0,0
33379,2019-09-04,1269,0,1269,101,1370,1370,0,0
33380,2019-09-04,110,-22,88,0,88,88,0,0
33381,2019-09-04,232,0,232,18,250,250,0,0
33382,2019-09-04,1815,0,1815,145,1960,1960,0,0
33383,2019-09-04,1815,0,1815,145,1960,1960,0,0
33384,2019-09-04,982,0,982,78,1060,1060,0,0
33385,2019-09-04,1019,0,1019,81,1100,1100,0,0
33386,2019-09-04,630,0,630,50,680,680,0,0
33387,2019-09-04,269,0,269,21,290,290,0,0
33388,2019-09-04,1260,0,1260,100,1360,1360,0,0
33389,2019-09-04,278,0,278,22,300,300,0,0
33390,2019-09-04,732,0,732,58,790,790,0,0
33391,2019-09-04,968,0,968,77,1045,1045,0,0
33392,2019-09-04,269,0,269,21,290,290,0,0
33393,2019-09-04,473,0,473,37,510,510,0,0
33394,2019-09-04,778,0,778,62,840,840,0,0
33395,2019-09-05,1232,0,1232,98,1330,1330,0,0
33396,2019-09-05,1075,-1000,75,5,80,80,0,0
33397,2019-09-05,547,0,547,43,590,590,0,0
33398,2019-09-05,232,0,232,18,250,250,0,0
33399,2019-09-05,519,0,519,41,560,560,0,0
33400,2019-09-05,1463,0,1463,117,1580,1580,0,0
33401,2019-09-05,649,0,649,51,700,700,0,0
33402,2019-09-05,491,0,491,39,530,530,0,0
33403,2019-09-05,112,0,112,8,120,120,0,0
33404,2019-09-05,713,0,713,57,770,770,0,0
33405,2019-09-05,371,0,371,29,400,400,0,0
33406,2019-09-05,945,0,945,75,1020,1020,0,0
33407,2019-09-05,1815,0,1815,145,1960,1960,0,0
33408,2019-09-05,1788,0,1788,142,1930,1930,0,0
33409,2019-09-05,602,0,602,48,650,650,0,0
33410,2019-09-05,364,-39,325,26,351,351,0,0
33411,2019-09-05,621,0,621,49,670,670,0,0
33412,2019-09-05,556,0,556,44,600,600,0,0
33413,2019-09-05,945,0,945,75,1020,1020,0,0
33414,2019-09-05,908,0,908,72,980,980,0,0
33415,2019-09-05,908,0,908,72,980,980,0,0
33416,2019-09-05,908,0,908,72,980,980,0,0
33417,2019-09-05,306,0,306,24,330,330,0,0
33418,2019-09-05,1036,-111,925,74,999,999,0,0
33419,2019-09-05,908,0,908,72,980,980,0,0
33420,2019-09-05,908,0,908,72,980,980,0,0
33421,2019-09-05,751,0,751,59,810,810,0,0
33422,2019-09-05,1306,0,1306,104,1410,1410,0,0
33423,2019-09-05,713,0,713,57,770,770,0,0
33424,2019-09-05,362,0,362,28,390,390,0,0
33425,2019-09-05,1158,0,1158,92,1250,1250,0,0
33426,2019-09-05,908,0,908,72,980,980,0,0
33427,2019-09-05,260,0,260,20,280,280,0,0
33428,2019-09-05,759,0,759,51,810,0,810,0
33429,2019-09-05,348,0,348,27,375,375,0,0
33430,2019-09-05,538,0,538,42,580,580,0,0
33431,2019-09-05,445,0,445,35,480,480,0,0
33432,2019-09-05,1334,0,1334,106,1440,1440,0,0
33433,2019-09-05,167,0,167,13,180,180,0,0
33434,2019-09-05,1815,0,1815,145,1960,1960,0,0
33435,2019-09-05,448,-48,400,32,432,432,0,0
33436,2019-09-05,1000,0,1000,80,1080,1080,0,0
33437,2019-09-05,1001,0,1001,79,1080,1080,0,0
33438,2019-09-05,102,0,102,8,110,110,0,0
33439,2019-09-05,899,0,899,71,970,970,0,0
33440,2019-09-05,788,0,788,62,850,850,0,0
33441,2019-09-05,343,0,343,27,370,370,0,0
33442,2019-09-05,602,0,602,48,650,650,0,0
33443,2019-09-05,612,0,612,48,660,660,0,0
33444,2019-09-05,389,0,389,31,420,420,0,0
33445,2019-09-05,1510,0,1510,120,1630,1630,0,0
33446,2019-09-05,297,0,297,23,320,320,0,0
33447,2019-09-05,306,0,306,24,330,330,0,0
33448,2019-09-05,1241,0,1241,99,1340,1340,0,0
33449,2019-09-05,343,0,343,27,370,370,0,0
33450,2019-09-05,621,0,621,49,670,670,0,0
33451,2019-09-05,1204,0,1204,96,1300,1300,0,0
33452,2019-09-05,399,0,399,31,430,430,0,0
33453,2019-09-05,278,0,278,22,300,300,0,0
33454,2019-09-05,338,0,338,27,365,365,0,0
33455,2019-09-05,565,0,565,45,610,610,0,0
33456,2019-09-05,509,0,509,31,540,540,0,0
33457,2019-09-05,213,0,213,17,230,230,0,0
33458,2019-09-05,1038,0,1038,82,1120,1120,0,0
33459,2019-09-05,602,0,602,48,650,650,0,0
33460,2019-09-05,663,-71,592,47,639,0,0,639
33461,2019-09-05,269,0,269,21,290,290,0,0
33462,2019-09-05,945,0,945,75,1020,0,1020,0
33463,2019-09-05,760,0,760,60,820,820,0,0
33464,2019-09-05,695,0,695,55,750,750,0,0
33465,2019-09-05,788,0,788,62,850,850,0,0
33466,2019-09-05,1054,0,1054,66,1120,1120,0,0
33467,2019-09-05,445,0,445,35,480,480,0,0
33468,2019-09-05,1203,0,1203,87,1290,1290,0,0
33469,2019-09-05,213,0,213,17,230,230,0,0
33470,2019-09-05,982,0,982,78,1060,0,1060,0
33471,2019-09-05,362,0,362,28,390,390,0,0
33472,2019-09-05,862,0,862,68,930,930,0,0
33473,2019-09-05,869,0,869,51,920,920,0,0
33474,2019-09-05,371,0,371,29,400,400,0,0
33475,2019-09-05,963,0,963,77,1040,1040,0,0
33476,2019-09-05,769,0,769,61,830,830,0,0
33477,2019-09-05,778,0,778,62,840,840,0,0
33478,2019-09-05,278,0,278,22,300,300,0,0
33479,2019-09-05,250,0,250,20,270,270,0,0
33480,2019-09-05,1121,0,1121,89,1210,1210,0,0
33481,2019-09-05,769,0,769,61,830,830,0,0
33482,2019-09-05,1139,0,1139,91,1230,1230,0,0
33483,2019-09-05,786,0,786,54,840,840,0,0
33484,2019-09-05,260,0,260,20,280,280,0,0
33485,2019-09-05,2343,0,2343,187,2530,0,2530,0
33486,2019-09-05,602,0,602,48,650,650,0,0
33487,2019-09-05,417,0,417,33,450,450,0,0
33488,2019-09-05,788,0,788,62,850,850,0,0
33489,2019-09-05,658,0,658,52,710,710,0,0
33490,2019-09-05,778,0,778,62,840,840,0,0
33491,2019-09-05,371,0,371,29,400,400,0,0
33492,2019-09-05,760,0,760,60,820,820,0,0
33493,2019-09-05,693,0,693,37,730,730,0,0
33494,2019-09-05,389,0,389,31,420,420,0,0
33495,2019-09-05,167,0,167,13,180,180,0,0
33496,2019-09-05,639,0,639,51,690,690,0,0
33497,2019-09-05,788,0,788,62,850,850,0,0
33498,2019-09-05,408,0,408,32,440,440,0,0
33499,2019-09-05,2815,0,2815,225,3040,0,3040,0
33500,2019-09-05,899,0,899,71,970,970,0,0
33501,2019-09-05,575,0,575,45,620,620,0,0
33502,2019-09-05,1001,0,1001,79,1080,1080,0,0
33503,2019-09-05,593,0,593,47,640,640,0,0
33504,2019-09-05,234,-25,209,16,225,225,0,0
33505,2019-09-05,556,0,556,44,600,600,0,0
33506,2019-09-05,389,0,389,31,420,420,0,0
33507,2019-09-05,908,0,908,72,980,980,0,0
33508,2019-09-05,908,0,908,72,980,980,0,0
33509,2019-09-05,908,0,908,72,980,980,0,0
33510,2019-09-05,908,0,908,72,980,980,0,0
33511,2019-09-05,501,0,501,39,540,540,0,0
33512,2019-09-05,903,0,903,72,975,975,0,0
33513,2019-09-05,723,0,723,57,780,780,0,0
33514,2019-09-05,908,0,908,72,980,980,0,0
33515,2019-09-05,399,0,399,31,430,430,0,0
33516,2019-09-05,158,0,158,12,170,170,0,0
33517,2019-09-05,794,-85,709,56,765,765,0,0
33518,2019-09-05,788,0,788,62,850,850,0,0
33519,2019-09-05,528,0,528,42,570,570,0,0
33520,2019-09-05,1963,0,1963,157,2120,2120,0,0
33521,2019-09-05,1575,0,1575,125,1700,1700,0,0
33522,2019-09-05,1408,0,1408,112,1520,1520,0,0
33523,2019-09-05,288,0,288,22,310,310,0,0
33524,2019-09-05,399,0,399,31,430,430,0,0
33525,2019-09-05,834,0,834,66,900,900,0,0
33526,2019-09-05,482,0,482,38,520,520,0,0
33527,2019-09-05,575,0,575,45,620,620,0,0
33528,2019-09-05,-1575,0,-1575,-125,-1700,-1700,0,0
33529,2019-09-05,-788,0,-788,-62,-850,-850,0,0
33530,2019-09-05,1575,0,1575,125,1700,0,0,1700
33531,2019-09-05,297,0,297,23,320,320,0,0
33532,2019-09-05,1158,0,1158,92,1250,1250,0,0
33533,2019-09-06,973,0,973,77,1050,1050,0,0
33534,2019-09-06,908,0,908,72,980,980,0,0
33535,2019-09-06,899,0,899,71,970,970,0,0
33536,2019-09-06,411,-44,367,29,396,396,0,0
33537,2019-09-06,1473,0,1473,117,1590,1590,0,0
33538,2019-09-06,315,0,315,25,340,340,0,0
33539,2019-09-06,926,0,926,74,1000,1000,0,0
33540,2019-09-06,1203,0,1203,87,1290,1290,0,0
33541,2019-09-06,639,0,639,51,690,690,0,0
33542,2019-09-06,1149,0,1149,91,1240,1240,0,0
33543,2019-09-06,1830,-196,1634,130,1764,1764,0,0
33544,2019-09-06,501,0,501,39,540,540,0,0
33545,2019-09-06,334,0,334,26,360,360,0,0
33546,2019-09-06,288,0,288,22,310,310,0,0
33547,2019-09-06,251,0,251,19,270,0,270,0
33548,2019-09-06,2065,0,2065,165,2230,2230,0,0
33549,2019-09-06,805,0,805,55,860,860,0,0
33550,2019-09-06,352,0,352,28,380,380,0,0
33551,2019-09-06,1038,0,1038,82,1120,0,0,1120
33552,2019-09-06,278,0,278,22,300,300,0,0
33553,2019-09-06,463,0,463,37,500,500,0,0
33554,2019-09-06,1389,0,1389,111,1500,1500,0,0
33555,2019-09-06,954,0,954,76,1030,0,1030,0
33556,2019-09-06,315,0,315,25,340,340,0,0
33557,2019-09-06,278,0,278,22,300,300,0,0
33558,2019-09-06,963,0,963,77,1040,1040,0,0
33559,2019-09-06,1149,0,1149,91,1240,1240,0,0
33560,2019-09-06,1186,0,1186,94,1280,1280,0,0
33561,2019-09-06,1880,0,1880,150,2030,2030,0,0
33562,2019-09-06,1093,0,1093,87,1180,1180,0,0
33563,2019-09-06,649,0,649,51,700,700,0,0
33564,2019-09-06,621,0,621,49,670,670,0,0
33565,2019-09-06,1213,0,1213,97,1310,1310,0,0
33566,2019-09-06,269,0,269,21,290,290,0,0
33567,2019-09-06,1963,0,1963,157,2120,2120,0,0
33568,2019-09-06,1130,0,1130,90,1220,1220,0,0
33569,2019-09-06,315,0,315,25,340,340,0,0
33570,2019-09-06,389,0,389,31,420,420,0,0
33571,2019-09-06,1362,0,1362,108,1470,1470,0,0
33572,2019-09-06,112,0,112,8,120,120,0,0
33573,2019-09-06,1186,0,1186,94,1280,1280,0,0
33574,2019-09-06,482,0,482,38,520,520,0,0
33575,2019-09-06,908,0,908,72,980,980,0,0
33576,2019-09-06,1038,0,1038,82,1120,1120,0,0
33577,2019-09-06,908,0,908,72,980,980,0,0
33578,2019-09-06,1815,0,1815,145,1960,0,1960,0
33579,2019-09-06,908,0,908,72,980,980,0,0
33580,2019-09-06,1047,0,1047,83,1130,1130,0,0
33581,2019-09-06,954,0,954,76,1030,1030,0,0
33582,2019-09-06,954,0,954,76,1030,1030,0,0
33583,2019-09-06,1426,0,1426,114,1540,1540,0,0
33584,2019-09-06,528,0,528,42,570,570,0,0
33585,2019-09-06,815,0,815,65,880,880,0,0
33586,2019-09-06,1362,0,1362,108,1470,1470,0,0
33587,2019-09-06,158,0,158,12,170,170,0,0
33588,2019-09-06,908,0,908,72,980,980,0,0
33589,2019-09-06,547,0,547,43,590,590,0,0
33590,2019-09-06,908,0,908,72,980,980,0,0
33591,2019-09-06,723,0,723,57,780,780,0,0
33592,2019-09-06,700,-75,625,50,675,675,0,0
33593,2019-09-06,658,0,658,52,710,710,0,0
33594,2019-09-06,426,0,426,34,460,460,0,0
33595,2019-09-06,260,0,260,20,280,280,0,0
33596,2019-09-06,1306,0,1306,104,1410,1410,0,0
33597,2019-09-06,908,0,908,72,980,980,0,0
33598,2019-09-06,658,0,658,52,710,710,0,0
33599,2019-09-06,1593,0,1593,127,1720,1720,0,0
33600,2019-09-06,1102,0,1102,88,1190,1190,0,0
33601,2019-09-06,2445,0,2445,195,2640,2640,0,0
33602,2019-09-06,667,0,667,53,720,720,0,0
33603,2019-09-06,408,0,408,32,440,440,0,0
33604,2019-09-06,528,0,528,42,570,570,0,0
33605,2019-09-06,1047,0,1047,83,1130,1130,0,0
33606,2019-09-06,1575,0,1575,125,1700,1700,0,0
33607,2019-09-06,1121,0,1121,89,1210,0,1210,0
33608,2019-09-06,325,0,325,25,350,350,0,0
33609,2019-09-06,639,0,639,51,690,690,0,0
33610,2019-09-06,658,0,658,52,710,710,0,0
33611,2019-09-06,584,0,584,46,630,630,0,0
33612,2019-09-06,667,0,667,53,720,720,0,0
33613,2019-09-06,954,0,954,76,1030,1030,0,0
33614,2019-09-06,323,0,323,17,340,340,0,0
33615,2019-09-06,121,0,121,9,130,130,0,0
33616,2019-09-06,1139,0,1139,91,1230,1230,0,0
33617,2019-09-06,277,0,277,13,290,290,0,0
33618,2019-09-06,436,0,436,34,470,470,0,0
33619,2019-09-06,768,0,768,52,820,820,0,0
33620,2019-09-06,369,0,369,11,380,380,0,0
33621,2019-09-06,806,0,806,64,870,870,0,0
33622,2019-09-06,352,0,352,28,380,380,0,0
33623,2019-09-06,880,0,880,70,950,950,0,0
33624,2019-09-06,399,0,399,31,430,430,0,0
33625,2019-09-06,334,0,334,26,360,360,0,0
33626,2019-09-06,815,0,815,65,880,880,0,0
33627,2019-09-06,691,-74,617,49,666,666,0,0
33628,2019-09-06,908,0,908,72,980,0,0,980
33629,2019-09-06,399,0,399,31,430,430,0,0
33630,2019-09-06,650,-138,512,40,552,552,0,0
33631,2019-09-06,491,0,491,39,530,530,0,0
33632,2019-09-06,917,0,917,73,990,990,0,0
33633,2019-09-06,980,0,980,60,1040,1040,0,0
33634,2019-09-06,323,0,323,17,340,340,0,0
33635,2019-09-06,334,0,334,26,360,360,0,0
33636,2019-09-06,538,0,538,42,580,580,0,0
33637,2019-09-06,952,-102,850,68,918,918,0,0
33638,2019-09-06,1445,0,1445,115,1560,1560,0,0
33639,2019-09-06,495,-53,442,35,477,477,0,0
33640,2019-09-06,973,0,973,77,1050,1050,0,0
33641,2019-09-06,532,-57,475,38,513,513,0,0
33642,2019-09-06,501,0,501,39,540,540,0,0
33643,2019-09-06,621,0,621,49,670,670,0,0
33644,2019-09-06,862,0,862,68,930,930,0,0
33645,2019-09-06,232,0,232,18,250,250,0,0
33646,2019-09-06,1028,0,1028,82,1110,1110,0,0
33647,2019-09-06,723,0,723,57,780,780,0,0
33648,2019-09-06,760,0,760,60,820,820,0,0
33649,2019-09-06,593,0,593,47,640,640,0,0
33650,2019-09-06,556,0,556,44,600,600,0,0
33651,2019-09-06,2362,0,2362,188,2550,2550,0,0
33652,2019-09-06,556,0,556,44,600,600,0,0
33653,2019-09-06,806,0,806,64,870,870,0,0
33654,2019-09-06,278,0,278,22,300,300,0,0
33655,2019-09-06,2130,0,2130,170,2300,2300,0,0
33656,2019-09-06,3149,0,3149,251,3400,3400,0,0
33657,2019-09-06,463,0,463,37,500,500,0,0
33658,2019-09-06,676,0,676,54,730,730,0,0
33659,2019-09-06,1194,0,1194,86,1280,1280,0,0
33660,2019-09-06,232,0,232,18,250,250,0,0
33661,2019-09-06,1575,0,1575,125,1700,1700,0,0
33662,2019-09-06,1203,0,1203,87,1290,1290,0,0
33663,2019-09-06,880,0,880,70,950,950,0,0
33664,2019-09-06,491,0,491,39,530,530,0,0
33665,2019-09-06,769,0,769,61,830,830,0,0
33666,2019-09-06,121,0,121,9,130,130,0,0
33667,2019-09-06,778,0,778,62,840,840,0,0
33668,2019-09-06,362,0,362,28,390,390,0,0
33669,2019-09-06,1575,0,1575,125,1700,1700,0,0
33670,2019-09-06,1408,0,1408,112,1520,1520,0,0
33671,2019-09-06,1575,0,1575,125,1700,0,1700,0
33672,2019-09-06,1408,0,1408,112,1520,1520,0,0
33673,2019-09-06,806,0,806,64,870,870,0,0
33674,2019-09-06,538,0,538,42,580,580,0,0
33675,2019-09-06,788,0,788,62,850,850,0,0
33676,2019-09-06,788,0,788,62,850,850,0,0
33677,2019-09-06,288,0,288,22,310,310,0,0
33678,2019-09-06,112,0,112,8,120,120,0,0
33679,2019-09-06,2167,0,2167,173,2340,2340,0,0
33680,2019-09-06,1306,0,1306,104,1410,1410,0,0
33681,2019-09-06,3149,0,3149,251,3400,3400,0,0
33682,2019-09-07,417,0,417,33,450,450,0,0
33683,2019-09-07,2186,0,2186,174,2360,2360,0,0
33684,2019-09-07,1084,0,1084,86,1170,1170,0,0
33685,2019-09-07,760,0,760,60,820,820,0,0
33686,2019-09-07,1075,0,1075,85,1160,1160,0,0
33687,2019-09-07,491,0,491,39,530,530,0,0
33688,2019-09-07,1556,0,1556,124,1680,1680,0,0
33689,2019-09-07,482,0,482,38,520,520,0,0
33690,2019-09-07,463,0,463,37,500,500,0,0
33691,2019-09-07,1815,0,1815,145,1960,1960,0,0
33692,2019-09-07,6667,0,6667,533,7200,7200,0,0
33693,2019-09-07,1917,0,1917,153,2070,2070,0,0
33694,2019-09-07,417,0,417,33,450,450,0,0
33695,2019-09-07,417,0,417,33,450,450,0,0
33696,2019-09-07,667,0,667,53,720,720,0,0
33697,2019-09-07,380,0,380,30,410,410,0,0
33698,2019-09-07,788,0,788,62,850,850,0,0
33699,2019-09-07,991,0,991,79,1070,1070,0,0
33700,2019-09-07,491,0,491,39,530,530,0,0
33701,2019-09-07,788,0,788,62,850,850,0,0
33702,2019-09-07,602,0,602,48,650,0,0,650
33703,2019-09-07,1815,0,1815,145,1960,1960,0,0
33704,2019-09-07,788,0,788,62,850,850,0,0
33705,2019-09-07,278,0,278,22,300,300,0,0
33706,2019-09-07,2269,0,2269,181,2450,2450,0,0
33707,2019-09-07,1436,0,1436,114,1550,1550,0,0
33708,2019-09-07,1575,0,1575,125,1700,1700,0,0
33709,2019-09-07,1462,0,1462,108,1570,1570,0,0
33710,2019-09-07,612,0,612,48,660,660,0,0
33711,2019-09-07,630,0,630,50,680,680,0,0
33712,2019-09-07,408,0,408,32,440,440,0,0
33713,2019-09-07,342,0,342,18,360,360,0,0
33714,2019-09-07,278,0,278,22,300,300,0,0
33715,2019-09-07,482,0,482,38,520,520,0,0
33716,2019-09-07,583,0,583,37,620,620,0,0
33717,2019-09-07,482,0,482,38,520,520,0,0
33718,2019-09-07,547,0,547,43,590,590,0,0
33719,2019-09-07,519,0,519,41,560,560,0,0
33720,2019-09-07,519,0,519,41,560,0,560,0
33721,2019-09-07,278,0,278,22,300,300,0,0
33722,2019-09-07,667,0,667,53,720,720,0,0
33723,2019-09-07,271,-29,242,19,261,261,0,0
33724,2019-09-07,2288,0,2288,182,2470,2470,0,0
33725,2019-09-07,2744,-294,2450,196,2646,0,2646,0
33726,2019-09-07,1517,0,1517,103,1620,0,1620,0
33727,2019-09-07,2389,0,2389,191,2580,2580,0,0
33728,2019-09-07,583,0,583,37,620,620,0,0
33729,2019-09-07,794,-85,709,56,765,765,0,0
33730,2019-09-07,908,0,908,72,980,980,0,0
33731,2019-09-07,1815,0,1815,145,1960,1960,0,0
33732,2019-09-07,315,0,315,25,340,340,0,0
33733,2019-09-07,1830,-196,1634,130,1764,1764,0,0
33734,2019-09-07,760,0,760,60,820,820,0,0
33735,2019-09-07,676,0,676,54,730,730,0,0
33736,2019-09-07,1815,0,1815,145,1960,1960,0,0
33737,2019-09-07,630,0,630,50,680,680,0,0
33738,2019-09-07,2036,0,2036,154,2190,2190,0,0
33739,2019-09-07,1463,0,1463,117,1580,1580,0,0
33740,2019-09-07,825,0,825,65,890,890,0,0
33741,2019-09-07,102,0,102,8,110,110,0,0
33742,2019-09-07,788,0,788,62,850,850,0,0
33743,2019-09-07,704,0,704,56,760,760,0,0
33744,2019-09-07,510,0,510,40,550,550,0,0
33745,2019-09-07,-1815,0,-1815,-145,-1960,-1960,0,0
33746,2019-09-07,1815,0,1815,145,1960,1960,0,0
33747,2019-09-07,843,0,843,67,910,910,0,0
33748,2019-09-07,399,0,399,31,430,430,0,0
33749,2019-09-07,3630,0,3630,290,3920,3920,0,0
33750,2019-09-07,501,0,501,39,540,540,0,0
33751,2019-09-07,963,0,963,68,1031,1031,0,0
33752,2019-09-07,399,0,399,31,430,430,0,0
33753,2019-09-07,1815,0,1815,145,1960,1960,0,0
33754,2019-09-07,806,0,806,64,870,870,0,0
33755,2019-09-07,1815,0,1815,145,1960,1960,0,0
33756,2019-09-07,917,0,917,73,990,990,0,0
33757,2019-09-07,556,0,556,44,600,600,0,0
33758,2019-09-07,1102,0,1102,88,1190,1190,0,0
33759,2019-09-07,1815,0,1815,145,1960,1960,0,0
33760,2019-09-07,778,0,778,62,840,840,0,0
33761,2019-09-07,908,0,908,72,980,980,0,0
33762,2019-09-07,280,-30,250,20,270,0,270,0
33763,2019-09-07,519,0,519,41,560,0,560,0
33764,2019-09-07,1923,-206,1717,137,1854,1854,0,0
33765,2019-09-07,1769,0,1769,141,1910,1910,0,0
33766,2019-09-07,788,0,788,62,850,850,0,0
33767,2019-09-07,463,0,463,37,500,500,0,0
33768,2019-09-07,815,0,815,65,880,880,0,0
33769,2019-09-07,1306,0,1306,104,1410,1410,0,0
33770,2019-09-07,1112,0,1112,88,1200,1200,0,0
33771,2019-09-07,334,0,334,26,360,360,0,0
33772,2019-09-07,991,0,991,79,1070,1070,0,0
33773,2019-09-07,621,0,621,49,670,670,0,0
33774,2019-09-07,139,0,139,11,150,150,0,0
33775,2019-09-07,204,0,204,16,220,220,0,0
33776,2019-09-07,306,0,306,24,330,330,0,0
33777,2019-09-07,760,0,760,60,820,820,0,0
33778,2019-09-07,389,0,389,31,420,420,0,0
33779,2019-09-07,1639,0,1639,131,1770,1770,0,0
33780,2019-09-07,649,0,649,51,700,700,0,0
33781,2019-09-07,843,0,843,67,910,910,0,0
33782,2019-09-07,269,0,269,21,290,290,0,0
33783,2019-09-07,288,0,288,22,310,310,0,0
33784,2019-09-07,158,0,158,12,170,170,0,0
33785,2019-09-07,666,0,666,44,710,710,0,0
33786,2019-09-07,112,0,112,8,120,120,0,0
33787,2019-09-07,334,0,334,26,360,360,0,0
33788,2019-09-07,186,0,186,14,200,200,0,0
33789,2019-09-07,334,0,334,26,360,360,0,0
33790,2019-09-07,908,0,908,72,980,980,0,0
33791,2019-09-07,249,0,249,11,260,260,0,0
33792,2019-09-07,314,0,314,16,330,330,0,0
33793,2019-09-07,315,0,315,25,340,340,0,0
33794,2019-09-07,1815,0,1815,145,1960,1960,0,0
33795,2019-09-07,1269,0,1269,101,1370,1370,0,0
33796,2019-09-07,426,0,426,34,460,460,0,0
33797,2019-09-07,408,0,408,32,440,440,0,0
33798,2019-09-07,495,-53,442,35,477,477,0,0
33799,2019-09-07,352,0,352,28,380,380,0,0
33800,2019-09-07,473,0,473,37,510,510,0,0
33801,2019-09-07,417,0,417,33,450,450,0,0
33802,2019-09-07,1028,0,1028,82,1110,1110,0,0
33803,2019-09-07,121,0,121,9,130,130,0,0
33804,2019-09-07,2158,0,2158,172,2330,0,2330,0
33805,2019-09-07,278,0,278,22,300,300,0,0
33806,2019-09-07,426,0,426,34,460,460,0,0
33807,2019-09-07,463,0,463,37,500,500,0,0
33808,2019-09-07,788,0,788,62,850,850,0,0
33809,2019-09-07,1575,0,1575,125,1700,1700,0,0
33810,2019-09-07,417,0,417,33,450,450,0,0
33811,2019-09-07,788,0,788,62,850,850,0,0
33812,2019-09-07,519,0,519,41,560,560,0,0
33813,2019-09-07,1075,0,1075,85,1160,1160,0,0
33814,2019-09-07,593,0,593,47,640,0,0,640
33815,2019-09-07,805,0,805,55,860,0,860,0
33816,2019-09-07,695,0,695,55,750,750,0,0
33817,2019-09-07,852,0,852,68,920,920,0,0
33818,2019-09-07,1575,0,1575,125,1700,1700,0,0
33819,2019-09-07,1575,0,1575,125,1700,1700,0,0
33820,2019-09-07,2362,0,2362,188,2550,0,2550,0
33821,2019-09-07,491,0,491,39,530,530,0,0
33822,2019-09-07,973,0,973,77,1050,1050,0,0
33823,2019-09-07,788,0,788,62,850,850,0,0
33824,2019-09-07,788,0,788,62,850,850,0,0
33825,2019-09-07,788,0,788,62,850,850,0,0
33826,2019-09-07,788,0,788,62,850,850,0,0
33827,2019-09-07,-788,0,-788,-62,-850,-850,0,0
33828,2019-09-07,250,0,250,20,270,270,0,0
33829,2019-09-07,788,0,788,62,850,850,0,0
33830,2019-09-07,334,0,334,26,360,360,0,0
33831,2019-09-07,675,0,675,45,720,720,0,0
33832,2019-09-07,788,0,788,62,850,850,0,0
33833,2019-09-07,417,0,417,33,450,450,0,0
33834,2019-09-07,788,0,788,62,850,850,0,0
33835,2019-09-07,1575,0,1575,125,1700,1700,0,0
33836,2019-09-07,1575,0,1575,125,1700,1700,0,0
33837,2019-09-07,1575,0,1575,125,1700,1700,0,0
33838,2019-09-07,1575,0,1575,125,1700,1700,0,0
33839,2019-09-07,490,0,490,30,520,520,0,0
33840,2019-09-07,788,0,788,62,850,850,0,0
33841,2019-09-07,788,0,788,62,850,850,0,0
33842,2019-09-07,843,0,843,67,910,0,0,910
33843,2019-09-07,843,0,843,67,910,910,0,0
33844,2019-09-07,1575,0,1575,125,1700,1700,0,0
33845,2019-09-07,306,0,306,24,330,330,0,0
33846,2019-09-07,788,0,788,62,850,850,0,0
33847,2019-09-07,325,0,325,25,350,350,0,0
33848,2019-09-07,1065,0,1065,85,1150,1150,0,0
33849,2019-09-07,1065,0,1065,85,1150,1150,0,0
33850,2019-09-07,1176,0,1176,94,1270,1270,0,0
33851,2019-09-07,556,0,556,44,600,600,0,0
33852,2019-09-07,556,0,556,44,600,600,0,0
33853,2019-09-08,658,0,658,52,710,710,0,0
33854,2019-09-08,491,0,491,39,530,530,0,0
33855,2019-09-08,306,0,306,24,330,330,0,0
33856,2019-09-08,686,0,686,54,740,740,0,0
33857,2019-09-08,444,0,444,26,470,470,0,0
33858,2019-09-08,815,0,815,65,880,880,0,0
33859,2019-09-08,695,0,695,55,750,750,0,0
33860,2019-09-08,1352,0,1352,108,1460,1460,0,0
33861,2019-09-08,1399,0,1399,111,1510,1510,0,0
33862,2019-09-08,1056,0,1056,84,1140,1140,0,0
33863,2019-09-08,649,0,649,51,700,700,0,0
33864,2019-09-08,1010,0,1010,80,1090,0,1090,0
33865,2019-09-08,1519,0,1519,121,1640,1640,0,0
33866,2019-09-08,908,0,908,72,980,980,0,0
33867,2019-09-08,908,0,908,72,980,980,0,0
33868,2019-09-08,352,0,352,28,380,380,0,0
33869,2019-09-08,1463,0,1463,117,1580,1580,0,0
33870,2019-09-08,686,0,686,54,740,740,0,0
33871,2019-09-08,463,0,463,37,500,500,0,0
33872,2019-09-08,778,0,778,62,840,840,0,0
33873,2019-09-08,269,0,269,21,290,290,0,0
33874,2019-09-08,778,0,778,62,840,840,0,0
33875,2019-09-08,649,0,649,51,700,700,0,0
33876,2019-09-08,435,0,435,25,460,460,0,0
33877,2019-09-08,195,0,195,15,210,0,0,210
33878,2019-09-08,2723,0,2723,217,2940,2940,0,0
33879,2019-09-08,584,0,584,46,630,630,0,0
33880,2019-09-08,1815,0,1815,145,1960,0,1960,0
33881,2019-09-08,1223,0,1223,97,1320,1320,0,0
33882,2019-09-08,334,0,334,26,360,360,0,0
33883,2019-09-08,788,0,788,62,850,850,0,0
33884,2019-09-08,630,0,630,50,680,680,0,0
33885,2019-09-08,1001,0,1001,79,1080,1080,0,0
33886,2019-09-08,899,0,899,71,970,970,0,0
33887,2019-09-08,510,0,510,40,550,550,0,0
33888,2019-09-08,426,0,426,34,460,460,0,0
33889,2019-09-08,1231,0,1231,89,1320,1320,0,0
33890,2019-09-08,945,0,945,75,1020,1020,0,0
33891,2019-09-08,713,0,713,57,770,770,0,0
33892,2019-09-08,417,0,417,33,450,450,0,0
33893,2019-09-08,788,0,788,62,850,850,0,0
33894,2019-09-08,1621,0,1621,129,1750,1750,0,0
33895,2019-09-08,1482,0,1482,118,1600,1600,0,0
33896,2019-09-08,501,0,501,39,540,540,0,0
33897,2019-09-08,908,0,908,72,980,980,0,0
33898,2019-09-08,908,0,908,72,980,980,0,0
33899,2019-09-08,899,0,899,71,970,970,0,0
33900,2019-09-08,702,0,702,38,740,740,0,0
33901,2019-09-08,2267,-242,2025,153,2178,2178,0,0
33902,2019-09-08,3740,0,3740,290,4030,4030,0,0
33903,2019-09-08,278,0,278,22,300,300,0,0
33904,2019-09-08,806,0,806,64,870,870,0,0
33905,2019-09-08,732,0,732,58,790,790,0,0
33906,2019-09-08,362,0,362,28,390,0,0,390
33907,2019-09-08,1130,0,1130,90,1220,1220,0,0
33908,2019-09-08,1815,0,1815,145,1960,1960,0,0
33909,2019-09-08,269,0,269,21,290,290,0,0
33910,2019-09-08,288,0,288,22,310,310,0,0
33911,2019-09-08,575,0,575,45,620,620,0,0
33912,2019-09-08,852,0,852,68,920,920,0,0
33913,2019-09-08,908,0,908,72,980,980,0,0
33914,2019-09-08,732,0,732,58,790,790,0,0
33915,2019-09-08,639,0,639,51,690,690,0,0
33916,2019-09-08,260,0,260,20,280,280,0,0
33917,2019-09-08,843,0,843,67,910,910,0,0
33918,2019-09-08,315,0,315,25,340,340,0,0
33919,2019-09-08,908,0,908,72,980,980,0,0
33920,2019-09-08,473,0,473,37,510,510,0,0
33921,2019-09-08,639,0,639,51,690,690,0,0
33922,2019-09-08,556,0,556,44,600,600,0,0
33923,2019-09-08,538,0,538,42,580,580,0,0
33924,2019-09-08,1047,0,1047,83,1130,1130,0,0
33925,2019-09-08,408,0,408,32,440,440,0,0
33926,2019-09-08,315,0,315,25,340,340,0,0
33927,2019-09-08,945,0,945,75,1020,1020,0,0
33928,2019-09-08,232,0,232,18,250,250,0,0
33929,2019-09-08,908,0,908,72,980,980,0,0
33930,2019-09-08,112,0,112,8,120,120,0,0
33931,2019-09-08,325,0,325,25,350,350,0,0
33932,2019-09-08,232,0,232,18,250,250,0,0
33933,2019-09-08,167,0,167,13,180,180,0,0
33934,2019-09-08,463,0,463,37,500,500,0,0
33935,2019-09-08,389,0,389,31,420,0,420,0
33936,2019-09-08,306,0,306,24,330,330,0,0
33937,2019-09-08,3223,0,3223,257,3480,3480,0,0
33938,2019-09-08,1186,0,1186,94,1280,1280,0,0
33939,2019-09-08,806,0,806,64,870,870,0,0
33940,2019-09-08,2630,0,2630,210,2840,2840,0,0
33941,2019-09-08,769,0,769,61,830,830,0,0
33942,2019-09-08,806,0,806,64,870,870,0,0
33943,2019-09-08,1575,0,1575,125,1700,1700,0,0
33944,2019-09-08,982,0,982,78,1060,1060,0,0
33945,2019-09-08,2362,0,2362,188,2550,2550,0,0
33946,2019-09-08,1575,0,1575,125,1700,1700,0,0
33947,2019-09-08,2362,0,2362,188,2550,2550,0,0
33948,2019-09-08,788,0,788,62,850,850,0,0
33949,2019-09-08,167,0,167,13,180,180,0,0
33950,2019-09-08,260,0,260,20,280,280,0,0
33951,2019-09-08,713,0,713,57,770,770,0,0
33952,2019-09-08,797,0,797,63,860,860,0,0
33953,2019-09-08,556,0,556,44,600,600,0,0
33954,2019-09-08,262,-28,234,18,252,252,0,0
33955,2019-09-08,5422,0,5422,433,5855,5855,0,0
33956,2019-09-08,343,0,343,27,370,370,0,0
33957,2019-09-08,565,0,565,45,610,610,0,0
33958,2019-09-08,547,0,547,43,590,590,0,0
33959,2019-09-08,871,0,871,69,940,940,0,0
33960,2019-09-08,167,0,167,13,180,180,0,0
33961,2019-09-08,769,0,769,61,830,830,0,0
33962,2019-09-08,519,0,519,41,560,560,0,0
33963,2019-09-08,667,0,667,53,720,720,0,0
33964,2019-09-08,232,0,232,18,250,250,0,0
33965,2019-09-08,612,0,612,48,660,660,0,0
33966,2019-09-08,954,0,954,76,1030,1030,0,0
33967,2019-09-08,334,0,334,26,360,360,0,0
33968,2019-09-09,880,0,880,70,950,950,0,0
33969,2019-09-09,612,0,612,48,660,660,0,0
33970,2019-09-09,612,0,612,48,660,660,0,0
33971,2019-09-09,510,0,510,40,550,550,0,0
33972,2019-09-09,547,0,547,43,590,590,0,0
33973,2019-09-09,1815,0,1815,145,1960,1960,0,0
33974,2019-09-09,723,0,723,57,780,780,0,0
33975,2019-09-09,1343,0,1343,107,1450,1450,0,0
33976,2019-09-09,639,0,639,51,690,690,0,0
33977,2019-09-09,1073,0,1073,77,1150,1150,0,0
33978,2019-09-09,639,0,639,51,690,690,0,0
33979,2019-09-09,806,0,806,64,870,870,0,0
33980,2019-09-09,880,0,880,70,950,950,0,0
33981,2019-09-09,612,0,612,48,660,660,0,0
33982,2019-09-09,621,0,621,49,670,670,0,0
33983,2019-09-09,1082,-230,852,68,920,920,0,0
33984,2019-09-09,656,-138,518,34,552,552,0,0
33985,2019-09-09,1019,0,1019,81,1100,1100,0,0
33986,2019-09-09,1112,0,1112,88,1200,1200,0,0
33987,2019-09-09,741,0,741,59,800,800,0,0
33988,2019-09-09,362,0,362,28,390,390,0,0
33989,2019-09-09,528,0,528,42,570,570,0,0
33990,2019-09-09,481,0,481,29,510,510,0,0
33991,2019-09-09,908,0,908,72,980,980,0,0
33992,2019-09-09,362,0,362,28,390,390,0,0
33993,2019-09-09,908,0,908,72,980,980,0,0
33994,2019-09-09,269,0,269,21,290,290,0,0
33995,2019-09-09,575,0,575,45,620,620,0,0
33996,2019-09-09,538,0,538,42,580,580,0,0
33997,2019-09-09,463,0,463,37,500,500,0,0
33998,2019-09-09,602,0,602,48,650,650,0,0
33999,2019-09-09,908,0,908,72,980,980,0,0
34000,2019-09-09,1815,0,1815,145,1960,1960,0,0
34001,2019-09-09,260,0,260,20,280,280,0,0
34002,2019-09-09,1815,0,1815,145,1960,1960,0,0
34003,2019-09-09,445,0,445,35,480,480,0,0
34004,2019-09-09,1815,0,1815,145,1960,1960,0,0
34005,2019-09-09,1001,0,1001,79,1080,1080,0,0
34006,2019-09-09,936,0,936,74,1010,1010,0,0
34007,2019-09-09,908,0,908,72,980,980,0,0
34008,2019-09-09,1815,0,1815,145,1960,1960,0,0
34009,2019-09-09,417,0,417,33,450,450,0,0
34010,2019-09-09,1621,0,1621,129,1750,1750,0,0
34011,2019-09-09,908,0,908,72,980,980,0,0
34012,2019-09-09,426,0,426,34,460,460,0,0
34013,2019-09-09,991,0,991,79,1070,1070,0,0
34014,2019-09-09,306,0,306,24,330,0,0,330
34015,2019-09-09,2723,0,2723,217,2940,2940,0,0
34016,2019-09-09,1815,0,1815,145,1960,1960,0,0
34017,2019-09-09,1815,0,1815,145,1960,1960,0,0
34018,2019-09-09,1083,0,1083,77,1160,1160,0,0
34019,2019-09-09,806,0,806,64,870,870,0,0
34020,2019-09-09,250,0,250,20,270,270,0,0
34021,2019-09-09,399,0,399,31,430,430,0,0
34022,2019-09-09,389,0,389,31,420,420,0,0
34023,2019-09-09,556,0,556,44,600,600,0,0
34024,2019-09-09,791,-168,623,49,672,672,0,0
34025,2019-09-09,491,0,491,39,530,530,0,0
34026,2019-09-09,158,0,158,12,170,170,0,0
34027,2019-09-09,232,0,232,18,250,250,0,0
34028,2019-09-09,584,0,584,46,630,630,0,0
34029,2019-09-09,269,0,269,21,290,290,0,0
34030,2019-09-09,332,0,332,8,340,340,0,0
34031,2019-09-09,843,0,843,67,910,910,0,0
34032,2019-09-09,1093,0,1093,87,1180,1180,0,0
34033,2019-09-09,565,0,565,45,610,610,0,0
34034,2019-09-09,695,0,695,55,750,750,0,0
34035,2019-09-09,315,0,315,25,340,340,0,0
34036,2019-09-09,1204,0,1204,96,1300,0,1300,0
34037,2019-09-09,371,0,371,29,400,400,0,0
34038,2019-09-09,463,0,463,37,500,500,0,0
34039,2019-09-09,797,0,797,63,860,860,0,0
34040,2019-09-09,232,0,232,18,250,250,0,0
34041,2019-09-09,1407,0,1407,103,1510,1510,0,0
34042,2019-09-09,825,0,825,65,890,890,0,0
34043,2019-09-09,1167,0,1167,93,1260,0,1260,0
34044,2019-09-09,899,0,899,71,970,970,0,0
34045,2019-09-09,877,0,877,43,920,920,0,0
34046,2019-09-09,1297,0,1297,103,1400,1400,0,0
34047,2019-09-09,917,0,917,73,990,990,0,0
34048,2019-09-09,408,0,408,32,440,440,0,0
34049,2019-09-09,797,0,797,63,860,860,0,0
34050,2019-09-09,575,0,575,45,620,620,0,0
34051,2019-09-09,741,0,741,59,800,800,0,0
34052,2019-09-09,204,0,204,16,220,220,0,0
34053,2019-09-09,350,-37,313,25,338,338,0,0
34054,2019-09-09,1575,0,1575,125,1700,1700,0,0
34055,2019-09-09,232,0,232,18,250,250,0,0
34056,2019-09-09,575,0,575,45,620,620,0,0
34057,2019-09-09,861,0,861,59,920,920,0,0
34058,2019-09-09,473,0,473,37,510,510,0,0
34059,2019-09-09,510,0,510,40,550,550,0,0
34060,2019-09-09,788,0,788,62,850,850,0,0
34061,2019-09-09,788,0,788,62,850,850,0,0
34062,2019-09-09,788,0,788,62,850,850,0,0
34063,2019-09-09,334,0,334,26,360,360,0,0
34064,2019-09-09,871,0,871,69,940,0,940,0
34065,2019-09-09,760,0,760,60,820,820,0,0
34066,2019-09-09,788,0,788,62,850,850,0,0
34067,2019-09-09,1149,0,1149,91,1240,1240,0,0
34068,2019-09-09,788,0,788,62,850,850,0,0
34069,2019-09-09,593,0,593,47,640,640,0,0
34070,2019-09-09,547,0,547,43,590,590,0,0
34071,2019-09-09,852,0,852,68,920,920,0,0
34072,2019-09-09,1204,0,1204,96,1300,1300,0,0
34073,2019-09-09,1575,0,1575,125,1700,1700,0,0
34074,2019-09-09,1612,0,1612,128,1740,1740,0,0
34075,2019-09-09,1038,0,1038,82,1120,1120,0,0
34076,2019-09-09,686,0,686,54,740,740,0,0
34077,2019-09-09,149,0,149,11,160,160,0,0
34078,2019-09-10,676,0,676,54,730,730,0,0
34079,2019-09-10,334,0,334,26,360,0,0,360
34080,2019-09-10,769,0,769,61,830,830,0,0
34081,2019-09-10,547,0,547,43,590,590,0,0
34082,2019-09-10,482,0,482,38,520,520,0,0
34083,2019-09-10,-186,0,-186,-23,-209,-209,0,0
34084,2019-09-10,93,0,93,16,109,109,0,0
34085,2019-09-10,93,0,93,9,102,102,0,0
34086,2019-09-10,186,0,186,14,200,200,0,0
34087,2019-09-10,186,0,186,16,202,202,0,0
34088,2019-09-10,-93,0,-93,-16,-109,-109,0,0
34089,2019-09-10,426,0,426,34,460,460,0,0
34090,2019-09-10,186,0,186,23,209,209,0,0
34091,2019-09-10,1130,0,1130,90,1220,1220,0,0
34092,2019-09-10,352,0,352,28,380,380,0,0
34093,2019-09-10,2315,0,2315,185,2500,2500,0,0
34094,2019-09-10,1097,0,1097,43,1140,1140,0,0
34095,2019-09-10,1880,0,1880,150,2030,2030,0,0
34096,2019-09-10,760,0,760,60,820,820,0,0
34097,2019-09-10,513,0,513,32,545,545,0,0
34098,2019-09-10,425,-45,380,30,410,410,0,0
34099,2019-09-10,704,0,704,56,760,760,0,0
34100,2019-09-10,204,0,204,16,220,220,0,0
34101,2019-09-10,584,0,584,46,630,630,0,0
34102,2019-09-10,1139,0,1139,91,1230,1230,0,0
34103,2019-09-10,1075,0,1075,85,1160,1160,0,0
34104,2019-09-10,399,0,399,31,430,430,0,0
34105,2019-09-10,584,0,584,46,630,630,0,0
34106,2019-09-10,917,0,917,73,990,990,0,0
34107,2019-09-10,510,0,510,40,550,550,0,0
34108,2019-09-11,871,0,871,69,940,940,0,0
34109,2019-09-11,908,0,908,72,980,980,0,0
34110,2019-09-11,269,0,269,21,290,290,0,0
34111,2019-09-11,658,0,658,52,710,710,0,0
34112,2019-09-11,416,0,416,24,440,440,0,0
34113,2019-09-11,362,0,362,28,390,390,0,0
34114,2019-09-11,426,0,426,34,460,460,0,0
34115,2019-09-11,1426,0,1426,114,1540,0,1540,0
34116,2019-09-11,547,0,547,43,590,590,0,0
34117,2019-09-11,2723,0,2723,217,2940,2940,0,0
34118,2019-09-11,778,0,778,62,840,840,0,0
34119,2019-09-11,195,0,195,15,210,210,0,0
34120,2019-09-11,232,0,232,18,250,250,0,0
34121,2019-09-11,1075,0,1075,85,1160,1160,0,0
34122,2019-09-11,1501,0,1501,119,1620,1620,0,0
34123,2019-09-11,704,0,704,56,760,760,0,0
34124,2019-09-11,491,0,491,39,530,530,0,0
34125,2019-09-11,963,0,963,77,1040,1040,0,0
34126,2019-09-11,371,0,371,29,400,400,0,0
34127,2019-09-11,1213,0,1213,97,1310,1310,0,0
34128,2019-09-11,704,0,704,56,760,760,0,0
34129,2019-09-11,176,0,176,14,190,190,0,0
34130,2019-09-11,1370,0,1370,100,1470,1470,0,0
34131,2019-09-11,713,0,713,57,770,770,0,0
34132,2019-09-11,973,0,973,77,1050,1050,0,0
34133,2019-09-11,769,0,769,61,830,830,0,0
34134,2019-09-11,260,0,260,20,280,280,0,0
34135,2019-09-11,389,0,389,31,420,420,0,0
34136,2019-09-11,399,0,399,31,430,430,0,0
34137,2019-09-11,2889,0,2889,231,3120,3120,0,0
34138,2019-09-11,334,0,334,26,360,360,0,0
34139,2019-09-11,1815,0,1815,145,1960,1960,0,0
34140,2019-09-11,954,0,954,76,1030,1030,0,0
34141,2019-09-11,278,0,278,22,300,300,0,0
34142,2019-09-11,426,0,426,34,460,460,0,0
34143,2019-09-11,723,0,723,57,780,780,0,0
34144,2019-09-11,176,0,176,14,190,190,0,0
34145,2019-09-11,343,0,343,27,370,370,0,0
34146,2019-09-11,686,0,686,54,740,740,0,0
34147,2019-09-11,815,0,815,65,880,880,0,0
34148,2019-09-11,954,0,954,76,1030,1030,0,0
34149,2019-09-11,791,-168,623,49,672,672,0,0
34150,2019-09-11,297,0,297,23,320,320,0,0
34151,2019-09-11,575,0,575,45,620,620,0,0
34152,2019-09-11,1260,0,1260,100,1360,1360,0,0
34153,2019-09-11,1204,0,1204,96,1300,1300,0,0
34154,2019-09-11,908,0,908,72,980,980,0,0
34155,2019-09-11,1001,0,1001,79,1080,1080,0,0
34156,2019-09-11,1815,0,1815,145,1960,0,1960,0
34157,2019-09-11,482,0,482,38,520,520,0,0
34158,2019-09-11,695,0,695,55,750,750,0,0
34159,2019-09-11,778,0,778,62,840,840,0,0
34160,2019-09-11,676,0,676,54,730,730,0,0
34161,2019-09-11,658,0,658,52,710,710,0,0
34162,2019-09-11,528,0,528,42,570,570,0,0
34163,2019-09-11,168,-18,150,12,162,162,0,0
34164,2019-09-11,325,0,325,25,350,0,350,0
34165,2019-09-11,889,0,889,71,960,960,0,0
34166,2019-09-11,1575,0,1575,125,1700,1700,0,0
34167,2019-09-11,408,0,408,32,440,440,0,0
34168,2019-09-11,528,0,528,42,570,570,0,0
34169,2019-09-11,686,0,686,54,740,740,0,0
34170,2019-09-11,973,0,973,77,1050,1050,0,0
34171,2019-09-11,852,0,852,68,920,920,0,0
34172,2019-09-11,777,0,777,53,830,830,0,0
34173,2019-09-11,916,0,916,64,980,980,0,0
34174,2019-09-11,334,0,334,26,360,360,0,0
34175,2019-09-11,1158,0,1158,92,1250,0,1250,0
34176,2019-09-11,741,0,741,59,800,800,0,0
34177,2019-09-11,676,0,676,54,730,730,0,0
34178,2019-09-11,815,0,815,65,880,880,0,0
34179,2019-09-11,788,0,788,62,850,850,0,0
34180,2019-09-11,315,0,315,25,340,340,0,0
34181,2019-09-11,-186,0,-186,-16,-202,-202,0,0
34182,2019-09-11,-186,0,-186,-14,-200,-200,0,0
34183,2019-09-11,-93,0,-93,-9,-102,-102,0,0
34184,2019-09-11,-186,0,-186,-16,-202,-202,0,0
34185,2019-09-11,186,0,186,16,202,202,0,0
34186,2019-09-11,453,0,453,27,480,480,0,0
34187,2019-09-11,713,0,713,57,770,770,0,0
34188,2019-09-11,704,0,704,56,760,760,0,0
34189,2019-09-11,788,0,788,62,850,850,0,0
34190,2019-09-11,420,-45,375,30,405,405,0,0
34191,2019-09-11,889,0,889,71,960,0,0,960
34192,2019-09-11,1575,0,1575,125,1700,1700,0,0
34193,2019-09-11,908,0,908,72,980,980,0,0
34194,2019-09-11,908,0,908,72,980,980,0,0
34195,2019-09-11,908,0,908,72,980,980,0,0
34196,2019-09-11,551,0,551,44,595,595,0,0
34197,2019-09-11,167,0,167,13,180,180,0,0
34198,2019-09-11,575,0,575,45,620,620,0,0
34199,2019-09-11,1028,0,1028,82,1110,1110,0,0
34200,2019-09-11,288,0,288,22,310,310,0,0
34201,2019-09-11,380,0,380,30,410,0,410,0
34202,2019-09-11,575,0,575,45,620,620,0,0
34203,2019-09-11,843,0,843,67,910,910,0,0
34204,2019-09-11,676,0,676,54,730,730,0,0
34205,2019-09-11,203,0,203,7,210,210,0,0
34206,2019-09-11,296,0,296,14,310,0,310,0
34207,2019-09-11,1093,0,1093,87,1180,1180,0,0
34208,2019-09-11,945,0,945,75,1020,0,0,1020
34209,2019-09-11,639,0,639,51,690,690,0,0
34210,2019-09-11,1575,0,1575,125,1700,1700,0,0
34211,2019-09-11,760,0,760,60,820,0,820,0
34212,2019-09-11,751,0,751,59,810,810,0,0
34213,2019-09-11,306,0,306,24,330,0,330,0
34214,2019-09-11,1575,0,1575,125,1700,1700,0,0
34215,2019-09-11,1056,0,1056,84,1140,1140,0,0
34216,2019-09-11,788,0,788,62,850,850,0,0
34217,2019-09-12,695,0,695,55,750,750,0,0
34218,2019-09-12,1065,0,1065,85,1150,1150,0,0
34219,2019-09-12,510,0,510,40,550,550,0,0
34220,2019-09-12,630,0,630,50,680,680,0,0
34221,2019-09-12,686,0,686,54,740,740,0,0
34222,2019-09-12,325,0,325,25,350,350,0,0
34223,2019-09-12,1065,0,1065,85,1150,0,1150,0
34224,2019-09-12,232,0,232,18,250,250,0,0
34225,2019-09-12,1815,0,1815,145,1960,1960,0,0
34226,2019-09-12,251,0,251,19,270,270,0,0
34227,2019-09-12,1643,-176,1467,117,1584,1584,0,0
34228,2019-09-12,704,0,704,56,760,760,0,0
34229,2019-09-12,1538,0,1538,122,1660,0,1660,0
34230,2019-09-12,1176,0,1176,94,1270,1270,0,0
34231,2019-09-12,778,0,778,62,840,840,0,0
34232,2019-09-12,630,0,630,50,680,680,0,0
34233,2019-09-12,639,0,639,51,690,690,0,0
34234,2019-09-12,1269,0,1269,101,1370,1370,0,0
34235,2019-09-12,1815,0,1815,145,1960,1960,0,0
34236,2019-09-12,815,0,815,65,880,880,0,0
34237,2019-09-12,769,0,769,61,830,830,0,0
34238,2019-09-12,908,0,908,72,980,980,0,0
34239,2019-09-12,436,0,436,34,470,0,470,0
34240,2019-09-12,278,0,278,22,300,300,0,0
34241,2019-09-12,352,0,352,28,380,380,0,0
34242,2019-09-12,667,0,667,53,720,720,0,0
34243,2019-09-12,815,0,815,65,880,880,0,0
34244,2019-09-12,880,0,880,70,950,950,0,0
34245,2019-09-12,297,0,297,23,320,320,0,0
34246,2019-09-12,389,0,389,31,420,420,0,0
34247,2019-09-12,1149,0,1149,91,1240,1240,0,0
34248,2019-09-12,788,0,788,62,850,850,0,0
34249,2019-09-12,2473,0,2473,197,2670,2670,0,0
34250,2019-09-12,672,0,672,53,725,725,0,0
34251,2019-09-12,204,0,204,16,220,220,0,0
34252,2019-09-12,325,0,325,25,350,350,0,0
34253,2019-09-12,556,0,556,44,600,0,600,0
34254,2019-09-12,203,0,203,16,219,219,0,0
34255,2019-09-12,330,0,330,0,330,330,0,0
34256,2019-09-12,528,0,528,42,570,570,0,0
34257,2019-09-12,334,0,334,26,360,360,0,0
34258,2019-09-12,695,0,695,55,750,750,0,0
34259,2019-09-12,1815,0,1815,145,1960,1960,0,0
34260,2019-09-12,1047,0,1047,83,1130,1130,0,0
34261,2019-09-12,445,0,445,35,480,480,0,0
34262,2019-09-12,638,0,638,42,680,680,0,0
34263,2019-09-12,436,0,436,34,470,470,0,0
34264,2019-09-12,843,0,843,67,910,0,910,0
34265,2019-09-12,908,0,908,72,980,980,0,0
34266,2019-09-12,1241,0,1241,99,1340,1340,0,0
34267,2019-09-12,751,0,751,59,810,810,0,0
34268,2019-09-12,463,0,463,37,500,500,0,0
34269,2019-09-12,538,0,538,42,580,580,0,0
34270,2019-09-12,547,0,547,43,590,590,0,0
34271,2019-09-12,3555,0,3555,275,3830,3830,0,0
34272,2019-09-12,1815,0,1815,145,1960,1960,0,0
34273,2019-09-12,741,0,741,59,800,800,0,0
34274,2019-09-12,315,0,315,25,340,340,0,0
34275,2019-09-12,908,0,908,72,980,980,0,0
34276,2019-09-12,908,0,908,72,980,980,0,0
34277,2019-09-12,908,0,908,72,980,980,0,0
34278,2019-09-12,167,0,167,13,180,180,0,0
34279,2019-09-12,371,0,371,29,400,400,0,0
34280,2019-09-12,2695,0,2695,215,2910,2910,0,0
34281,2019-09-12,1056,0,1056,84,1140,1140,0,0
34282,2019-09-12,630,0,630,50,680,680,0,0
34283,2019-09-12,723,0,723,57,780,780,0,0
34284,2019-09-12,676,0,676,54,730,730,0,0
34285,2019-09-12,685,0,685,45,730,730,0,0
34286,2019-09-12,405,-86,319,25,344,344,0,0
34287,2019-09-12,405,-86,319,25,344,344,0,0
34288,2019-09-12,167,0,167,13,180,180,0,0
34289,2019-09-12,445,0,445,35,480,480,0,0
34290,2019-09-12,575,0,575,45,620,620,0,0
34291,2019-09-12,843,0,843,67,910,910,0,0
34292,2019-09-12,499,-106,393,31,424,424,0,0
34293,2019-09-12,499,-106,393,31,424,424,0,0
34294,2019-09-12,732,0,732,58,790,790,0,0
34295,2019-09-12,732,0,732,58,790,790,0,0
34296,2019-09-12,1343,0,1343,107,1450,1450,0,0
34297,2019-09-12,778,0,778,62,840,840,0,0
34298,2019-09-12,1408,0,1408,112,1520,1520,0,0
34299,2019-09-12,519,0,519,41,560,0,560,0
34300,2019-09-12,278,0,278,22,300,300,0,0
34301,2019-09-12,510,0,510,40,550,550,0,0
34302,2019-09-12,491,0,491,39,530,530,0,0
34303,2019-09-12,422,0,422,33,455,455,0,0
34304,2019-09-12,519,0,519,41,560,560,0,0
34305,2019-09-12,362,0,362,28,390,390,0,0
34306,2019-09-12,889,0,889,71,960,960,0,0
34307,2019-09-12,667,0,667,53,720,720,0,0
34308,2019-09-12,352,0,352,28,380,380,0,0
34309,2019-09-12,908,0,908,72,980,980,0,0
34310,2019-09-12,648,0,648,42,690,690,0,0
34311,2019-09-12,945,0,945,75,1020,1020,0,0
34312,2019-09-12,880,0,880,70,950,950,0,0
34313,2019-09-12,269,0,269,21,290,290,0,0
34314,2019-09-12,158,0,158,12,170,170,0,0
34315,2019-09-12,917,0,917,73,990,990,0,0
34316,2019-09-12,149,0,149,11,160,160,0,0
34317,2019-09-12,269,0,269,21,290,290,0,0
34318,2019-09-12,417,0,417,33,450,450,0,0
34319,2019-09-12,1536,0,1536,114,1650,1650,0,0
34320,2019-09-12,399,0,399,31,430,430,0,0
34321,2019-09-12,806,0,806,64,870,870,0,0
34322,2019-09-12,269,0,269,21,290,290,0,0
34323,2019-09-12,602,0,602,48,650,650,0,0
34324,2019-09-12,528,0,528,42,570,570,0,0
34325,2019-09-12,777,0,777,53,830,830,0,0
34326,2019-09-12,862,0,862,68,930,930,0,0
34327,2019-09-12,389,0,389,31,420,420,0,0
34328,2019-09-12,269,0,269,21,290,290,0,0
34329,2019-09-12,1575,0,1575,125,1700,1700,0,0
34330,2019-09-12,593,0,593,47,640,640,0,0
34331,2019-09-12,491,0,491,39,530,530,0,0
34332,2019-09-12,473,0,473,37,510,510,0,0
34333,2019-09-12,556,0,556,44,600,600,0,0
34334,2019-09-12,602,0,602,48,650,650,0,0
34335,2019-09-12,426,0,426,34,460,460,0,0
34336,2019-09-12,788,0,788,62,850,850,0,0
34337,2019-09-12,788,0,788,62,850,850,0,0
34338,2019-09-12,788,0,788,62,850,850,0,0
34339,2019-09-12,630,0,630,50,680,680,0,0
34340,2019-09-12,797,0,797,63,860,860,0,0
34341,2019-09-12,-788,0,-788,-62,-850,-850,0,0
34342,2019-09-12,814,0,814,56,870,870,0,0
34343,2019-09-12,482,0,482,38,520,520,0,0
34344,2019-09-12,472,0,472,28,500,500,0,0
34345,2019-09-12,1036,-111,925,74,999,999,0,0
34346,2019-09-12,584,0,584,46,630,630,0,0
34347,2019-09-12,723,0,723,57,780,780,0,0
34348,2019-09-13,186,0,186,14,200,200,0,0
34349,2019-09-13,751,0,751,59,810,810,0,0
34350,2019-09-13,1112,0,1112,88,1200,1200,0,0
34351,2019-09-13,1251,0,1251,99,1350,1350,0,0
34352,2019-09-13,-639,0,-639,-51,-690,-690,0,0
34353,2019-09-13,621,0,621,49,670,670,0,0
34354,2019-09-13,306,0,306,24,330,330,0,0
34355,2019-09-13,482,0,482,38,520,520,0,0
34356,2019-09-13,1815,0,1815,145,1960,1960,0,0
34357,2019-09-13,639,0,639,51,690,690,0,0
34358,2019-09-13,639,0,639,51,690,690,0,0
34359,2019-09-13,621,0,621,49,670,670,0,0
34360,2019-09-13,454,0,454,36,490,490,0,0
34361,2019-09-13,399,0,399,31,430,430,0,0
34362,2019-09-13,215,-23,192,15,207,207,0,0
34363,2019-09-13,1768,0,1768,132,1900,1900,0,0
34364,2019-09-13,769,0,769,61,830,830,0,0
34365,2019-09-13,1815,0,1815,145,1960,1960,0,0
34366,2019-09-13,629,0,629,41,670,670,0,0
34367,2019-09-13,278,0,278,22,300,0,0,300
34368,2019-09-13,1723,0,1723,137,1860,1860,0,0
34369,2019-09-13,1056,0,1056,84,1140,1140,0,0
34370,2019-09-13,232,0,232,18,250,250,0,0
34371,2019-09-13,963,0,963,77,1040,1040,0,0
34372,2019-09-13,1112,0,1112,88,1200,1200,0,0
34373,2019-09-13,1130,0,1130,90,1220,1220,0,0
34374,2019-09-13,556,0,556,44,600,600,0,0
34375,2019-09-13,1047,0,1047,83,1130,1130,0,0
34376,2019-09-13,1047,0,1047,83,1130,1130,0,0
34377,2019-09-13,-1047,0,-1047,-83,-1130,-1130,0,0
34378,2019-09-13,630,0,630,50,680,680,0,0
34379,2019-09-13,348,0,348,27,375,0,375,0
34380,2019-09-13,630,0,630,50,680,680,0,0
34381,2019-09-13,713,0,713,57,770,770,0,0
34382,2019-09-13,1815,0,1815,145,1960,1960,0,0
34383,2019-09-13,936,0,936,74,1010,1010,0,0
34384,2019-09-13,1815,0,1815,145,1960,1960,0,0
34385,2019-09-13,399,0,399,31,430,430,0,0
34386,2019-09-13,889,0,889,71,960,960,0,0
34387,2019-09-13,1352,0,1352,108,1460,1460,0,0
34388,2019-09-13,4445,0,4445,355,4800,4800,0,0
34389,2019-09-13,1695,0,1695,135,1830,1830,0,0
34390,2019-09-13,926,0,926,74,1000,1000,0,0
34391,2019-09-13,232,0,232,18,250,250,0,0
34392,2019-09-13,815,0,815,65,880,880,0,0
34393,2019-09-13,852,0,852,68,920,920,0,0
34394,2019-09-13,723,0,723,57,780,780,0,0
34395,2019-09-13,1362,0,1362,108,1470,1470,0,0
34396,2019-09-13,1510,0,1510,120,1630,1630,0,0
34397,2019-09-13,436,0,436,34,470,470,0,0
34398,2019-09-13,463,0,463,37,500,500,0,0
34399,2019-09-13,995,0,995,70,1065,1065,0,0
34400,2019-09-13,297,0,297,23,320,320,0,0
34401,2019-09-13,1815,0,1815,145,1960,1960,0,0
34402,2019-09-13,380,0,380,30,410,410,0,0
34403,2019-09-13,982,0,982,78,1060,1060,0,0
34404,2019-09-13,712,0,712,48,760,760,0,0
34405,2019-09-13,1482,0,1482,118,1600,1600,0,0
34406,2019-09-13,852,0,852,68,920,920,0,0
34407,2019-09-13,834,0,834,66,900,900,0,0
34408,2019-09-13,250,0,250,20,270,270,0,0
34409,2019-09-13,297,0,297,23,320,320,0,0
34410,2019-09-13,1416,0,1416,104,1520,1520,0,0
34411,2019-09-13,908,0,908,72,980,980,0,0
34412,2019-09-13,1167,0,1167,93,1260,1260,0,0
34413,2019-09-13,519,0,519,41,560,560,0,0
34414,2019-09-13,269,0,269,21,290,290,0,0
34415,2019-09-13,769,0,769,61,830,0,0,830
34416,2019-09-13,518,0,518,32,550,550,0,0
34417,2019-09-13,769,0,769,61,830,830,0,0
34418,2019-09-13,1963,0,1963,157,2120,2120,0,0
34419,2019-09-13,389,0,389,31,420,420,0,0
34420,2019-09-13,278,0,278,22,300,300,0,0
34421,2019-09-13,973,0,973,77,1050,1050,0,0
34422,2019-09-13,908,0,908,72,980,980,0,0
34423,2019-09-13,426,0,426,34,460,460,0,0
34424,2019-09-13,917,0,917,73,990,990,0,0
34425,2019-09-13,260,0,260,20,280,280,0,0
34426,2019-09-13,232,0,232,18,250,250,0,0
34427,2019-09-13,343,0,343,27,370,370,0,0
34428,2019-09-13,473,0,473,37,510,510,0,0
34429,2019-09-13,130,0,130,10,140,140,0,0
34430,2019-09-13,806,0,806,64,870,0,0,870
34431,2019-09-13,547,0,547,43,590,0,590,0
34432,2019-09-13,288,0,288,22,310,310,0,0
34433,2019-09-13,519,0,519,41,560,560,0,0
34434,2019-09-13,334,0,334,26,360,360,0,0
34435,2019-09-13,195,0,195,15,210,210,0,0
34436,2019-09-13,334,0,334,26,360,360,0,0
34437,2019-09-13,584,0,584,46,630,630,0,0
34438,2019-09-13,473,0,473,37,510,510,0,0
34439,2019-09-13,223,0,223,17,240,240,0,0
34440,2019-09-13,260,0,260,20,280,280,0,0
34441,2019-09-13,542,-58,484,38,522,522,0,0
34442,2019-09-13,675,0,675,45,720,720,0,0
34443,2019-09-13,945,0,945,75,1020,1020,0,0
34444,2019-09-13,380,0,380,30,410,0,410,0
34445,2019-09-13,306,0,306,24,330,330,0,0
34446,2019-09-13,306,0,306,24,330,330,0,0
34447,2019-09-13,667,0,667,53,720,720,0,0
34448,2019-09-13,973,0,973,77,1050,1050,0,0
34449,2019-09-13,278,0,278,22,300,300,0,0
34450,2019-09-13,-306,0,-306,-24,-330,-330,0,0
34451,2019-09-13,176,0,176,14,190,190,0,0
34452,2019-09-13,1454,0,1454,116,1570,1570,0,0
34453,2019-09-13,880,0,880,70,950,950,0,0
34454,2019-09-13,380,0,380,30,410,410,0,0
34455,2019-09-13,436,0,436,34,470,470,0,0
34456,2019-09-13,741,0,741,59,800,800,0,0
34457,2019-09-13,593,0,593,47,640,640,0,0
34458,2019-09-13,3056,0,3056,244,3300,0,3300,0
34459,2019-09-13,379,0,379,21,400,400,0,0
34460,2019-09-13,1575,0,1575,125,1700,0,1700,0
34461,2019-09-13,788,0,788,62,850,850,0,0
34462,2019-09-13,788,0,788,62,850,850,0,0
34463,2019-09-13,1491,0,1491,119,1610,1610,0,0
34464,2019-09-13,1028,0,1028,82,1110,1110,0,0
34465,2019-09-13,1176,0,1176,94,1270,1270,0,0
34466,2019-09-13,602,0,602,48,650,650,0,0
34467,2019-09-13,1713,0,1713,137,1850,1850,0,0
34468,2019-09-13,788,0,788,62,850,850,0,0
34469,2019-09-13,788,0,788,62,850,850,0,0
34470,2019-09-13,1158,0,1158,92,1250,1250,0,0
34471,2019-09-13,982,0,982,78,1060,1060,0,0
34472,2019-09-13,1093,0,1093,87,1180,1180,0,0
34473,2019-09-13,158,0,158,12,170,170,0,0
34474,2019-09-13,139,0,139,11,150,150,0,0
34475,2019-09-13,1251,0,1251,99,1350,0,0,1350
34476,2019-09-13,519,0,519,41,560,560,0,0
34477,2019-09-13,278,0,278,22,300,300,0,0
34478,2019-09-13,648,0,648,42,690,0,690,0
34479,2019-09-13,389,0,389,31,420,420,0,0
34480,2019-09-13,760,0,760,60,820,0,0,820
34481,2019-09-13,2362,0,2362,188,2550,2550,0,0
34482,2019-09-13,999,0,999,71,1070,1070,0,0
34483,2019-09-13,1288,0,1288,102,1390,1390,0,0
34484,2019-09-13,788,0,788,62,850,850,0,0
34485,2019-09-13,1575,0,1575,125,1700,1700,0,0
34486,2019-09-13,454,0,454,36,490,490,0,0
34487,2019-09-13,1760,0,1760,140,1900,0,1900,0
34488,2019-09-13,510,0,510,40,550,0,0,550
34489,2019-09-13,788,0,788,62,850,850,0,0
34490,2019-09-13,417,0,417,33,450,450,0,0
34491,2019-09-13,445,0,445,35,480,0,480,0
34492,2019-09-13,1019,0,1019,81,1100,1100,0,0
34493,2019-09-13,362,0,362,28,390,390,0,0
34494,2019-09-13,1575,0,1575,125,1700,1700,0,0
34495,2019-09-13,593,0,593,47,640,0,0,640
34496,2019-09-14,1815,0,1815,145,1960,0,1960,0
34497,2019-09-14,269,0,269,21,290,290,0,0
34498,2019-09-14,426,0,426,34,460,460,0,0
34499,2019-09-14,2899,0,2899,231,3130,3130,0,0
34500,2019-09-14,2334,0,2334,186,2520,2520,0,0
34501,2019-09-14,880,0,880,70,950,950,0,0
34502,2019-09-14,491,0,491,39,530,530,0,0
34503,2019-09-14,1510,0,1510,120,1630,1630,0,0
34504,2019-09-14,667,0,667,53,720,720,0,0
34505,2019-09-14,1241,0,1241,99,1340,1340,0,0
34506,2019-09-14,352,0,352,28,380,0,380,0
34507,2019-09-14,829,-88,741,51,792,792,0,0
34508,2019-09-14,649,0,649,51,700,700,0,0
34509,2019-09-14,1119,0,1119,71,1190,1190,0,0
34510,2019-09-14,2723,0,2723,217,2940,2940,0,0
34511,2019-09-14,112,0,112,8,120,120,0,0
34512,2019-09-14,167,0,167,13,180,180,0,0
34513,2019-09-14,3630,0,3630,290,3920,3920,0,0
34514,2019-09-14,565,0,565,45,610,610,0,0
34515,2019-09-14,713,0,713,57,770,770,0,0
34516,2019-09-14,491,0,491,39,530,530,0,0
34517,2019-09-14,528,0,528,42,570,0,570,0
34518,2019-09-14,1602,0,1602,128,1730,1730,0,0
34519,2019-09-14,1575,0,1575,125,1700,1700,0,0
34520,2019-09-14,3084,0,3084,246,3330,3330,0,0
34521,2019-09-14,1565,0,1565,125,1690,1690,0,0
34522,2019-09-14,528,0,528,42,570,570,0,0
34523,2019-09-14,1269,0,1269,101,1370,1370,0,0
34524,2019-09-14,204,0,204,16,220,220,0,0
34525,2019-09-14,695,0,695,55,750,750,0,0
34526,2019-09-14,260,0,260,20,280,280,0,0
34527,2019-09-14,760,0,760,60,820,820,0,0
34528,2019-09-14,510,0,510,40,550,550,0,0
34529,2019-09-14,778,0,778,62,840,840,0,0
34530,2019-09-14,417,0,417,33,450,450,0,0
34531,2019-09-14,1815,0,1815,145,1960,1960,0,0
34532,2019-09-14,1149,0,1149,91,1240,1240,0,0
34533,2019-09-14,1830,-196,1634,130,1764,1764,0,0
34534,2019-09-14,593,0,593,47,640,640,0,0
34535,2019-09-14,936,0,936,74,1010,1010,0,0
34536,2019-09-14,269,0,269,21,290,290,0,0
34537,2019-09-14,1621,0,1621,129,1750,1750,0,0
34538,2019-09-14,1186,0,1186,94,1280,1280,0,0
34539,2019-09-14,822,-88,734,58,792,792,0,0
34540,2019-09-14,1815,0,1815,145,1960,0,1960,0
34541,2019-09-14,1889,0,1889,151,2040,2040,0,0
34542,2019-09-14,204,0,204,16,220,220,0,0
34543,2019-09-14,250,0,250,20,270,0,0,270
34544,2019-09-14,575,0,575,45,620,620,0,0
34545,2019-09-14,667,0,667,53,720,720,0,0
34546,2019-09-14,334,0,334,26,360,360,0,0
34547,2019-09-14,149,0,149,11,160,0,0,160
34548,2019-09-14,1325,0,1325,105,1430,1430,0,0
34549,2019-09-14,1528,0,1528,122,1650,1650,0,0
34550,2019-09-14,167,0,167,13,180,180,0,0
34551,2019-09-14,1556,0,1556,124,1680,1680,0,0
34552,2019-09-14,862,0,862,68,930,930,0,0
34553,2019-09-14,538,0,538,42,580,0,0,580
34554,2019-09-14,445,0,445,35,480,480,0,0
34555,2019-09-14,926,0,926,74,1000,0,1000,0
34556,2019-09-14,945,0,945,75,1020,1020,0,0
34557,2019-09-14,676,0,676,54,730,730,0,0
34558,2019-09-14,232,0,232,18,250,250,0,0
34559,2019-09-14,1815,0,1815,145,1960,1960,0,0
34560,2019-09-14,223,0,223,17,240,240,0,0
34561,2019-09-14,1815,0,1815,145,1960,1960,0,0
34562,2019-09-14,575,0,575,45,620,620,0,0
34563,2019-09-14,315,0,315,25,340,340,0,0
34564,2019-09-14,380,0,380,30,410,410,0,0
34565,2019-09-14,2315,0,2315,185,2500,2500,0,0
34566,2019-09-14,389,0,389,31,420,420,0,0
34567,2019-09-14,167,0,167,13,180,180,0,0
34568,2019-09-14,1575,0,1575,125,1700,1700,0,0
34569,2019-09-14,454,0,454,36,490,490,0,0
34570,2019-09-14,278,0,278,22,300,300,0,0
34571,2019-09-14,1047,0,1047,83,1130,1130,0,0
34572,2019-09-14,482,0,482,38,520,520,0,0
34573,2019-09-14,389,0,389,31,420,420,0,0
34574,2019-09-14,1223,0,1223,97,1320,1320,0,0
34575,2019-09-14,2213,0,2213,177,2390,2390,0,0
34576,2019-09-14,607,-65,542,43,585,585,0,0
34577,2019-09-14,741,0,741,59,800,800,0,0
34578,2019-09-14,371,0,371,29,400,400,0,0
34579,2019-09-14,1815,0,1815,145,1960,1960,0,0
34580,2019-09-14,908,0,908,72,980,980,0,0
34581,2019-09-14,908,0,908,72,980,980,0,0
34582,2019-09-14,436,0,436,34,470,470,0,0
34583,2019-09-14,1681,-180,1501,119,1620,1620,0,0
34584,2019-09-14,815,0,815,65,880,880,0,0
34585,2019-09-14,1815,0,1815,145,1960,0,1960,0
34586,2019-09-14,3084,0,3084,246,3330,3330,0,0
34587,2019-09-14,297,0,297,23,320,320,0,0
34588,2019-09-14,501,0,501,39,540,540,0,0
34589,2019-09-14,1815,0,1815,145,1960,1960,0,0
34590,2019-09-14,1389,0,1389,111,1500,1500,0,0
34591,2019-09-14,426,0,426,34,460,460,0,0
34592,2019-09-14,1028,0,1028,82,1110,0,1110,0
34593,2019-09-14,420,-45,375,30,405,405,0,0
34594,2019-09-14,843,0,843,67,910,910,0,0
34595,2019-09-14,2528,0,2528,202,2730,2730,0,0
34596,2019-09-14,348,0,348,27,375,375,0,0
34597,2019-09-14,695,0,695,55,750,750,0,0
34598,2019-09-14,1620,0,1620,120,1740,1740,0,0
34599,2019-09-14,0,0,0,0,-30,-30,0,0
34600,2019-09-14,213,0,213,17,230,230,0,0
34601,2019-09-14,288,0,288,22,310,310,0,0
34602,2019-09-14,417,0,417,33,450,450,0,0
34603,2019-09-14,251,0,251,19,270,270,0,0
34604,2019-09-14,917,0,917,73,990,990,0,0
34605,2019-09-14,1001,0,1001,79,1080,1080,0,0
34606,2019-09-14,269,0,269,21,290,290,0,0
34607,2019-09-14,741,0,741,59,800,800,0,0
34608,2019-09-14,186,0,186,14,200,200,0,0
34609,2019-09-14,528,0,528,42,570,570,0,0
34610,2019-09-14,505,0,505,40,545,545,0,0
34611,2019-09-14,110,0,110,0,110,110,0,0
34612,2019-09-14,297,0,297,23,320,320,0,0
34613,2019-09-14,991,0,991,79,1070,1070,0,0
34614,2019-09-14,612,0,612,48,660,660,0,0
34615,2019-09-14,612,0,612,48,660,660,0,0
34616,2019-09-14,-612,0,-612,-48,-660,-660,0,0
34617,2019-09-14,186,0,186,14,200,200,0,0
34618,2019-09-14,260,0,260,20,280,280,0,0
34619,2019-09-14,1334,0,1334,106,1440,1440,0,0
34620,2019-09-14,139,0,139,11,150,150,0,0
34621,2019-09-14,695,0,695,55,750,750,0,0
34622,2019-09-14,1408,0,1408,112,1520,0,0,1520
34623,2019-09-14,501,0,501,39,540,540,0,0
34624,2019-09-14,1325,0,1325,105,1430,0,1430,0
34625,2019-09-14,399,0,399,31,430,430,0,0
34626,2019-09-14,542,-58,484,38,522,522,0,0
34627,2019-09-14,130,0,130,10,140,140,0,0
34628,2019-09-14,760,0,760,60,820,820,0,0
34629,2019-09-14,564,0,564,36,600,600,0,0
34630,2019-09-14,1009,0,1009,71,1080,1080,0,0
34631,2019-09-14,1056,0,1056,84,1140,1140,0,0
34632,2019-09-14,630,0,630,50,680,680,0,0
34633,2019-09-14,1899,0,1899,151,2050,2050,0,0
34634,2019-09-14,744,-158,586,46,632,632,0,0
34635,2019-09-14,2538,0,2538,202,2740,2740,0,0
34636,2019-09-14,399,0,399,31,430,430,0,0
34637,2019-09-14,695,0,695,55,750,750,0,0
34638,2019-09-14,389,0,389,31,420,420,0,0
34639,2019-09-14,405,-86,319,25,344,344,0,0
34640,2019-09-14,871,0,871,69,940,940,0,0
34641,2019-09-14,667,0,667,53,720,720,0,0
34642,2019-09-14,806,0,806,64,870,870,0,0
34643,2019-09-14,732,0,732,58,790,790,0,0
34644,2019-09-14,112,0,112,8,120,120,0,0
34645,2019-09-14,167,0,167,13,180,180,0,0
34646,2019-09-14,3084,0,3084,246,3330,3330,0,0
34647,2019-09-14,1010,0,1010,80,1090,1090,0,0
34648,2019-09-14,501,0,501,39,540,540,0,0
34649,2019-09-14,315,0,315,25,340,340,0,0
34650,2019-09-14,862,0,862,68,930,930,0,0
34651,2019-09-14,260,0,260,20,280,280,0,0
34652,2019-09-14,1575,0,1575,125,1700,1700,0,0
34653,2019-09-14,1501,0,1501,119,1620,1620,0,0
34654,2019-09-14,1676,0,1676,134,1810,0,1810,0
34655,2019-09-14,612,0,612,48,660,660,0,0
34656,2019-09-14,352,0,352,28,380,0,0,380
34657,2019-09-14,1575,0,1575,125,1700,1700,0,0
34658,2019-09-14,250,0,250,20,270,270,0,0
34659,2019-09-14,1056,0,1056,84,1140,1140,0,0
34660,2019-09-14,1575,0,1575,125,1700,1700,0,0
34661,2019-09-14,482,0,482,38,520,520,0,0
34662,2019-09-14,667,0,667,53,720,720,0,0
34663,2019-09-14,686,0,686,54,740,740,0,0
34664,2019-09-14,1554,-161,1393,56,1449,1449,0,0
34665,2019-09-14,473,0,473,37,510,510,0,0
34666,2019-09-14,181,0,181,14,195,195,0,0
34667,2019-09-14,788,0,788,62,850,850,0,0
34668,2019-09-14,788,0,788,62,850,850,0,0
34669,2019-09-14,899,0,899,71,970,970,0,0
34670,2019-09-14,501,0,501,39,540,540,0,0
34671,2019-09-14,1111,-119,992,79,1071,1071,0,0
34672,2019-09-14,899,0,899,71,970,970,0,0
34673,2019-09-14,362,0,362,28,390,390,0,0
34674,2019-09-14,380,0,380,30,410,410,0,0
34675,2019-09-14,392,-42,350,28,378,378,0,0
34676,2019-09-14,1575,0,1575,125,1700,1700,0,0
34677,2019-09-14,102,0,102,8,110,110,0,0
34678,2019-09-14,1945,0,1945,155,2100,2100,0,0
34679,2019-09-14,269,0,269,21,290,290,0,0
34680,2019-09-14,1888,0,1888,142,2030,2030,0,0
34681,2019-09-14,528,0,528,42,570,570,0,0
34682,2019-09-14,630,0,630,50,680,680,0,0
34683,2019-09-14,325,0,325,25,350,350,0,0
34684,2019-09-14,213,0,213,17,230,230,0,0
34685,2019-09-14,3149,0,3149,251,3400,3400,0,0
34686,2019-09-14,3149,0,3149,251,3400,0,3400,0
34687,2019-09-14,1575,0,1575,125,1700,1700,0,0
34688,2019-09-14,2362,0,2362,188,2550,2550,0,0
34689,2019-09-14,1575,0,1575,125,1700,1700,0,0
34690,2019-09-14,3936,0,3936,314,4250,0,0,4250
34691,2019-09-14,1186,0,1186,94,1280,1280,0,0
34692,2019-09-14,1204,0,1204,96,1300,1300,0,0
34693,2019-09-14,593,0,593,47,640,640,0,0
34694,2019-09-14,2119,-227,1892,151,2043,2043,0,0
34695,2019-09-14,1528,0,1528,122,1650,1650,0,0
34696,2019-09-14,278,0,278,22,300,300,0,0
34697,2019-09-14,1575,0,1575,125,1700,1700,0,0
34698,2019-09-14,760,0,760,60,820,820,0,0
34699,2019-09-14,760,0,760,60,820,820,0,0
34700,2019-09-14,778,0,778,62,840,840,0,0
34701,2019-09-14,1575,0,1575,125,1700,1700,0,0
34702,2019-09-15,699,0,699,11,710,710,0,0
34703,2019-09-15,843,0,843,67,910,910,0,0
34704,2019-09-15,1010,0,1010,80,1090,1090,0,0
34705,2019-09-15,954,0,954,76,1030,1030,0,0
34706,2019-09-15,491,0,491,39,530,530,0,0
34707,2019-09-15,371,0,371,29,400,400,0,0
34708,2019-09-15,538,0,538,42,580,580,0,0
34709,2019-09-15,1612,0,1612,128,1740,1740,0,0
34710,2019-09-15,1620,0,1620,120,1740,1740,0,0
34711,2019-09-15,991,0,991,79,1070,0,1070,0
34712,2019-09-15,1806,0,1806,144,1950,0,1950,0
34713,2019-09-15,1815,0,1815,145,1960,0,0,1960
34714,2019-09-15,797,0,797,63,860,860,0,0
34715,2019-09-15,186,0,186,14,200,200,0,0
34716,2019-09-15,1510,0,1510,120,1630,1630,0,0
34717,2019-09-15,639,0,639,51,690,690,0,0
34718,2019-09-15,1417,0,1417,113,1530,1530,0,0
34719,2019-09-15,1213,0,1213,97,1310,1310,0,0
34720,2019-09-15,399,0,399,31,430,430,0,0
34721,2019-09-15,843,0,843,67,910,910,0,0
34722,2019-09-15,626,-67,559,44,603,603,0,0
34723,2019-09-15,389,0,389,31,420,420,0,0
34724,2019-09-15,3630,0,3630,290,3920,3920,0,0
34725,2019-09-15,491,0,491,39,530,530,0,0
34726,2019-09-15,1065,0,1065,85,1150,1150,0,0
34727,2019-09-15,1158,0,1158,92,1250,1250,0,0
34728,2019-09-15,2917,0,2917,233,3150,3150,0,0
34729,2019-09-15,260,0,260,20,280,280,0,0
34730,2019-09-15,1575,0,1575,125,1700,1700,0,0
34731,2019-09-15,584,0,584,46,630,630,0,0
34732,2019-09-15,1112,0,1112,88,1200,1200,0,0
34733,2019-09-15,1945,0,1945,155,2100,2100,0,0
34734,2019-09-15,1223,-131,1092,87,1179,1179,0,0
34735,2019-09-15,3149,0,3149,251,3400,0,3400,0
34736,2019-09-15,1667,0,1667,133,1800,1800,0,0
34737,2019-09-15,408,0,408,32,440,440,0,0
34738,2019-09-15,3202,0,3202,238,3440,0,3440,0
34739,2019-09-15,769,0,769,61,830,830,0,0
34740,2019-09-15,991,0,991,79,1070,1070,0,0
34741,2019-09-15,926,0,926,74,1000,1000,0,0
34742,2019-09-15,843,0,843,67,910,910,0,0
34743,2019-09-15,2093,0,2093,167,2260,2260,0,0
34744,2019-09-15,278,0,278,22,300,300,0,0
34745,2019-09-15,1315,0,1315,105,1420,1420,0,0
34746,2019-09-15,399,0,399,31,430,430,0,0
34747,2019-09-15,834,0,834,66,900,900,0,0
34748,2019-09-15,2213,0,2213,177,2390,0,2390,0
34749,2019-09-15,1232,0,1232,98,1330,1330,0,0
34750,2019-09-15,676,0,676,54,730,730,0,0
34751,2019-09-15,426,0,426,34,460,460,0,0
34752,2019-09-15,1149,0,1149,91,1240,1240,0,0
34753,2019-09-15,334,0,334,26,360,360,0,0
34754,2019-09-15,241,0,241,19,260,260,0,0
34755,2019-09-15,1815,0,1815,145,1960,1960,0,0
34756,2019-09-15,3630,0,3630,290,3920,3920,0,0
34757,2019-09-15,1815,0,1815,145,1960,1960,0,0
34758,2019-09-15,-1815,0,-1815,-145,-1960,-1960,0,0
34759,2019-09-15,1917,0,1917,153,2070,2070,0,0
34760,2019-09-15,223,0,223,17,240,240,0,0
34761,2019-09-15,551,-59,492,39,531,531,0,0
34762,2019-09-15,1323,0,1323,97,1420,1420,0,0
34763,2019-09-15,1815,0,1815,145,1960,1960,0,0
34764,2019-09-15,593,0,593,47,640,640,0,0
34765,2019-09-15,473,0,473,37,510,510,0,0
34766,2019-09-15,1501,0,1501,119,1620,1620,0,0
34767,2019-09-15,4019,0,4019,321,4340,4340,0,0
34768,2019-09-15,260,0,260,20,280,280,0,0
34769,2019-09-15,1815,0,1815,145,1960,1960,0,0
34770,2019-09-15,158,0,158,12,170,170,0,0
34771,2019-09-15,251,0,251,19,270,270,0,0
34772,2019-09-15,417,0,417,33,450,450,0,0
34773,2019-09-15,371,0,371,29,400,400,0,0
34774,2019-09-15,167,0,167,13,180,180,0,0
34775,2019-09-15,1065,0,1065,85,1150,1150,0,0
34776,2019-09-15,778,0,778,62,840,0,840,0
34777,2019-09-15,334,0,334,26,360,360,0,0
34778,2019-09-15,491,0,491,39,530,530,0,0
34779,2019-09-15,556,0,556,44,600,600,0,0
34780,2019-09-15,269,0,269,21,290,290,0,0
34781,2019-09-15,1510,0,1510,120,1630,1630,0,0
34782,2019-09-15,1815,0,1815,145,1960,1960,0,0
34783,2019-09-15,862,0,862,68,930,930,0,0
34784,2019-09-15,899,0,899,71,970,970,0,0
34785,2019-09-15,1815,0,1815,145,1960,1960,0,0
34786,2019-09-15,167,0,167,13,180,180,0,0
34787,2019-09-15,1815,0,1815,145,1960,1960,0,0
34788,2019-09-15,167,0,167,13,180,180,0,0
34789,2019-09-15,278,0,278,22,300,300,0,0
34790,2019-09-15,306,0,306,24,330,330,0,0
34791,2019-09-15,4454,0,4454,356,4810,4810,0,0
34792,2019-09-15,1658,0,1658,132,1790,1790,0,0
34793,2019-09-15,3630,0,3630,290,3920,3920,0,0
34794,2019-09-15,1843,0,1843,147,1990,0,1990,0
34795,2019-09-15,908,0,908,72,980,980,0,0
34796,2019-09-15,139,0,139,11,150,150,0,0
34797,2019-09-15,852,0,852,68,920,920,0,0
34798,2019-09-15,352,0,352,28,380,380,0,0
34799,2019-09-15,908,0,908,72,980,980,0,0
34800,2019-09-15,1815,0,1815,145,1960,1960,0,0
34801,2019-09-15,862,0,862,68,930,930,0,0
34802,2019-09-15,1982,0,1982,158,2140,0,2140,0
34803,2019-09-15,195,0,195,15,210,210,0,0
34804,2019-09-15,445,0,445,35,480,480,0,0
34805,2019-09-15,833,0,833,57,890,890,0,0
34806,2019-09-15,788,0,788,62,850,850,0,0
34807,2019-09-15,408,0,408,32,440,440,0,0
34808,2019-09-15,473,0,473,37,510,510,0,0
34809,2019-09-15,1195,0,1195,95,1290,0,1290,0
34810,2019-09-15,186,0,186,14,200,200,0,0
34811,2019-09-15,1593,0,1593,127,1720,1720,0,0
34812,2019-09-15,778,0,778,62,840,840,0,0
34813,2019-09-15,260,0,260,20,280,280,0,0
34814,2019-09-15,806,0,806,64,870,0,870,0
34815,2019-09-15,260,0,260,20,280,280,0,0
34816,2019-09-15,297,0,297,23,320,320,0,0
34817,2019-09-15,1186,0,1186,94,1280,1280,0,0
34818,2019-09-15,260,0,260,20,280,280,0,0
34819,2019-09-15,204,0,204,16,220,220,0,0
34820,2019-09-15,926,0,926,74,1000,1000,0,0
34821,2019-09-15,389,0,389,31,420,420,0,0
34822,2019-09-15,167,0,167,13,180,180,0,0
34823,2019-09-15,880,0,880,70,950,950,0,0
34824,2019-09-15,399,0,399,31,430,430,0,0
34825,2019-09-15,232,0,232,18,250,250,0,0
34826,2019-09-15,362,0,362,28,390,390,0,0
34827,2019-09-15,1408,0,1408,112,1520,1520,0,0
34828,2019-09-15,1241,0,1241,99,1340,1340,0,0
34829,2019-09-15,491,0,491,39,530,530,0,0
34830,2019-09-15,1834,0,1834,146,1980,1980,0,0
34831,2019-09-15,227,0,227,18,245,245,0,0
34832,2019-09-15,1278,0,1278,102,1380,1380,0,0
34833,2019-09-15,4047,0,4047,323,4370,4370,0,0
34834,2019-09-15,297,0,297,23,320,320,0,0
34835,2019-09-15,241,0,241,19,260,260,0,0
34836,2019-09-15,778,0,778,62,840,840,0,0
34837,2019-09-15,778,0,778,62,840,840,0,0
34838,2019-09-15,639,0,639,51,690,690,0,0
34839,2019-09-15,1806,0,1806,144,1950,1950,0,0
34840,2019-09-15,1584,0,1584,126,1710,1710,0,0
34841,2019-09-15,713,0,713,57,770,770,0,0
34842,2019-09-15,399,0,399,31,430,430,0,0
34843,2019-09-15,501,0,501,39,540,540,0,0
34844,2019-09-15,491,0,491,39,530,530,0,0
34845,2019-09-15,93,0,93,7,100,100,0,0
34846,2019-09-15,334,0,334,26,360,360,0,0
34847,2019-09-15,213,0,213,17,230,230,0,0
34848,2019-09-15,288,0,288,22,310,310,0,0
34849,2019-09-15,1417,0,1417,113,1530,1530,0,0
34850,2019-09-15,815,0,815,65,880,880,0,0
34851,2019-09-15,278,0,278,22,300,300,0,0
34852,2019-09-15,1112,0,1112,88,1200,1200,0,0
34853,2019-09-15,1028,0,1028,82,1110,1110,0,0
34854,2019-09-15,788,0,788,62,850,850,0,0
34855,2019-09-15,538,0,538,42,580,580,0,0
34856,2019-09-15,917,0,917,73,990,990,0,0
34857,2019-09-15,778,0,778,62,840,840,0,0
34858,2019-09-15,269,0,269,21,290,290,0,0
34859,2019-09-15,376,0,376,29,405,0,0,405
34860,2019-09-15,306,0,306,24,330,330,0,0
34861,2019-09-15,269,0,269,21,290,290,0,0
34862,2019-09-15,1575,0,1575,125,1700,1700,0,0
34863,2019-09-15,158,0,158,12,170,170,0,0
34864,2019-09-15,509,0,509,31,540,540,0,0
34865,2019-09-15,1575,0,1575,125,1700,1700,0,0
34866,2019-09-15,797,0,797,63,860,860,0,0
34867,2019-09-15,639,0,639,51,690,690,0,0
34868,2019-09-15,1352,0,1352,108,1460,1460,0,0
34869,2019-09-15,797,0,797,63,860,860,0,0
34870,2019-09-15,334,0,334,26,360,360,0,0
34871,2019-09-15,-389,0,-389,-31,-420,-420,0,0
34872,2019-09-15,1852,0,1852,148,2000,2000,0,0
34873,2019-09-15,1575,0,1575,125,1700,0,1700,0
34874,2019-09-15,1019,0,1019,81,1100,1100,0,0
34875,2019-09-15,1575,0,1575,125,1700,1700,0,0
34876,2019-09-15,509,0,509,31,540,540,0,0
34877,2019-09-15,1038,0,1038,82,1120,1120,0,0
34878,2019-09-15,2101,0,2101,159,2260,2260,0,0
34879,2019-09-15,500,0,500,40,540,0,0,540
34880,2019-09-15,797,0,797,63,860,860,0,0
34881,2019-09-15,362,0,362,28,390,390,0,0
34882,2019-09-15,371,0,371,29,400,400,0,0
34883,2019-09-15,1417,0,1417,113,1530,1530,0,0
34884,2019-09-15,1547,0,1547,123,1670,1670,0,0
34885,2019-09-15,2362,0,2362,188,2550,0,2550,0
34886,2019-09-15,389,0,389,31,420,420,0,0
34887,2019-09-15,1575,0,1575,125,1700,1700,0,0
34888,2019-09-15,491,0,491,39,530,530,0,0
34889,2019-09-15,880,0,880,70,950,950,0,0
34890,2019-09-15,362,0,362,28,390,390,0,0
34891,2019-09-15,362,0,362,28,390,390,0,0
34892,2019-09-15,260,0,260,20,280,0,280,0
34893,2019-09-15,1575,0,1575,125,1700,1700,0,0
34894,2019-09-15,1575,0,1575,125,1700,1700,0,0
34895,2019-09-15,278,0,278,22,300,300,0,0
34896,2019-09-15,1575,0,1575,125,1700,1700,0,0
34897,2019-09-15,1019,0,1019,81,1100,1100,0,0
34898,2019-09-15,1852,0,1852,148,2000,2000,0,0
34899,2019-09-15,1575,0,1575,125,1700,1700,0,0
34900,2019-09-15,1065,0,1065,85,1150,1150,0,0
34901,2019-09-15,1325,0,1325,105,1430,1430,0,0
34902,2019-09-15,2362,0,2362,188,2550,2550,0,0
34903,2019-09-15,431,0,431,34,465,465,0,0
34904,2019-09-15,1204,0,1204,96,1300,1300,0,0
34905,2019-09-15,1814,0,1814,136,1950,1950,0,0
34906,2019-09-15,501,0,501,39,540,540,0,0
34907,2019-09-15,788,0,788,62,850,850,0,0
34908,2019-09-15,1575,0,1575,125,1700,1700,0,0
34909,2019-09-15,1575,0,1575,125,1700,1700,0,0
34910,2019-09-16,1815,0,1815,145,1960,1960,0,0
34911,2019-09-16,315,0,315,25,340,340,0,0
34912,2019-09-16,417,0,417,33,450,450,0,0
34913,2019-09-16,1000,0,1000,80,1080,0,1080,0
34914,2019-09-16,584,0,584,46,630,630,0,0
34915,2019-09-16,1815,0,1815,145,1960,1960,0,0
34916,2019-09-16,352,0,352,28,380,380,0,0
34917,2019-09-16,782,-83,699,48,747,747,0,0
34918,2019-09-16,241,0,241,19,260,260,0,0
34919,2019-09-16,426,0,426,34,460,460,0,0
34920,2019-09-16,473,0,473,37,510,510,0,0
34921,2019-09-16,1269,0,1269,101,1370,1370,0,0
34922,2019-09-16,1371,0,1371,109,1480,1480,0,0
34923,2019-09-16,1223,0,1223,97,1320,1320,0,0
34924,2019-09-16,1815,0,1815,145,1960,1960,0,0
34925,2019-09-16,658,0,658,52,710,710,0,0
34926,2019-09-16,392,-42,350,28,378,378,0,0
34927,2019-09-16,435,0,435,25,460,460,0,0
34928,2019-09-16,453,0,453,27,480,480,0,0
34929,2019-09-16,241,0,241,19,260,260,0,0
34930,2019-09-16,1001,0,1001,79,1080,1080,0,0
34931,2019-09-16,695,0,695,55,750,750,0,0
34932,2019-09-16,504,-54,450,36,486,486,0,0
34933,2019-09-16,245,-52,193,15,208,208,0,0
34934,2019-09-16,644,0,644,51,695,695,0,0
34935,2019-09-16,814,0,814,56,870,870,0,0
34936,2019-09-16,1815,0,1815,145,1960,1960,0,0
34937,2019-09-16,1158,0,1158,92,1250,1250,0,0
34938,2019-09-16,834,0,834,66,900,900,0,0
34939,2019-09-16,167,0,167,13,180,180,0,0
34940,2019-09-16,1389,0,1389,111,1500,1500,0,0
34941,2019-09-16,621,0,621,49,670,670,0,0
34942,2019-09-16,908,0,908,72,980,980,0,0
34943,2019-09-16,3149,0,3149,251,3400,3400,0,0
34944,2019-09-16,495,-53,442,35,477,0,0,477
34945,2019-09-16,769,0,769,61,830,830,0,0
34946,2019-09-16,514,-55,459,36,495,0,0,495
34947,2019-09-16,336,-36,300,24,324,324,0,0
34948,2019-09-16,917,0,917,73,990,990,0,0
34949,2019-09-16,269,0,269,21,290,290,0,0
34950,2019-09-16,649,0,649,51,700,700,0,0
34951,2019-09-16,519,0,519,41,560,560,0,0
34952,2019-09-16,908,0,908,72,980,980,0,0
34953,2019-09-16,749,0,749,51,800,800,0,0
34954,2019-09-16,908,0,908,72,980,980,0,0
34955,2019-09-16,908,0,908,72,980,980,0,0
34956,2019-09-16,528,0,528,42,570,570,0,0
34957,2019-09-16,639,0,639,51,690,690,0,0
34958,2019-09-16,445,0,445,35,480,480,0,0
34959,2019-09-16,908,0,908,72,980,980,0,0
34960,2019-09-16,908,0,908,72,980,980,0,0
34961,2019-09-16,908,0,908,72,980,980,0,0
34962,2019-09-16,612,0,612,48,660,660,0,0
34963,2019-09-16,269,0,269,21,290,290,0,0
34964,2019-09-16,769,0,769,61,830,830,0,0
34965,2019-09-16,741,0,741,59,800,800,0,0
34966,2019-09-16,130,0,130,10,140,140,0,0
34967,2019-09-16,1158,0,1158,92,1250,1250,0,0
34968,2019-09-16,565,0,565,45,610,610,0,0
34969,2019-09-16,463,0,463,37,500,500,0,0
34970,2019-09-16,251,0,251,19,270,270,0,0
34971,2019-09-16,1297,0,1297,103,1400,0,1400,0
34972,2019-09-16,402,-43,359,28,387,387,0,0
34973,2019-09-16,206,-22,184,14,198,198,0,0
34974,2019-09-16,908,0,908,72,980,980,0,0
34975,2019-09-16,139,0,139,11,150,150,0,0
34976,2019-09-16,602,0,602,48,650,650,0,0
34977,2019-09-16,1139,-242,897,71,968,968,0,0
34978,2019-09-16,825,0,825,65,890,890,0,0
34979,2019-09-16,788,0,788,62,850,850,0,0
34980,2019-09-16,1575,0,1575,125,1700,1700,0,0
34981,2019-09-16,269,0,269,21,290,290,0,0
34982,2019-09-16,889,0,889,71,960,960,0,0
34983,2019-09-16,269,0,269,21,290,290,0,0
34984,2019-09-16,1130,0,1130,90,1220,0,1220,0
34985,2019-09-16,2176,0,2176,174,2350,2350,0,0
34986,2019-09-16,241,0,241,19,260,260,0,0
34987,2019-09-16,862,0,862,68,930,0,930,0
34988,2019-09-16,510,0,510,40,550,550,0,0
34989,2019-09-16,1232,0,1232,98,1330,1330,0,0
34990,2019-09-16,193,0,193,15,208,208,0,0
34991,2019-09-16,926,0,926,74,1000,1000,0,0
34992,2019-09-16,1575,0,1575,125,1700,1700,0,0
34993,2019-09-16,352,0,352,28,380,380,0,0
34994,2019-09-16,121,0,121,9,130,130,0,0
34995,2019-09-16,556,0,556,44,600,600,0,0
34996,2019-09-16,926,0,926,74,1000,1000,0,0
34997,2019-09-16,2028,0,2028,162,2190,2190,0,0
34998,2019-09-16,389,0,389,31,420,420,0,0
34999,2019-09-16,1815,0,1815,145,1960,1960,0,0
35000,2019-09-16,936,0,936,74,1010,1010,0,0
35001,2019-09-16,250,0,250,20,270,270,0,0
35002,2019-09-16,519,0,519,41,560,560,0,0
35003,2019-09-16,667,0,667,53,720,720,0,0
35004,2019-09-16,797,0,797,63,860,860,0,0
35005,2019-09-16,621,0,621,49,670,670,0,0
35006,2019-09-16,269,0,269,21,290,290,0,0
35007,2019-09-16,1593,0,1593,127,1720,1720,0,0
35008,2019-09-16,621,0,621,49,670,670,0,0
35009,2019-09-16,1223,0,1223,97,1320,1320,0,0
35010,2019-09-16,232,0,232,18,250,250,0,0
35011,2019-09-16,760,0,760,60,820,820,0,0
35012,2019-09-16,1408,0,1408,112,1520,1520,0,0
35013,2019-09-16,575,0,575,45,620,620,0,0
35014,2019-09-16,482,0,482,38,520,520,0,0
35015,2019-09-16,289,0,289,23,312,312,0,0
35016,2019-09-16,482,0,482,38,520,520,0,0
35017,2019-09-16,269,0,269,21,290,290,0,0
35018,2019-09-16,232,0,232,18,250,250,0,0
35019,2019-09-16,269,0,269,21,290,290,0,0
35020,2019-09-16,788,0,788,62,850,850,0,0
35021,2019-09-16,288,0,288,22,310,310,0,0
35022,2019-09-16,130,0,130,10,140,140,0,0
35023,2019-09-16,1065,0,1065,85,1150,1150,0,0
35024,2019-09-16,788,0,788,62,850,850,0,0
35025,2019-09-16,1130,0,1130,90,1220,1220,0,0
35026,2019-09-16,1130,0,1130,90,1220,1220,0,0
35027,2019-09-16,889,0,889,71,960,960,0,0
35028,2019-09-16,1008,-108,900,72,972,972,0,0
35029,2019-09-16,278,0,278,22,300,300,0,0
35030,2019-09-16,788,0,788,62,850,850,0,0
35031,2019-09-16,843,0,843,67,910,910,0,0
35032,2019-09-16,249,0,249,11,260,260,0,0
35033,2019-09-16,1575,0,1575,125,1700,0,1700,0
35034,2019-09-16,788,0,788,62,850,850,0,0
35035,2019-09-16,269,0,269,21,290,290,0,0
35036,2019-09-16,167,0,167,13,180,180,0,0
35037,2019-09-16,862,0,862,68,930,930,0,0
35038,2019-09-16,1101,0,1101,79,1180,1180,0,0
35039,2019-09-16,1852,0,1852,148,2000,2000,0,0
35040,2019-09-16,1139,0,1139,91,1230,1230,0,0
35041,2019-09-16,1825,0,1825,145,1970,1970,0,0
35042,2019-09-16,1389,0,1389,111,1500,1500,0,0
35043,2019-09-16,362,0,362,28,390,390,0,0
35044,2019-09-17,691,-74,617,49,666,666,0,0
35045,2019-09-17,842,0,842,58,900,0,0,900
35046,2019-09-17,167,0,167,13,180,180,0,0
35047,2019-09-17,638,0,638,42,680,680,0,0
35048,2019-09-17,738,-79,659,52,711,711,0,0
35049,2019-09-17,47,0,47,3,50,50,0,0
35050,2019-09-17,149,0,149,11,160,160,0,0
35051,2019-09-17,991,0,991,79,1070,1070,0,0
35052,2019-09-17,222,0,222,8,230,230,0,0
35053,2019-09-17,149,0,149,11,160,160,0,0
35054,2019-09-17,315,0,315,25,340,340,0,0
35055,2019-09-17,232,0,232,18,250,250,0,0
35056,2019-09-17,174,0,174,13,187,187,0,0
35057,2019-09-17,208,0,208,16,224,224,0,0
35058,2019-09-17,269,0,269,21,290,290,0,0
35059,2019-09-17,1815,0,1815,145,1960,1960,0,0
35060,2019-09-17,501,0,501,39,540,540,0,0
35061,2019-09-17,1352,0,1352,108,1460,1460,0,0
35062,2019-09-17,899,0,899,71,970,970,0,0
35063,2019-09-17,649,0,649,51,700,700,0,0
35064,2019-09-17,195,0,195,15,210,210,0,0
35065,2019-09-17,1694,-360,1334,106,1440,1440,0,0
35066,2019-09-17,251,0,251,19,270,270,0,0
35067,2019-09-19,463,0,463,37,500,500,0,0
35068,2019-09-19,602,0,602,48,650,650,0,0
35069,2019-09-19,565,0,565,45,610,610,0,0
35070,2019-09-19,1233,-132,1101,87,1188,1188,0,0
35071,2019-09-19,1491,0,1491,119,1610,1610,0,0
35072,2019-09-19,1176,0,1176,94,1270,1270,0,0
35073,2019-09-19,491,0,491,39,530,530,0,0
35074,2019-09-19,760,0,760,60,820,820,0,0
35075,2019-09-19,908,0,908,72,980,980,0,0
35076,2019-09-19,982,0,982,78,1060,1060,0,0
35077,2019-09-19,612,0,612,48,660,660,0,0
35078,2019-09-19,223,0,223,17,240,240,0,0
35079,2019-09-19,195,0,195,15,210,210,0,0
35080,2019-09-19,278,0,278,22,300,300,0,0
35081,2019-09-19,231,0,231,9,240,240,0,0
35082,2019-09-19,649,0,649,51,700,700,0,0
35083,2019-09-19,1815,0,1815,145,1960,1960,0,0
35084,2019-09-19,908,0,908,72,980,980,0,0
35085,2019-09-19,538,0,538,42,580,580,0,0
35086,2019-09-19,500,0,500,40,540,540,0,0
35087,2019-09-19,1815,0,1815,145,1960,1960,0,0
35088,2019-09-19,991,0,991,79,1070,1070,0,0
35089,2019-09-19,1602,0,1602,128,1730,1730,0,0
35090,2019-09-19,269,0,269,21,290,290,0,0
35091,2019-09-19,327,-35,292,23,315,315,0,0
35092,2019-09-19,1125,-120,1005,80,1085,1085,0,0
35093,2019-09-19,454,0,454,36,490,490,0,0
35094,2019-09-19,834,0,834,66,900,900,0,0
35095,2019-09-19,269,0,269,21,290,290,0,0
35096,2019-09-19,417,0,417,33,450,450,0,0
35097,2019-09-19,1815,0,1815,145,1960,0,1960,0
35098,2019-09-19,1815,0,1815,145,1960,1960,0,0
35099,2019-09-19,1815,0,1815,145,1960,1960,0,0
35100,2019-09-19,315,0,315,25,340,340,0,0
35101,2019-09-19,936,0,936,74,1010,1010,0,0
35102,2019-09-19,658,0,658,52,710,0,710,0
35103,2019-09-19,1028,0,1028,82,1110,1110,0,0
35104,2019-09-19,380,0,380,30,410,410,0,0
35105,2019-09-19,334,0,334,26,360,360,0,0
35106,2019-09-19,658,0,658,52,710,0,710,0
35107,2019-09-19,973,0,973,77,1050,1050,0,0
35108,2019-09-19,788,0,788,62,850,850,0,0
35109,2019-09-19,788,0,788,62,850,850,0,0
35110,2019-09-19,611,0,611,39,650,650,0,0
35111,2019-09-19,399,0,399,31,430,430,0,0
35112,2019-09-19,306,0,306,24,330,330,0,0
35113,2019-09-19,1471,0,1471,99,1570,1570,0,0
35114,2019-09-19,788,0,788,62,850,850,0,0
35115,2019-09-19,1065,0,1065,85,1150,1150,0,0
35116,2019-09-19,139,0,139,11,150,150,0,0
35117,2019-09-19,325,0,325,25,350,350,0,0
35118,2019-09-19,806,0,806,64,870,870,0,0
35119,2019-09-19,926,0,926,74,1000,1000,0,0
35120,2019-09-19,1759,0,1759,131,1890,1890,0,0
35121,2019-09-19,325,0,325,25,350,350,0,0
35122,2019-09-19,1575,0,1575,125,1700,1700,0,0
35123,2019-09-19,463,0,463,37,500,0,500,0
35124,2019-09-19,2323,0,2323,177,2500,2500,0,0
35125,2019-09-19,1575,0,1575,125,1700,1700,0,0
35126,2019-09-19,834,0,834,66,900,900,0,0
35127,2019-09-19,306,0,306,24,330,0,0,330
35128,2019-09-19,582,0,582,28,610,610,0,0
35129,2019-09-19,186,0,186,14,200,200,0,0
35130,2019-09-19,315,0,315,25,340,340,0,0
35131,2019-09-19,260,0,260,20,280,280,0,0
35132,2019-09-19,1056,0,1056,84,1140,1140,0,0
35133,2019-09-19,510,0,510,40,550,550,0,0
35134,2019-09-19,519,0,519,41,560,560,0,0
35135,2019-09-19,556,0,556,44,600,600,0,0
35136,2019-09-19,760,0,760,60,820,820,0,0
35137,2019-09-19,3120,0,3120,240,3360,0,3360,0
35138,2019-09-19,1834,0,1834,146,1980,1980,0,0
35139,2019-09-19,213,0,213,17,230,230,0,0
35140,2019-09-19,1019,0,1019,81,1100,1100,0,0
35141,2019-09-19,3084,0,3084,246,3330,0,3330,0
35142,2019-09-19,1334,0,1334,106,1440,1440,0,0
35143,2019-09-19,788,0,788,62,850,850,0,0
35144,2019-09-19,788,0,788,62,850,850,0,0
35145,2019-09-19,519,0,519,41,560,560,0,0
35146,2019-09-20,760,0,760,60,820,820,0,0
35147,2019-09-20,936,0,936,74,1010,1010,0,0
35148,2019-09-20,389,0,389,31,420,420,0,0
35149,2019-09-20,649,0,649,51,700,700,0,0
35150,2019-09-20,306,0,306,24,330,330,0,0
35151,2019-09-20,1815,0,1815,145,1960,1960,0,0
35152,2019-09-20,806,0,806,64,870,870,0,0
35153,2019-09-20,852,0,852,68,920,920,0,0
35154,2019-09-20,1232,0,1232,98,1330,1330,0,0
35155,2019-09-20,1815,0,1815,145,1960,1960,0,0
35156,2019-09-20,1251,0,1251,99,1350,1350,0,0
35157,2019-09-20,630,0,630,50,680,680,0,0
35158,2019-09-20,417,0,417,33,450,450,0,0
35159,2019-09-20,602,0,602,48,650,650,0,0
35160,2019-09-20,-1815,0,-1815,-145,-1960,-1960,0,0
35161,2019-09-20,1399,0,1399,111,1510,1510,0,0
35162,2019-09-20,908,0,908,72,980,980,0,0
35163,2019-09-20,751,0,751,59,810,810,0,0
35164,2019-09-20,1166,0,1166,84,1250,1250,0,0
35165,2019-09-20,2010,0,2010,160,2170,0,0,2170
35166,2019-09-20,943,-101,842,67,909,909,0,0
35167,2019-09-20,713,0,713,57,770,770,0,0
35168,2019-09-20,555,0,555,35,590,590,0,0
35169,2019-09-20,945,0,945,75,1020,1020,0,0
35170,2019-09-20,139,0,139,11,150,150,0,0
35171,2019-09-20,186,0,186,14,200,200,0,0
35172,2019-09-20,871,0,871,69,940,940,0,0
35173,2019-09-20,510,0,510,40,550,550,0,0
35174,2019-09-20,260,0,260,20,280,280,0,0
35175,2019-09-20,1288,0,1288,102,1390,1390,0,0
35176,2019-09-20,685,0,685,45,730,0,0,730
35177,2019-09-20,704,0,704,56,760,0,0,760
35178,2019-09-20,1417,0,1417,113,1530,1530,0,0
35179,2019-09-20,1306,0,1306,104,1410,1410,0,0
35180,2019-09-20,1269,0,1269,101,1370,1370,0,0
35181,2019-09-20,167,0,167,13,180,180,0,0
35182,2019-09-20,547,0,547,43,590,0,0,590
35183,2019-09-20,908,0,908,72,980,980,0,0
35184,2019-09-20,908,0,908,72,980,980,0,0
35185,2019-09-20,759,0,759,51,810,810,0,0
35186,2019-09-20,232,0,232,18,250,250,0,0
35187,2019-09-20,1093,-1000,93,7,100,100,0,0
35188,2019-09-20,1223,0,1223,97,1320,1320,0,0
35189,2019-09-20,315,0,315,25,340,340,0,0
35190,2019-09-20,1815,0,1815,145,1960,1960,0,0
35191,2019-09-20,686,0,686,54,740,740,0,0
35192,2019-09-20,575,0,575,45,620,620,0,0
35193,2019-09-20,426,0,426,34,460,460,0,0
35194,2019-09-20,278,0,278,22,300,300,0,0
35195,2019-09-20,806,0,806,64,870,870,0,0
35196,2019-09-20,788,0,788,62,850,0,850,0
35197,2019-09-20,732,0,732,58,790,790,0,0
35198,2019-09-20,220,0,220,0,220,220,0,0
35199,2019-09-20,1038,0,1038,82,1120,1120,0,0
35200,2019-09-20,2723,0,2723,217,2940,2940,0,0
35201,2019-09-20,417,0,417,33,450,450,0,0
35202,2019-09-20,1157,0,1157,83,1240,1240,0,0
35203,2019-09-20,1676,0,1676,134,1810,1810,0,0
35204,2019-09-20,630,0,630,50,680,680,0,0
35205,2019-09-20,556,0,556,44,600,600,0,0
35206,2019-09-20,908,0,908,72,980,980,0,0
35207,2019-09-20,908,0,908,72,980,980,0,0
35208,2019-09-20,908,0,908,72,980,980,0,0
35209,2019-09-20,1047,0,1047,83,1130,1130,0,0
35210,2019-09-20,139,0,139,11,150,150,0,0
35211,2019-09-20,1815,0,1815,145,1960,1960,0,0
35212,2019-09-20,732,0,732,58,790,790,0,0
35213,2019-09-20,889,0,889,71,960,960,0,0
35214,2019-09-20,556,0,556,44,600,600,0,0
35215,2019-09-20,908,0,908,72,980,980,0,0
35216,2019-09-20,908,0,908,72,980,980,0,0
35217,2019-09-20,362,0,362,28,390,390,0,0
35218,2019-09-20,639,0,639,51,690,690,0,0
35219,2019-09-20,1713,0,1713,137,1850,1850,0,0
35220,2019-09-20,260,0,260,20,280,280,0,0
35221,2019-09-20,840,0,840,40,880,880,0,0
35222,2019-09-20,815,0,815,65,880,880,0,0
35223,2019-09-20,969,-206,763,61,824,824,0,0
35224,2019-09-20,635,-68,567,45,612,612,0,0
35225,2019-09-20,426,0,426,34,460,460,0,0
35226,2019-09-20,408,0,408,32,440,440,0,0
35227,2019-09-20,399,0,399,31,430,430,0,0
35228,2019-09-20,630,0,630,50,680,680,0,0
35229,2019-09-20,639,0,639,51,690,690,0,0
35230,2019-09-20,815,0,815,65,880,880,0,0
35231,2019-09-20,963,0,963,77,1040,1040,0,0
35232,2019-09-20,315,0,315,25,340,340,0,0
35233,2019-09-20,501,0,501,39,540,540,0,0
35234,2019-09-20,269,0,269,21,290,290,0,0
35235,2019-09-20,463,0,463,37,500,500,0,0
35236,2019-09-20,417,0,417,33,450,450,0,0
35237,2019-09-20,269,0,269,21,290,290,0,0
35238,2019-09-20,564,0,564,36,600,600,0,0
35239,2019-09-20,731,0,731,49,780,780,0,0
35240,2019-09-20,139,0,139,11,150,150,0,0
35241,2019-09-20,593,0,593,47,640,640,0,0
35242,2019-09-20,278,0,278,22,300,300,0,0
35243,2019-09-20,251,0,251,19,270,270,0,0
35244,2019-09-20,667,0,667,53,720,720,0,0
35245,2019-09-20,1056,0,1056,84,1140,1140,0,0
35246,2019-09-20,260,0,260,20,280,280,0,0
35247,2019-09-20,982,0,982,78,1060,1060,0,0
35248,2019-09-20,833,0,833,57,890,890,0,0
35249,2019-09-20,408,0,408,32,440,440,0,0
35250,2019-09-20,778,0,778,62,840,840,0,0
35251,2019-09-20,288,0,288,22,310,310,0,0
35252,2019-09-20,260,0,260,20,280,280,0,0
35253,2019-09-20,1482,0,1482,118,1600,1600,0,0
35254,2019-09-20,1121,0,1121,89,1210,1210,0,0
35255,2019-09-20,139,0,139,11,150,150,0,0
35256,2019-09-20,1064,0,1064,76,1140,1140,0,0
35257,2019-09-20,602,0,602,48,650,650,0,0
35258,2019-09-20,1482,0,1482,118,1600,1600,0,0
35259,2019-09-20,1426,0,1426,114,1540,1540,0,0
35260,2019-09-20,1269,0,1269,101,1370,1370,0,0
35261,2019-09-20,667,0,667,53,720,0,720,0
35262,2019-09-20,1519,0,1519,121,1640,1640,0,0
35263,2019-09-20,417,0,417,33,450,450,0,0
35264,2019-09-20,2445,0,2445,195,2640,2640,0,0
35265,2019-09-20,1575,0,1575,125,1700,1700,0,0
35266,2019-09-20,380,0,380,30,410,410,0,0
35267,2019-09-20,167,0,167,13,180,180,0,0
35268,2019-09-20,825,0,825,65,890,0,890,0
35269,2019-09-20,1325,0,1325,105,1430,1430,0,0
35270,2019-09-20,954,0,954,76,1030,1030,0,0
35271,2019-09-20,362,0,362,28,390,390,0,0
35272,2019-09-20,325,0,325,25,350,350,0,0
35273,2019-09-20,2601,0,2601,199,2800,2800,0,0
35274,2019-09-20,204,0,204,16,220,220,0,0
35275,2019-09-20,584,0,584,46,630,630,0,0
35276,2019-09-20,1343,0,1343,107,1450,1450,0,0
35277,2019-09-20,234,-25,209,16,225,225,0,0
35278,2019-09-20,1575,0,1575,125,1700,0,1700,0
35279,2019-09-20,519,0,519,41,560,560,0,0
35280,2019-09-20,167,0,167,13,180,180,0,0
35281,2019-09-20,1963,0,1963,157,2120,2120,0,0
35282,2019-09-20,269,0,269,21,290,290,0,0
35283,2019-09-20,1658,0,1658,132,1790,1790,0,0
35284,2019-09-20,1575,0,1575,125,1700,1700,0,0
35285,2019-09-20,843,0,843,67,910,910,0,0
35286,2019-09-20,953,0,953,67,1020,1020,0,0
35287,2019-09-20,880,0,880,70,950,950,0,0
35288,2019-09-20,639,0,639,51,690,690,0,0
35289,2019-09-20,1417,0,1417,113,1530,1530,0,0
35290,2019-09-20,9584,0,9584,766,10350,10350,0,0
35291,2019-09-20,954,0,954,76,1030,1030,0,0
35292,2019-09-21,2064,0,2064,156,2220,2220,0,0
35293,2019-09-21,2649,0,2649,211,2860,2860,0,0
35294,2019-09-21,926,0,926,74,1000,1000,0,0
35295,2019-09-21,963,0,963,77,1040,1040,0,0
35296,2019-09-21,430,-46,384,30,414,414,0,0
35297,2019-09-21,260,0,260,20,280,280,0,0
35298,2019-09-21,695,0,695,55,750,750,0,0
35299,2019-09-21,1130,-121,1009,80,1089,1089,0,0
35300,2019-09-21,1815,0,1815,145,1960,1960,0,0
35301,2019-09-21,944,0,944,66,1010,0,1010,0
35302,2019-09-21,399,0,399,31,430,430,0,0
35303,2019-09-21,473,0,473,37,510,510,0,0
35304,2019-09-21,389,0,389,31,420,420,0,0
35305,2019-09-21,269,0,269,21,290,290,0,0
35306,2019-09-21,685,0,685,45,730,730,0,0
35307,2019-09-21,556,0,556,44,600,600,0,0
35308,2019-09-21,1001,0,1001,79,1080,0,0,1080
35309,2019-09-21,501,0,501,39,540,540,0,0
35310,2019-09-21,1035,0,1035,65,1100,1100,0,0
35311,2019-09-21,250,0,250,20,270,270,0,0
35312,2019-09-21,436,0,436,34,470,470,0,0
35313,2019-09-21,514,-55,459,36,495,495,0,0
35314,2019-09-21,1112,0,1112,88,1200,0,1200,0
35315,2019-09-21,621,0,621,49,670,670,0,0
35316,2019-09-21,1509,0,1509,111,1620,1620,0,0
35317,2019-09-21,556,0,556,44,600,600,0,0
35318,2019-09-21,482,0,482,38,520,0,520,0
35319,2019-09-21,1575,0,1575,125,1700,1700,0,0
35320,2019-09-21,1084,0,1084,86,1170,1170,0,0
35321,2019-09-21,1575,0,1575,125,1700,1700,0,0
35322,2019-09-21,542,-58,484,38,522,522,0,0
35323,2019-09-21,788,0,788,62,850,850,0,0
35324,2019-09-21,269,0,269,21,290,290,0,0
35325,2019-09-21,741,0,741,59,800,800,0,0
35326,2019-09-21,686,0,686,54,740,740,0,0
35327,2019-09-21,1102,0,1102,88,1190,1190,0,0
35328,2019-09-21,167,0,167,13,180,180,0,0
35329,2019-09-21,556,0,556,44,600,600,0,0
35330,2019-09-21,621,0,621,49,670,670,0,0
35331,2019-09-21,686,0,686,54,740,740,0,0
35332,2019-09-21,2575,0,2575,205,2780,2780,0,0
35333,2019-09-21,1056,0,1056,84,1140,1140,0,0
35334,2019-09-21,749,0,749,51,800,800,0,0
35335,2019-09-21,871,0,871,69,940,940,0,0
35336,2019-09-21,1084,0,1084,86,1170,1170,0,0
35337,2019-09-21,973,0,973,77,1050,1050,0,0
35338,2019-09-21,1028,0,1028,82,1110,1110,0,0
35339,2019-09-21,389,0,389,31,420,420,0,0
35340,2019-09-21,149,0,149,11,160,160,0,0
35341,2019-09-21,362,0,362,28,390,390,0,0
35342,2019-09-21,454,0,454,36,490,490,0,0
35343,2019-09-21,1028,0,1028,82,1110,1110,0,0
35344,2019-09-21,1501,0,1501,119,1620,1620,0,0
35345,2019-09-21,213,0,213,17,230,230,0,0
35346,2019-09-21,2102,0,2102,168,2270,2270,0,0
35347,2019-09-21,417,0,417,33,450,450,0,0
35348,2019-09-21,2741,0,2741,219,2960,2960,0,0
35349,2019-09-21,908,0,908,72,980,980,0,0
35350,2019-09-21,556,0,556,44,600,600,0,0
35351,2019-09-21,658,0,658,52,710,710,0,0
35352,2019-09-21,213,0,213,17,230,230,0,0
35353,2019-09-21,547,0,547,43,590,590,0,0
35354,2019-09-21,334,0,334,26,360,360,0,0
35355,2019-09-21,271,-29,242,19,261,261,0,0
35356,2019-09-21,334,0,334,26,360,360,0,0
35357,2019-09-21,667,0,667,53,720,720,0,0
35358,2019-09-21,149,0,149,11,160,160,0,0
35359,2019-09-21,315,0,315,25,340,340,0,0
35360,2019-09-21,362,0,362,28,390,390,0,0
35361,2019-09-21,1232,0,1232,98,1330,1330,0,0
35362,2019-09-21,718,0,718,57,775,775,0,0
35363,2019-09-21,1575,0,1575,125,1700,1700,0,0
35364,2019-09-21,880,0,880,70,950,950,0,0
35365,2019-09-21,899,0,899,71,970,970,0,0
35366,2019-09-21,649,0,649,51,700,700,0,0
35367,2019-09-21,1334,0,1334,106,1440,0,1440,0
35368,2019-09-21,556,0,556,44,600,600,0,0
35369,2019-09-21,334,0,334,26,360,360,0,0
35370,2019-09-21,945,0,945,75,1020,1020,0,0
35371,2019-09-21,945,0,945,75,1020,1020,0,0
35372,2019-09-21,584,0,584,46,630,630,0,0
35373,2019-09-21,862,0,862,68,930,930,0,0
35374,2019-09-21,760,0,760,60,820,820,0,0
35375,2019-09-21,1371,0,1371,109,1480,1480,0,0
35376,2019-09-21,538,0,538,42,580,580,0,0
35377,2019-09-21,523,0,523,41,564,564,0,0
35378,2019-09-21,1556,0,1556,124,1680,1680,0,0
35379,2019-09-21,463,0,463,37,500,500,0,0
35380,2019-09-21,852,0,852,68,920,920,0,0
35381,2019-09-21,482,0,482,38,520,520,0,0
35382,2019-09-21,269,0,269,21,290,290,0,0
35383,2019-09-21,278,0,278,22,300,300,0,0
35384,2019-09-21,1315,0,1315,105,1420,1420,0,0
35385,2019-09-21,454,0,454,36,490,490,0,0
35386,2019-09-21,676,0,676,54,730,730,0,0
35387,2019-09-21,2675,0,2675,205,2880,2880,0,0
35388,2019-09-21,3223,0,3223,257,3480,3480,0,0
35389,2019-09-21,575,0,575,45,620,620,0,0
35390,2019-09-21,2445,0,2445,195,2640,0,2640,0
35391,2019-09-21,463,0,463,37,500,500,0,0
35392,2019-09-21,769,0,769,61,830,830,0,0
35393,2019-09-21,1065,0,1065,85,1150,1150,0,0
35394,2019-09-21,3380,0,3380,270,3650,3650,0,0
35395,2019-09-21,862,0,862,68,930,930,0,0
35396,2019-09-21,741,0,741,59,800,800,0,0
35397,2019-09-21,584,0,584,46,630,630,0,0
35398,2019-09-21,760,0,760,60,820,820,0,0
35399,2019-09-21,454,0,454,36,490,490,0,0
35400,2019-09-21,260,0,260,20,280,280,0,0
35401,2019-09-21,260,0,260,20,280,280,0,0
35402,2019-09-21,528,0,528,42,570,570,0,0
35403,2019-09-21,445,0,445,35,480,480,0,0
35404,2019-09-21,704,0,704,56,760,760,0,0
35405,2019-09-21,362,0,362,28,390,390,0,0
35406,2019-09-21,139,0,139,11,150,150,0,0
35407,2019-09-21,343,0,343,27,370,370,0,0
35408,2019-09-21,1112,0,1112,88,1200,1200,0,0
35409,2019-09-21,260,0,260,20,280,280,0,0
35410,2019-09-21,1973,0,1973,157,2130,2130,0,0
35411,2019-09-21,1740,0,1740,130,1870,1870,0,0
35412,2019-09-21,1399,0,1399,111,1510,1510,0,0
35413,2019-09-21,1056,0,1056,84,1140,1140,0,0
35414,2019-09-21,139,0,139,11,150,150,0,0
35415,2019-09-21,186,0,186,14,200,200,0,0
35416,2019-09-21,234,-25,209,16,225,225,0,0
35417,2019-09-21,667,0,667,53,720,720,0,0
35418,2019-09-21,2760,0,2760,220,2980,2980,0,0
35419,2019-09-21,1065,0,1065,85,1150,0,1150,0
35420,2019-09-21,760,0,760,60,820,820,0,0
35421,2019-09-21,565,0,565,45,610,610,0,0
35422,2019-09-21,963,0,963,77,1040,1040,0,0
35423,2019-09-21,315,0,315,25,340,340,0,0
35424,2019-09-21,334,0,334,26,360,360,0,0
35425,2019-09-21,426,0,426,34,460,460,0,0
35426,2019-09-21,334,0,334,26,360,360,0,0
35427,2019-09-21,593,0,593,47,640,640,0,0
35428,2019-09-21,1473,0,1473,117,1590,0,1590,0
35429,2019-09-21,167,0,167,13,180,180,0,0
35430,2019-09-21,241,0,241,19,260,260,0,0
35431,2019-09-21,612,0,612,48,660,660,0,0
35432,2019-09-21,1130,0,1130,90,1220,1220,0,0
35433,2019-09-21,723,0,723,57,780,780,0,0
35434,2019-09-21,917,0,917,73,990,990,0,0
35435,2019-09-21,926,0,926,74,1000,1000,0,0
35436,2019-09-21,110,0,110,0,110,0,110,0
35437,2019-09-21,362,0,362,28,390,390,0,0
35438,2019-09-21,1075,0,1075,85,1160,1160,0,0
35439,2019-09-21,277,0,277,13,290,0,0,290
35440,2019-09-21,426,0,426,34,460,460,0,0
35441,2019-09-21,915,-98,817,65,882,0,0,882
35442,2019-09-21,954,0,954,76,1030,1030,0,0
35443,2019-09-21,667,0,667,53,720,720,0,0
35444,2019-09-21,1575,0,1575,125,1700,1700,0,0
35445,2019-09-21,899,0,899,71,970,970,0,0
35446,2019-09-21,389,0,389,31,420,420,0,0
35447,2019-09-21,953,0,953,67,1020,1020,0,0
35448,2019-09-21,278,0,278,22,300,300,0,0
35449,2019-09-21,1019,0,1019,81,1100,1100,0,0
35450,2019-09-21,2251,0,2251,179,2430,2430,0,0
35451,2019-09-21,473,0,473,37,510,510,0,0
35452,2019-09-21,630,0,630,50,680,680,0,0
35453,2019-09-21,556,0,556,44,600,600,0,0
35454,2019-09-21,389,0,389,31,420,420,0,0
35455,2019-09-21,621,0,621,49,670,670,0,0
35456,2019-09-21,889,0,889,71,960,960,0,0
35457,2019-09-21,232,0,232,18,250,250,0,0
35458,2019-09-21,509,0,509,31,540,540,0,0
35459,2019-09-21,3149,0,3149,251,3400,3400,0,0
35460,2019-09-21,232,0,232,18,250,250,0,0
35461,2019-09-21,501,0,501,39,540,540,0,0
35462,2019-09-21,1065,0,1065,85,1150,1150,0,0
35463,2019-09-21,2639,0,2639,211,2850,2850,0,0
35464,2019-09-21,288,0,288,22,310,310,0,0
35465,2019-09-21,1575,0,1575,125,1700,1700,0,0
35466,2019-09-21,1575,0,1575,125,1700,1700,0,0
35467,2019-09-21,788,0,788,62,850,0,850,0
35468,2019-09-21,1065,0,1065,85,1150,0,1150,0
35469,2019-09-21,954,0,954,76,1030,1030,0,0
35470,2019-09-21,620,0,620,40,660,660,0,0
35471,2019-09-21,1575,0,1575,125,1700,1700,0,0
35472,2019-09-21,2130,0,2130,170,2300,2300,0,0
35473,2019-09-21,1575,0,1575,125,1700,1700,0,0
35474,2019-09-21,584,0,584,46,630,630,0,0
35475,2019-09-21,1575,0,1575,125,1700,1700,0,0
35476,2019-09-21,936,0,936,74,1010,1010,0,0
35477,2019-09-21,1575,0,1575,125,1700,1700,0,0
35478,2019-09-21,334,0,334,26,360,360,0,0
35479,2019-09-21,712,0,712,48,760,0,0,760
35480,2019-09-21,278,0,278,22,300,300,0,0
35481,2019-09-21,788,0,788,62,850,850,0,0
35482,2019-09-21,788,0,788,62,850,850,0,0
35483,2019-09-21,1129,0,1129,81,1210,1210,0,0
35484,2019-09-21,278,0,278,22,300,300,0,0
35485,2019-09-21,1575,0,1575,125,1700,1700,0,0
35486,2019-09-21,1175,0,1175,85,1260,0,1260,0
35487,2019-09-21,181,0,181,14,195,195,0,0
35488,2019-09-21,473,0,473,37,510,510,0,0
35489,2019-09-21,343,0,343,27,370,370,0,0
35490,2019-09-21,491,0,491,39,530,530,0,0
35491,2019-09-21,2213,0,2213,177,2390,2390,0,0
35492,2019-09-21,1510,0,1510,120,1630,0,1630,0
35493,2019-09-22,973,0,973,77,1050,1050,0,0
35494,2019-09-22,981,-105,876,69,945,945,0,0
35495,2019-09-22,-973,0,-973,-77,-1050,-1050,0,0
35496,2019-09-22,1667,0,1667,133,1800,1800,0,0
35497,2019-09-22,399,0,399,31,430,430,0,0
35498,2019-09-22,954,0,954,76,1030,1030,0,0
35499,2019-09-22,1593,0,1593,127,1720,1720,0,0
35500,2019-09-22,1010,0,1010,80,1090,1090,0,0
35501,2019-09-22,908,0,908,72,980,980,0,0
35502,2019-09-22,704,0,704,56,760,760,0,0
35503,2019-09-22,426,0,426,34,460,460,0,0
35504,2019-09-22,908,0,908,72,980,980,0,0
35505,2019-09-22,672,-72,600,48,648,648,0,0
35506,2019-09-22,1629,0,1629,121,1750,1750,0,0
35507,2019-09-22,536,0,536,34,570,570,0,0
35508,2019-09-22,408,0,408,32,440,440,0,0
35509,2019-09-22,2334,0,2334,186,2520,2520,0,0
35510,2019-09-22,593,0,593,47,640,0,0,640
35511,2019-09-22,1667,0,1667,133,1800,1800,0,0
35512,2019-09-22,1010,0,1010,80,1090,1090,0,0
35513,2019-09-22,908,0,908,72,980,980,0,0
35514,2019-09-22,1371,0,1371,109,1480,0,1480,0
35515,2019-09-22,760,0,760,60,820,0,0,820
35516,2019-09-22,1575,0,1575,125,1700,1700,0,0
35517,2019-09-22,825,0,825,65,890,890,0,0
35518,2019-09-22,528,0,528,42,570,570,0,0
35519,2019-09-22,278,0,278,22,300,300,0,0
35520,2019-09-22,667,0,667,53,720,720,0,0
35521,2019-09-22,371,0,371,29,400,400,0,0
35522,2019-09-22,963,0,963,77,1040,1040,0,0
35523,2019-09-22,167,0,167,13,180,180,0,0
35524,2019-09-22,1575,0,1575,125,1700,0,1700,0
35525,2019-09-22,417,0,417,33,450,450,0,0
35526,2019-09-22,1399,0,1399,111,1510,1510,0,0
35527,2019-09-22,1587,-170,1417,113,1530,1530,0,0
35528,2019-09-22,945,0,945,75,1020,1020,0,0
35529,2019-09-22,991,0,991,79,1070,1070,0,0
35530,2019-09-22,510,0,510,40,550,550,0,0
35531,2019-09-22,834,0,834,66,900,900,0,0
35532,2019-09-22,1371,0,1371,109,1480,1480,0,0
35533,2019-09-22,676,0,676,54,730,0,730,0
35534,2019-09-22,510,0,510,40,550,550,0,0
35535,2019-09-22,112,0,112,8,120,120,0,0
35536,2019-09-22,-1575,0,-1575,-125,-1700,0,-1700,0
35537,2019-09-22,602,0,602,48,650,650,0,0
35538,2019-09-22,1260,0,1260,100,1360,1360,0,0
35539,2019-09-22,825,0,825,65,890,890,0,0
35540,2019-09-22,862,0,862,68,930,930,0,0
35541,2019-09-22,1251,0,1251,99,1350,1350,0,0
35542,2019-09-22,745,-79,666,45,711,711,0,0
35543,2019-09-22,2019,0,2019,161,2180,2180,0,0
35544,2019-09-22,880,0,880,70,950,0,950,0
35545,2019-09-22,1323,0,1323,97,1420,0,1420,0
35546,2019-09-22,-1323,0,-1323,-97,-1420,0,-1420,0
35547,2019-09-22,1333,-142,1191,87,1278,0,1278,0
35548,2019-09-22,260,0,260,20,280,280,0,0
35549,2019-09-22,760,0,760,60,820,820,0,0
35550,2019-09-22,288,0,288,22,310,0,0,310
35551,2019-09-22,555,0,555,35,590,590,0,0
35552,2019-09-22,2723,0,2723,217,2940,2940,0,0
35553,2019-09-22,315,0,315,25,340,340,0,0
35554,2019-09-22,1945,0,1945,155,2100,2100,0,0
35555,2019-09-22,176,0,176,14,190,190,0,0
35556,2019-09-22,269,0,269,21,290,290,0,0
35557,2019-09-22,602,0,602,48,650,650,0,0
35558,2019-09-22,825,0,825,65,890,890,0,0
35559,2019-09-22,371,0,371,29,400,400,0,0
35560,2019-09-22,945,0,945,75,1020,1020,0,0
35561,2019-09-22,1102,0,1102,88,1190,1190,0,0
35562,2019-09-22,575,0,575,45,620,620,0,0
35563,2019-09-22,1121,0,1121,89,1210,1210,0,0
35564,2019-09-22,575,0,575,45,620,620,0,0
35565,2019-09-22,1001,0,1001,79,1080,1080,0,0
35566,2019-09-22,3092,0,3092,238,3330,3330,0,0
35567,2019-09-22,223,0,223,17,240,240,0,0
35568,2019-09-22,1899,0,1899,151,2050,0,2050,0
35569,2019-09-22,139,0,139,11,150,150,0,0
35570,2019-09-22,445,0,445,35,480,480,0,0
35571,2019-09-22,712,0,712,48,760,760,0,0
35572,2019-09-22,463,0,463,37,500,0,500,0
35573,2019-09-22,593,0,593,47,640,640,0,0
35574,2019-09-22,3630,0,3630,290,3920,0,3920,0
35575,2019-09-22,758,0,758,42,800,800,0,0
35576,2019-09-22,297,0,297,23,320,320,0,0
35577,2019-09-22,899,0,899,71,970,970,0,0
35578,2019-09-22,963,0,963,77,1040,1040,0,0
35579,2019-09-22,232,0,232,18,250,250,0,0
35580,2019-09-22,1028,0,1028,82,1110,1110,0,0
35581,2019-09-22,630,0,630,50,680,680,0,0
35582,2019-09-22,1278,0,1278,102,1380,1380,0,0
35583,2019-09-22,343,0,343,27,370,370,0,0
35584,2019-09-22,639,0,639,51,690,690,0,0
35585,2019-09-22,954,0,954,76,1030,1030,0,0
35586,2019-09-22,269,0,269,21,290,290,0,0
35587,2019-09-22,806,0,806,64,870,870,0,0
35588,2019-09-22,556,0,556,44,600,600,0,0
35589,2019-09-22,880,0,880,70,950,950,0,0
35590,2019-09-22,260,0,260,20,280,280,0,0
35591,2019-09-22,362,0,362,28,390,390,0,0
35592,2019-09-22,686,0,686,54,740,740,0,0
35593,2019-09-22,519,0,519,41,560,560,0,0
35594,2019-09-22,862,0,862,68,930,930,0,0
35595,2019-09-22,352,0,352,28,380,380,0,0
35596,2019-09-22,741,0,741,59,800,800,0,0
35597,2019-09-22,1871,0,1871,149,2020,2020,0,0
35598,2019-09-22,417,0,417,33,450,450,0,0
35599,2019-09-22,186,0,186,14,200,200,0,0
35600,2019-09-22,389,0,389,31,420,420,0,0
35601,2019-09-22,260,0,260,20,280,280,0,0
35602,2019-09-22,297,0,297,23,320,320,0,0
35603,2019-09-22,788,0,788,62,850,850,0,0
35604,2019-09-22,121,0,121,9,130,130,0,0
35605,2019-09-22,686,0,686,54,740,740,0,0
35606,2019-09-22,1343,0,1343,107,1450,1450,0,0
35607,2019-09-22,593,0,593,47,640,640,0,0
35608,2019-09-22,232,0,232,18,250,250,0,0
35609,2019-09-22,232,0,232,18,250,250,0,0
35610,2019-09-22,1223,0,1223,97,1320,1320,0,0
35611,2019-09-22,463,0,463,37,500,500,0,0
35612,2019-09-22,426,0,426,34,460,460,0,0
35613,2019-09-22,343,0,343,27,370,370,0,0
35614,2019-09-22,713,0,713,57,770,770,0,0
35615,2019-09-22,2260,0,2260,180,2440,2440,0,0
35616,2019-09-22,1815,0,1815,145,1960,1960,0,0
35617,2019-09-22,672,-72,600,48,648,0,648,0
35618,2019-09-22,880,0,880,70,950,950,0,0
35619,2019-09-22,547,0,547,43,590,590,0,0
35620,2019-09-22,260,0,260,20,280,280,0,0
35621,2019-09-22,741,0,741,59,800,800,0,0
35622,2019-09-22,880,0,880,70,950,950,0,0
35623,2019-09-22,945,0,945,75,1020,1020,0,0
35624,2019-09-22,658,0,658,52,710,710,0,0
35625,2019-09-22,232,0,232,18,250,250,0,0
35626,2019-09-22,380,0,380,30,410,410,0,0
35627,2019-09-22,1889,0,1889,151,2040,2040,0,0
35628,2019-09-22,2056,0,2056,164,2220,2220,0,0
35629,2019-09-22,186,0,186,14,200,200,0,0
35630,2019-09-22,116,0,116,9,125,125,0,0
35631,2019-09-22,519,0,519,41,560,560,0,0
35632,2019-09-22,278,0,278,22,300,300,0,0
35633,2019-09-22,334,0,334,26,360,360,0,0
35634,2019-09-22,352,0,352,28,380,380,0,0
35635,2019-09-22,380,0,380,30,410,410,0,0
35636,2019-09-22,1056,0,1056,84,1140,1140,0,0
35637,2019-09-22,593,0,593,47,640,640,0,0
35638,2019-09-22,547,0,547,43,590,590,0,0
35639,2019-09-22,1575,0,1575,125,1700,1700,0,0
35640,2019-09-22,862,0,862,68,930,930,0,0
35641,2019-09-22,982,0,982,78,1060,1060,0,0
35642,2019-09-22,1260,0,1260,100,1360,1360,0,0
35643,2019-09-22,741,0,741,59,800,800,0,0
35644,2019-09-22,1269,0,1269,101,1370,1370,0,0
35645,2019-09-22,538,0,538,42,580,580,0,0
35646,2019-09-22,2186,0,2186,174,2360,2360,0,0
35647,2019-09-22,973,0,973,77,1050,1050,0,0
35648,2019-09-22,334,0,334,26,360,360,0,0
35649,2019-09-22,1575,0,1575,125,1700,1700,0,0
35650,2019-09-22,778,0,778,62,840,840,0,0
35651,2019-09-22,1019,0,1019,81,1100,1100,0,0
35652,2019-09-22,2093,0,2093,167,2260,0,2260,0
35653,2019-09-22,788,0,788,62,850,850,0,0
35654,2019-09-22,1694,0,1694,126,1820,1820,0,0
35655,2019-09-22,269,0,269,21,290,290,0,0
35656,2019-09-22,1575,0,1575,125,1700,0,1700,0
35657,2019-09-22,38,0,38,2,40,40,0,0
35658,2019-09-22,620,0,620,40,660,660,0,0
35659,2019-09-22,1575,0,1575,125,1700,1700,0,0
35660,2019-09-22,1334,0,1334,106,1440,1440,0,0
35661,2019-09-22,352,0,352,28,380,0,380,0
35662,2019-09-22,806,0,806,64,870,870,0,0
35663,2019-09-22,1575,0,1575,125,1700,1700,0,0
35664,2019-09-22,1334,0,1334,106,1440,1440,0,0
35665,2019-09-22,1065,0,1065,85,1150,0,0,1150
35666,2019-09-22,1315,0,1315,105,1420,1420,0,0
35667,2019-09-22,788,0,788,62,850,850,0,0
35668,2019-09-22,315,0,315,25,340,340,0,0
35669,2019-09-22,1065,0,1065,85,1150,1150,0,0
35670,2019-09-22,1575,0,1575,125,1700,1700,0,0
35671,2019-09-22,181,0,181,14,195,195,0,0
35672,2019-09-22,556,0,556,44,600,600,0,0
35673,2019-09-22,1575,0,1575,125,1700,1700,0,0
35674,2019-09-22,991,0,991,79,1070,1070,0,0
35675,2019-09-22,1167,0,1167,93,1260,1260,0,0
35676,2019-09-22,1630,0,1630,130,1760,1760,0,0
35677,2019-09-22,1629,0,1629,121,1750,1750,0,0
35678,2019-09-22,908,0,908,72,980,980,0,0
35679,2019-09-22,1575,0,1575,125,1700,1700,0,0
35680,2019-09-22,973,0,973,77,1050,1050,0,0
35681,2019-09-22,658,0,658,52,710,710,0,0
35682,2019-09-22,723,0,723,57,780,780,0,0
35683,2019-09-23,760,0,760,60,820,820,0,0
35684,2019-09-23,760,0,760,60,820,820,0,0
35685,2019-09-23,389,0,389,31,420,420,0,0
35686,2019-09-23,880,0,880,70,950,950,0,0
35687,2019-09-23,2454,0,2454,196,2650,2650,0,0
35688,2019-09-23,-639,0,-639,-51,-690,-690,0,0
35689,2019-09-23,426,0,426,34,460,460,0,0
35690,2019-09-23,908,0,908,72,980,980,0,0
35691,2019-09-23,1388,0,1388,102,1490,0,1490,0
35692,2019-09-23,630,0,630,50,680,680,0,0
35693,2019-09-23,741,0,741,59,800,800,0,0
35694,2019-09-23,402,-43,359,28,387,387,0,0
35695,2019-09-23,944,0,944,66,1010,1010,0,0
35696,2019-09-23,366,0,366,29,395,395,0,0
35697,2019-09-23,908,0,908,72,980,980,0,0
35698,2019-09-23,1084,0,1084,86,1170,1170,0,0
35699,2019-09-23,1473,0,1473,117,1590,1590,0,0
35700,2019-09-23,510,0,510,40,550,550,0,0
35701,2019-09-23,417,0,417,33,450,450,0,0
35702,2019-09-23,667,0,667,53,720,720,0,0
35703,2019-09-23,667,0,667,53,720,720,0,0
35704,2019-09-23,862,0,862,68,930,930,0,0
35705,2019-09-23,704,0,704,56,760,760,0,0
35706,2019-09-23,788,0,788,62,850,850,0,0
35707,2019-09-23,852,0,852,68,920,920,0,0
35708,2019-09-23,1121,0,1121,89,1210,0,1210,0
35709,2019-09-23,473,0,473,37,510,510,0,0
35710,2019-09-23,1398,0,1398,102,1500,1500,0,0
35711,2019-09-23,389,0,389,31,420,420,0,0
35712,2019-09-23,269,0,269,21,290,290,0,0
35713,2019-09-23,908,0,908,72,980,980,0,0
35714,2019-09-23,908,0,908,72,980,980,0,0
35715,2019-09-23,1001,0,1001,79,1080,1080,0,0
35716,2019-09-23,1815,0,1815,145,1960,1960,0,0
35717,2019-09-23,454,0,454,36,490,490,0,0
35718,2019-09-23,1723,0,1723,137,1860,1860,0,0
35719,2019-09-23,1649,0,1649,131,1780,1780,0,0
35720,2019-09-23,528,0,528,42,570,570,0,0
35721,2019-09-23,945,0,945,75,1020,0,1020,0
35722,2019-09-23,241,0,241,19,260,260,0,0
35723,2019-09-23,241,0,241,19,260,260,0,0
35724,2019-09-23,250,0,250,20,270,270,0,0
35725,2019-09-23,362,0,362,28,390,390,0,0
35726,2019-09-23,538,0,538,42,580,580,0,0
35727,2019-09-23,482,0,482,38,520,520,0,0
35728,2019-09-23,334,0,334,26,360,360,0,0
35729,2019-09-23,1704,0,1704,136,1840,1840,0,0
35730,2019-09-23,1010,0,1010,80,1090,1090,0,0
35731,2019-09-23,195,0,195,15,210,210,0,0
35732,2019-09-23,271,-29,242,19,261,261,0,0
35733,2019-09-23,639,0,639,51,690,690,0,0
35734,2019-09-23,973,0,973,77,1050,1050,0,0
35735,2019-09-23,908,0,908,72,980,980,0,0
35736,2019-09-23,908,0,908,72,980,980,0,0
35737,2019-09-23,602,0,602,48,650,650,0,0
35738,2019-09-23,686,0,686,54,740,740,0,0
35739,2019-09-23,2389,0,2389,191,2580,2580,0,0
35740,2019-09-23,797,0,797,63,860,860,0,0
35741,2019-09-23,834,0,834,66,900,0,900,0
35742,2019-09-23,908,0,908,72,980,980,0,0
35743,2019-09-23,501,0,501,39,540,540,0,0
35744,2019-09-23,519,0,519,41,560,560,0,0
35745,2019-09-23,528,0,528,42,570,570,0,0
35746,2019-09-23,908,0,908,72,980,980,0,0
35747,2019-09-23,297,0,297,23,320,320,0,0
35748,2019-09-23,519,0,519,41,560,560,0,0
35749,2019-09-23,908,0,908,72,980,980,0,0
35750,2019-09-23,334,0,334,26,360,360,0,0
35751,2019-09-23,889,0,889,71,960,960,0,0
35752,2019-09-23,1501,0,1501,119,1620,1620,0,0
35753,2019-09-23,528,0,528,42,570,570,0,0
35754,2019-09-23,908,0,908,72,980,980,0,0
35755,2019-09-23,788,0,788,62,850,850,0,0
35756,2019-09-23,482,0,482,38,520,520,0,0
35757,2019-09-23,260,0,260,20,280,280,0,0
35758,2019-09-23,389,0,389,31,420,420,0,0
35759,2019-09-23,445,0,445,35,480,480,0,0
35760,2019-09-23,1973,0,1973,157,2130,2130,0,0
35761,2019-09-23,556,0,556,44,600,600,0,0
35762,2019-09-23,769,0,769,61,830,830,0,0
35763,2019-09-23,528,0,528,42,570,570,0,0
35764,2019-09-23,575,0,575,45,620,620,0,0
35765,2019-09-23,454,0,454,36,490,490,0,0
35766,2019-09-23,269,0,269,21,290,290,0,0
35767,2019-09-23,436,0,436,34,470,470,0,0
35768,2019-09-23,565,-120,445,35,480,480,0,0
35769,2019-09-23,334,0,334,26,360,360,0,0
35770,2019-09-23,612,0,612,48,660,0,0,660
35771,2019-09-23,1343,0,1343,107,1450,1450,0,0
35772,2019-09-23,778,0,778,62,840,840,0,0
35773,2019-09-23,667,0,667,53,720,720,0,0
35774,2019-09-23,1565,0,1565,125,1690,1690,0,0
35775,2019-09-23,260,0,260,20,280,280,0,0
35776,2019-09-23,1047,0,1047,83,1130,0,1130,0
35777,2019-09-23,399,0,399,31,430,430,0,0
35778,2019-09-23,1325,0,1325,105,1430,1430,0,0
35779,2019-09-23,1028,0,1028,82,1110,1110,0,0
35780,2019-09-23,2241,0,2241,179,2420,2420,0,0
35781,2019-09-23,797,0,797,63,860,860,0,0
35782,2019-09-23,565,0,565,45,610,610,0,0
35783,2019-09-23,612,0,612,48,660,660,0,0
35784,2019-09-23,130,0,130,10,140,140,0,0
35785,2019-09-23,277,0,277,13,290,290,0,0
35786,2019-09-23,389,0,389,31,420,420,0,0
35787,2019-09-23,399,0,399,31,430,430,0,0
35788,2019-09-23,1260,0,1260,100,1360,1360,0,0
35789,2019-09-23,926,0,926,74,1000,1000,0,0
35790,2019-09-23,389,0,389,31,420,420,0,0
35791,2019-09-23,269,0,269,21,290,290,0,0
35792,2019-09-23,112,0,112,8,120,120,0,0
35793,2019-09-23,834,0,834,66,900,900,0,0
35794,2019-09-23,1584,0,1584,126,1710,1710,0,0
35795,2019-09-23,371,0,371,29,400,400,0,0
35796,2019-09-23,426,0,426,34,460,460,0,0
35797,2019-09-23,1575,0,1575,125,1700,1700,0,0
35798,2019-09-23,269,0,269,21,290,290,0,0
35799,2019-09-23,788,0,788,62,850,850,0,0
35800,2019-09-23,1575,0,1575,125,1700,0,1700,0
35801,2019-09-23,834,0,834,66,900,900,0,0
35802,2019-09-23,1575,0,1575,125,1700,1700,0,0
35803,2019-09-23,491,0,491,39,530,530,0,0
35804,2019-09-23,1575,0,1575,125,1700,1700,0,0
35805,2019-09-23,352,0,352,28,380,380,0,0
35806,2019-09-23,501,0,501,39,540,540,0,0
35807,2019-09-23,667,0,667,53,720,720,0,0
35808,2019-09-23,1575,0,1575,125,1700,0,0,1700
35809,2019-09-23,695,0,695,55,750,750,0,0
35810,2019-09-23,371,0,371,29,400,400,0,0
35811,2019-09-23,760,0,760,60,820,820,0,0
35812,2019-09-23,1575,0,1575,125,1700,0,1700,0
35813,2019-09-23,352,0,352,28,380,380,0,0
35814,2019-09-23,880,0,880,70,950,950,0,0
35815,2019-09-23,538,0,538,42,580,580,0,0
35816,2019-09-23,408,0,408,32,440,440,0,0
35817,2019-09-23,667,0,667,53,720,720,0,0
35818,2019-09-23,565,0,565,45,610,610,0,0
35819,2019-09-23,234,-25,209,16,225,225,0,0
35820,2019-09-23,1232,0,1232,98,1330,1330,0,0
35821,2019-09-23,1195,0,1195,95,1290,1290,0,0
35822,2019-09-23,445,0,445,35,480,480,0,0
35823,2019-09-23,788,0,788,62,850,850,0,0
35824,2019-09-23,788,0,788,62,850,850,0,0
35825,2019-09-23,936,0,936,74,1010,0,0,1010
35826,2019-09-23,352,0,352,28,380,380,0,0
35827,2019-09-23,269,0,269,21,290,290,0,0
35828,2019-09-24,538,0,538,42,580,580,0,0
35829,2019-09-24,1176,0,1176,94,1270,1270,0,0
35830,2019-09-24,482,0,482,38,520,520,0,0
35831,2019-09-24,1713,0,1713,137,1850,1850,0,0
35832,2019-09-24,1038,0,1038,82,1120,1120,0,0
35833,2019-09-24,945,0,945,75,1020,1020,0,0
35834,2019-09-24,121,0,121,9,130,130,0,0
35835,2019-09-24,260,0,260,20,280,280,0,0
35836,2019-09-24,334,0,334,26,360,360,0,0
35837,2019-09-24,501,0,501,39,540,540,0,0
35838,2019-09-24,278,0,278,22,300,300,0,0
35839,2019-09-24,334,0,334,26,360,0,360,0
35840,2019-09-24,271,-29,242,19,261,261,0,0
35841,2019-09-24,463,0,463,37,500,500,0,0
35842,2019-09-24,778,0,778,62,840,840,0,0
35843,2019-09-24,704,0,704,56,760,760,0,0
35844,2019-09-24,1436,0,1436,114,1550,1550,0,0
35845,2019-09-24,333,0,333,17,350,350,0,0
35846,2019-09-24,1203,0,1203,87,1290,1290,0,0
35847,2019-09-24,593,0,593,47,640,640,0,0
35848,2019-09-24,462,0,462,28,490,490,0,0
35849,2019-09-24,889,0,889,71,960,960,0,0
35850,2019-09-24,371,0,371,29,400,0,400,0
35851,2019-09-24,806,0,806,64,870,870,0,0
35852,2019-09-24,477,0,477,38,515,515,0,0
35853,2019-09-24,1815,0,1815,145,1960,0,0,1960
35854,2019-09-24,1186,0,1186,94,1280,1280,0,0
35855,2019-09-24,102,0,102,8,110,110,0,0
35856,2019-09-24,491,0,491,39,530,530,0,0
35857,2019-09-24,371,0,371,29,400,400,0,0
35858,2019-09-24,209,0,209,16,225,225,0,0
35859,2019-09-24,908,0,908,72,980,980,0,0
35860,2019-09-24,649,0,649,51,700,700,0,0
35861,2019-09-24,943,0,943,57,1000,1000,0,0
35862,2019-09-24,362,0,362,28,390,390,0,0
35863,2019-09-24,1139,0,1139,91,1230,1230,0,0
35864,2019-09-24,2399,0,2399,191,2590,2590,0,0
35865,2019-09-24,778,0,778,62,840,840,0,0
35866,2019-09-25,501,0,501,40,541,541,0,0
35867,2019-09-25,714,0,714,57,771,771,0,0
35868,2019-09-25,167,-33,134,10,144,0,0,144
35869,2019-09-25,650,0,650,52,702,702,0,0
35870,2019-09-25,112,0,112,8,120,120,0,0
35871,2019-09-25,1814,0,1814,145,1959,1959,0,0
35872,2019-09-25,494,0,494,39,533,533,0,0
35873,2019-09-25,306,0,306,24,330,330,0,0
35874,2019-09-25,455,0,455,36,491,491,0,0
35875,2019-09-25,687,0,687,54,741,741,0,0
35876,2019-09-25,-816,0,-816,-65,-881,-881,0,0
35877,2019-09-25,816,0,816,65,881,881,0,0
35878,2019-09-25,538,0,538,43,581,0,0,581
35879,2019-09-25,2334,0,2334,186,2520,2520,0,0
35880,2019-09-25,2104,0,2104,168,2272,2272,0,0
35881,2019-09-25,501,-50,451,36,487,487,0,0
35882,2019-09-25,1074,0,1074,85,1159,1159,0,0
35883,2019-09-25,907,0,907,72,979,979,0,0
35884,2019-09-25,649,0,649,51,700,700,0,0
35885,2019-09-25,992,0,992,79,1071,1071,0,0
35886,2019-09-25,362,0,362,28,390,390,0,0
35887,2019-09-25,1814,0,1814,145,1959,1959,0,0
35888,2019-09-25,1753,0,1753,140,1893,1893,0,0
35889,2019-09-25,139,0,139,11,150,150,0,0
35890,2019-09-25,167,0,167,13,180,180,0,0
35891,2019-09-25,816,0,816,65,881,881,0,0
35892,2019-09-25,529,0,529,42,571,571,0,0
35893,2019-09-25,492,0,492,39,531,531,0,0
35894,2019-09-25,-529,0,-529,-42,-571,-571,0,0
35895,2019-09-25,548,0,548,43,591,591,0,0
35896,2019-09-25,487,0,487,38,525,525,0,0
35897,2019-09-25,687,0,687,54,741,741,0,0
35898,2019-09-25,907,0,907,72,979,979,0,0
35899,2019-09-25,907,0,907,72,979,979,0,0
35900,2019-09-25,445,0,445,35,480,480,0,0
35901,2019-09-25,417,0,417,33,450,450,0,0
35902,2019-09-25,556,0,556,44,600,600,0,0
35903,2019-09-25,557,0,557,44,601,601,0,0
35904,2019-09-25,474,-94,380,30,410,410,0,0
35905,2019-09-25,44444,0,44444,3555,47999,0,47999,0
35906,2019-09-25,649,0,649,51,700,700,0,0
35907,2019-09-25,139,0,139,11,150,150,0,0
35908,2019-09-25,520,0,520,41,561,561,0,0
35909,2019-09-25,465,0,465,37,502,502,0,0
35910,2019-09-25,214,0,214,17,231,231,0,0
35911,2019-09-25,778,0,778,62,840,840,0,0
35912,2019-09-25,214,0,214,17,231,231,0,0
35913,2019-09-25,47,0,47,3,50,50,0,0
35914,2019-09-25,2084,0,2084,166,2250,2250,0,0
35915,2019-09-25,2223,0,2223,177,2400,2400,0,0
35916,2019-09-25,418,0,418,33,451,451,0,0
35917,2019-09-25,687,0,687,54,741,741,0,0
35918,2019-09-25,1095,0,1095,87,1182,1182,0,0
35919,2019-09-25,713,0,713,57,770,770,0,0
35920,2019-09-25,529,0,529,42,571,571,0,0
35921,2019-09-25,511,0,511,40,551,551,0,0
35922,2019-09-25,799,0,799,63,862,862,0,0
35923,2019-09-25,1028,0,1028,82,1110,1110,0,0
35924,2019-09-25,390,0,390,31,421,0,421,0
35925,2019-09-25,1279,0,1279,102,1381,1381,0,0
35926,2019-09-25,1852,0,1852,148,2000,2000,0,0
35927,2019-09-25,1168,0,1168,93,1261,1261,0,0
35928,2019-09-25,825,0,825,66,891,891,0,0
35929,2019-09-25,-529,0,-529,-42,-571,-571,0,0
35930,2019-09-25,47,0,47,7,54,54,0,0
35931,2019-09-25,-501,0,-501,-40,-541,-541,0,0
35932,2019-09-25,-501,0,-501,-40,-541,-541,0,0
35933,2019-09-25,-501,0,-501,-40,-541,-541,0,0
35934,2019-09-25,-370,0,-370,-29,-399,-399,0,0
35935,2019-09-25,-370,0,-370,-29,-399,-399,0,0
35936,2019-09-25,-501,0,-501,-40,-541,-541,0,0
35937,2019-09-25,1574,0,1574,125,1699,1699,0,0
35938,2019-09-25,-1585,0,-1585,-126,-1711,-1711,0,0
35939,2019-09-25,-47,0,-47,-3,-50,-50,0,0
35940,2019-09-25,-47,0,-47,-7,-54,-54,0,0
35941,2019-09-25,529,0,529,42,571,571,0,0
35942,2019-09-25,501,0,501,40,541,541,0,0
35943,2019-09-25,501,0,501,40,541,541,0,0
35944,2019-09-25,501,0,501,40,541,541,0,0
35945,2019-09-25,370,0,370,29,399,399,0,0
35946,2019-09-25,370,0,370,29,399,399,0,0
35947,2019-09-25,501,0,501,40,541,541,0,0
35948,2019-09-25,1585,0,1585,126,1711,1711,0,0
35949,2019-09-25,47,0,47,3,50,50,0,0
35950,2019-09-25,696,0,696,55,751,751,0,0
35951,2019-09-25,-47,0,-47,-3,-50,-50,0,0
35952,2019-09-25,1574,0,1574,125,1699,1699,0,0
35953,2019-09-25,47,0,47,3,50,50,0,0
35954,2019-09-25,648,-64,584,46,630,630,0,0
35955,2019-09-25,882,0,882,70,952,952,0,0
35956,2019-09-25,1169,0,1169,93,1262,1262,0,0
35957,2019-09-25,40,0,40,3,43,43,0,0
35958,2019-09-25,848,0,848,67,915,915,0,0
35959,2019-09-25,-806,0,-806,-64,-870,-870,0,0
35960,2019-09-25,1574,0,1574,125,1699,1699,0,0
35961,2019-09-25,1574,0,1574,125,1699,1699,0,0
35962,2019-09-25,1574,0,1574,125,1699,1699,0,0
35963,2019-09-25,697,0,697,55,752,752,0,0
35964,2019-09-25,2159,0,2159,172,2331,0,2331,0
35965,2019-09-25,648,0,648,51,699,699,0,0
35966,2019-09-25,232,-23,209,16,225,225,0,0
35967,2019-09-25,899,0,899,71,970,970,0,0
35968,2019-09-25,685,0,685,54,739,739,0,0
35969,2019-09-25,537,0,537,42,579,579,0,0
35970,2019-09-25,1118,0,1118,89,1207,1207,0,0
35971,2019-09-25,139,0,139,11,150,150,0,0
35972,2019-09-25,1020,0,1020,81,1101,1101,0,0
35973,2019-09-25,806,0,806,64,870,870,0,0
35974,2019-09-25,603,0,603,48,651,651,0,0
35975,2019-09-25,1336,0,1336,106,1442,1442,0,0
35976,2019-09-25,787,0,787,62,849,849,0,0
35977,2019-09-25,1455,0,1455,116,1571,1571,0,0
35978,2019-09-25,1214,0,1214,97,1311,1311,0,0
35979,2019-09-25,409,0,409,32,441,441,0,0
35980,2019-09-25,787,0,787,62,849,849,0,0
35981,2019-09-25,852,0,852,68,920,920,0,0
35982,2019-09-26,1215,0,1215,97,1312,1312,0,0
35983,2019-09-26,640,0,640,51,691,691,0,0
35984,2019-09-26,456,0,456,36,492,492,0,0
35985,2019-09-26,446,0,446,35,481,481,0,0
35986,2019-09-26,501,0,501,40,541,541,0,0
35987,2019-09-26,761,0,761,60,821,821,0,0
35988,2019-09-26,1095,0,1095,87,1182,1182,0,0
35989,2019-09-26,538,-53,485,38,523,523,0,0
35990,2019-09-26,167,0,167,13,180,180,0,0
35991,2019-09-26,1400,0,1400,112,1512,1512,0,0
35992,2019-09-26,261,0,261,20,281,281,0,0
35993,2019-09-26,373,0,373,29,402,402,0,0
35994,2019-09-26,907,0,907,72,979,979,0,0
35995,2019-09-26,278,0,278,22,300,300,0,0
35996,2019-09-26,1290,-129,1161,92,1253,1253,0,0
35997,2019-09-26,2721,0,2721,217,2938,2938,0,0
35998,2019-09-26,907,0,907,72,979,979,0,0
35999,2019-09-26,907,0,907,72,979,979,0,0
36000,2019-09-26,371,0,371,29,400,400,0,0
36001,2019-09-26,1814,0,1814,145,1959,1959,0,0
36002,2019-09-26,752,0,752,60,812,812,0,0
36003,2019-09-26,3193,0,3193,255,3448,3448,0,0
36004,2019-09-26,538,0,538,43,581,581,0,0
36005,2019-09-26,686,0,686,54,740,740,0,0
36006,2019-09-26,2014,-201,1813,145,1958,0,1958,0
36007,2019-09-26,278,0,278,22,300,300,0,0
36008,2019-09-26,907,0,907,72,979,979,0,0
36009,2019-09-26,882,0,882,70,952,952,0,0
36010,2019-09-26,1814,0,1814,145,1959,1959,0,0
36011,2019-09-26,907,0,907,72,979,979,0,0
36012,2019-09-26,363,0,363,29,392,392,0,0
36013,2019-09-26,596,0,596,47,643,643,0,0
36014,2019-09-26,436,0,436,34,470,470,0,0
36015,2019-09-26,325,0,325,26,351,351,0,0
36016,2019-09-26,762,0,762,60,822,822,0,0
36017,2019-09-26,1814,0,1814,145,1959,1959,0,0
36018,2019-09-26,1159,0,1159,92,1251,1251,0,0
36019,2019-09-26,1226,0,1226,98,1324,1324,0,0
36020,2019-09-26,788,0,788,63,851,851,0,0
36021,2019-09-26,669,0,669,53,722,722,0,0
36022,2019-09-26,363,0,363,29,392,392,0,0
36023,2019-09-26,1814,0,1814,145,1959,1959,0,0
36024,2019-09-26,584,0,584,46,630,630,0,0
36025,2019-09-26,547,0,547,43,590,590,0,0
36026,2019-09-26,723,0,723,57,780,0,780,0
36027,2019-09-26,483,0,483,38,521,521,0,0
36028,2019-09-26,418,0,418,33,451,451,0,0
36029,2019-09-26,705,0,705,56,761,761,0,0
36030,2019-09-26,381,0,381,30,411,411,0,0
36031,2019-09-26,445,0,445,35,480,0,480,0
36032,2019-09-26,770,0,770,61,831,831,0,0
36033,2019-09-26,260,0,260,20,280,280,0,0
36034,2019-09-26,1814,0,1814,145,1959,1959,0,0
36035,2019-09-26,1814,0,1814,145,1959,0,1959,0
36036,2019-09-26,907,0,907,72,979,979,0,0
36037,2019-09-26,558,0,558,44,602,602,0,0
36038,2019-09-26,901,0,901,72,973,973,0,0
36039,2019-09-26,612,0,612,48,660,660,0,0
36040,2019-09-26,787,0,787,62,849,849,0,0
36041,2019-09-26,1574,0,1574,125,1699,1699,0,0
36042,2019-09-26,787,0,787,62,849,0,849,0
36043,2019-09-26,334,0,334,26,360,360,0,0
36044,2019-09-26,733,0,733,58,791,791,0,0
36045,2019-09-26,362,0,362,28,390,390,0,0
36046,2019-09-26,873,0,873,69,942,942,0,0
36047,2019-09-26,520,0,520,41,561,561,0,0
36048,2019-09-26,1039,0,1039,83,1122,1122,0,0
36049,2019-09-26,1112,0,1112,88,1200,1200,0,0
36050,2019-09-26,2319,0,2319,185,2504,0,2504,0
36051,2019-09-26,806,0,806,64,870,870,0,0
36052,2019-09-26,204,0,204,16,220,220,0,0
36053,2019-09-26,1038,0,1038,83,1121,1121,0,0
36054,2019-09-26,957,0,957,76,1033,1033,0,0
36055,2019-09-26,797,0,797,63,860,0,0,860
36056,2019-09-26,307,0,307,24,331,331,0,0
36057,2019-09-26,741,0,741,59,800,800,0,0
36058,2019-09-26,778,0,778,62,840,840,0,0
36059,2019-09-26,371,0,371,29,400,400,0,0
36060,2019-09-26,400,0,400,32,432,432,0,0
36061,2019-09-26,595,0,595,47,642,642,0,0
36062,2019-09-26,622,0,622,49,671,671,0,0
36063,2019-09-26,389,0,389,31,420,420,0,0
36064,2019-09-26,1226,0,1226,98,1324,1324,0,0
36065,2019-09-26,1574,0,1574,125,1699,0,1699,0
36066,2019-09-26,501,0,501,40,541,541,0,0
36067,2019-09-26,650,0,650,52,702,702,0,0
36068,2019-09-26,603,0,603,48,651,651,0,0
36069,2019-09-26,778,0,778,62,840,840,0,0
36070,2019-09-26,1574,0,1574,125,1699,1699,0,0
36071,2019-09-26,919,0,919,73,992,992,0,0
36072,2019-09-26,787,-78,709,56,765,765,0,0
36073,2019-09-26,603,0,603,48,651,651,0,0
36074,2019-09-26,631,0,631,50,681,681,0,0
36075,2019-09-26,761,0,761,60,821,821,0,0
36076,2019-09-26,334,-33,301,24,325,325,0,0
36077,2019-09-26,344,0,344,27,371,371,0,0
36078,2019-09-26,954,-95,859,68,927,927,0,0
36079,2019-09-26,391,0,391,31,422,422,0,0
36080,2019-09-26,1336,0,1336,106,1442,1442,0,0
36081,2019-09-26,937,0,937,74,1011,1011,0,0
36082,2019-09-26,705,0,705,56,761,761,0,0
36083,2019-09-26,696,0,696,55,751,751,0,0
36084,2019-09-26,370,0,370,29,399,0,399,0
36085,2019-09-26,668,0,668,53,721,721,0,0
36086,2019-09-26,630,0,630,50,680,680,0,0
36087,2019-09-26,787,0,787,62,849,849,0,0
36088,2019-09-26,139,0,139,11,150,150,0,0
36089,2019-09-26,269,0,269,21,290,290,0,0
36090,2019-09-26,214,0,214,17,231,231,0,0
36091,2019-09-26,844,0,844,67,911,911,0,0
36092,2019-09-26,1086,0,1086,86,1172,1172,0,0
36093,2019-09-26,1808,0,1808,144,1952,1952,0,0
36094,2019-09-26,983,0,983,78,1061,1061,0,0
36095,2019-09-26,1574,0,1574,125,1699,1699,0,0
36096,2019-09-27,316,0,316,25,341,341,0,0
36097,2019-09-27,417,0,417,33,450,450,0,0
36098,2019-09-27,715,0,715,57,772,772,0,0
36099,2019-09-27,919,0,919,73,992,992,0,0
36100,2019-09-27,566,0,566,45,611,611,0,0
36101,2019-09-27,510,0,510,40,550,550,0,0
36102,2019-09-27,1355,0,1355,108,1463,1463,0,0
36103,2019-09-27,501,0,501,40,541,541,0,0
36104,2019-09-27,492,0,492,39,531,531,0,0
36105,2019-09-27,455,0,455,36,491,491,0,0
36106,2019-09-27,1512,0,1512,120,1632,1632,0,0
36107,2019-09-27,501,0,501,40,541,541,0,0
36108,2019-09-27,1814,0,1814,145,1959,1959,0,0
36109,2019-09-27,1308,0,1308,104,1412,1412,0,0
36110,2019-09-27,698,0,698,55,753,0,0,753
36111,2019-09-27,816,0,816,65,881,881,0,0
36112,2019-09-27,1542,0,1542,123,1665,1665,0,0
36113,2019-09-27,753,0,753,60,813,813,0,0
36114,2019-09-27,1814,0,1814,145,1959,1959,0,0
36115,2019-09-27,473,-47,426,34,460,460,0,0
36116,2019-09-27,993,0,993,79,1072,1072,0,0
36117,2019-09-27,167,0,167,13,180,180,0,0
36118,2019-09-27,482,0,482,38,520,520,0,0
36119,2019-09-27,2067,0,2067,165,2232,2232,0,0
36120,2019-09-27,695,0,695,55,750,750,0,0
36121,2019-09-27,1177,0,1177,94,1271,1271,0,0
36122,2019-09-27,735,0,735,58,793,793,0,0
36123,2019-09-27,639,0,639,51,690,690,0,0
36124,2019-09-27,1681,0,1681,134,1815,1815,0,0
36125,2019-09-27,483,0,483,38,521,521,0,0
36126,2019-09-27,816,0,816,65,881,881,0,0
36127,2019-09-27,788,0,788,63,851,851,0,0
36128,2019-09-27,520,-52,468,37,505,0,505,0
36129,2019-09-27,483,0,483,38,521,0,521,0
36130,2019-09-27,1814,0,1814,145,1959,1959,0,0
36131,2019-09-27,408,0,408,32,440,440,0,0
36132,2019-09-27,1037,0,1037,82,1119,0,1119,0
36133,2019-09-27,417,0,417,33,450,450,0,0
36134,2019-09-27,112,0,112,8,120,120,0,0
36135,2019-09-27,2078,0,2078,166,2244,2244,0,0
36136,2019-09-27,465,0,465,37,502,502,0,0
36137,2019-09-27,917,0,917,73,990,990,0,0
36138,2019-09-27,907,-90,817,65,882,882,0,0
36139,2019-09-27,492,0,492,39,531,531,0,0
36140,2019-09-27,269,0,269,21,290,290,0,0
36141,2019-09-27,492,0,492,39,531,531,0,0
36142,2019-09-27,790,0,790,63,853,853,0,0
36143,2019-09-27,929,0,929,74,1003,1003,0,0
36144,2019-09-27,567,0,567,45,612,612,0,0
36145,2019-09-27,510,0,510,40,550,550,0,0
36146,2019-09-27,102,0,102,8,110,110,0,0
36147,2019-09-27,491,0,491,39,530,530,0,0
36148,2019-09-27,389,0,389,31,420,420,0,0
36149,2019-09-27,798,0,798,63,861,861,0,0
36150,2019-09-27,593,0,593,47,640,0,0,640
36151,2019-09-27,603,0,603,48,651,651,0,0
36152,2019-09-27,1188,0,1188,95,1283,1283,0,0
36153,2019-09-27,612,0,612,48,660,660,0,0
36154,2019-09-27,306,-30,276,22,298,298,0,0
36155,2019-09-27,251,0,251,20,271,271,0,0
36156,2019-09-27,539,0,539,43,582,582,0,0
36157,2019-09-27,1298,0,1298,103,1401,1401,0,0
36158,2019-09-27,269,0,269,21,290,290,0,0
36159,2019-09-27,1983,0,1983,158,2141,2141,0,0
36160,2019-09-27,900,0,900,72,972,972,0,0
36161,2019-09-27,789,0,789,63,852,852,0,0
36162,2019-09-27,1059,0,1059,84,1143,1143,0,0
36163,2019-09-27,4226,0,4226,338,4564,4564,0,0
36164,2019-09-27,1252,0,1252,100,1352,1352,0,0
36165,2019-09-27,353,0,353,28,381,381,0,0
36166,2019-09-27,418,-41,377,30,407,407,0,0
36167,2019-09-27,779,0,779,62,841,841,0,0
36168,2019-09-27,2690,0,2690,215,2905,2905,0,0
36169,2019-09-27,362,0,362,28,390,390,0,0
36170,2019-09-27,898,0,898,71,969,969,0,0
36171,2019-09-27,139,0,139,11,150,150,0,0
36172,2019-09-27,149,-29,120,9,129,129,0,0
36173,2019-09-27,399,0,399,31,430,430,0,0
36174,2019-09-27,-399,0,-399,-31,-430,-430,0,0
36175,2019-09-27,594,0,594,47,641,641,0,0
36176,2019-09-27,260,0,260,20,280,280,0,0
36177,2019-09-27,269,0,269,21,290,290,0,0
36178,2019-09-27,1354,0,1354,108,1462,1462,0,0
36179,2019-09-27,260,0,260,20,280,280,0,0
36180,2019-09-27,816,0,816,65,881,0,881,0
36181,2019-09-27,584,0,584,46,630,630,0,0
36182,2019-09-27,538,0,538,43,581,581,0,0
36183,2019-09-27,141,0,141,11,152,152,0,0
36184,2019-09-27,1315,0,1315,105,1420,1420,0,0
36185,2019-09-27,334,0,334,26,360,360,0,0
36186,2019-09-27,288,0,288,23,311,311,0,0
36187,2019-09-27,455,0,455,36,491,491,0,0
36188,2019-09-27,260,0,260,20,280,280,0,0
36189,2019-09-27,799,0,799,63,862,862,0,0
36190,2019-09-27,623,0,623,49,672,672,0,0
36191,2019-09-27,926,0,926,74,1000,1000,0,0
36192,2019-09-27,250,0,250,20,270,270,0,0
36193,2019-09-27,613,0,613,49,662,662,0,0
36194,2019-09-27,1633,0,1633,130,1763,1763,0,0
36195,2019-09-27,649,0,649,51,700,700,0,0
36196,2019-09-27,188,0,188,15,203,203,0,0
36197,2019-09-27,1002,0,1002,80,1082,1082,0,0
36198,2019-09-27,141,0,141,11,152,152,0,0
36199,2019-09-27,278,0,278,22,300,0,0,300
36200,2019-09-27,1014,0,1014,81,1095,1095,0,0
36201,2019-09-27,640,0,640,51,691,691,0,0
36202,2019-09-27,834,0,834,66,900,900,0,0
36203,2019-09-27,787,0,787,62,849,849,0,0
36204,2019-09-27,947,0,947,75,1022,1022,0,0
36205,2019-09-27,482,0,482,38,520,520,0,0
36206,2019-09-27,787,0,787,62,849,0,0,849
36207,2019-09-27,1551,0,1551,124,1675,1675,0,0
36208,2019-09-27,1103,0,1103,88,1191,1191,0,0
36209,2019-09-27,2361,0,2361,188,2549,2549,0,0
36210,2019-09-27,769,-76,693,55,748,748,0,0
36211,2019-09-27,501,0,501,40,541,541,0,0
36212,2019-09-27,1584,0,1584,126,1710,1710,0,0
36213,2019-09-27,149,0,149,11,160,160,0,0
36214,2019-09-27,1297,0,1297,103,1400,1400,0,0
36215,2019-09-27,677,0,677,54,731,731,0,0
36216,2019-09-27,241,0,241,19,260,260,0,0
36217,2019-09-27,916,0,916,73,989,989,0,0
36218,2019-09-27,1176,0,1176,94,1270,1270,0,0
36219,2019-09-27,306,0,306,24,330,330,0,0
36220,2019-09-27,1177,0,1177,94,1271,0,1271,0
36221,2019-09-27,299,0,299,23,322,322,0,0
36222,2019-09-27,1371,0,1371,109,1480,1480,0,0
36223,2019-09-27,1493,0,1493,119,1612,1612,0,0
36224,2019-09-27,2361,0,2361,188,2549,2549,0,0
36225,2019-09-27,473,0,473,37,510,510,0,0
36226,2019-09-27,269,0,269,21,290,290,0,0
36227,2019-09-27,1574,0,1574,125,1699,0,1699,0
36228,2019-09-27,1465,0,1465,117,1582,0,1582,0
36229,2019-09-27,907,0,907,72,979,979,0,0
36230,2019-09-27,640,0,640,51,691,691,0,0
36231,2019-09-27,658,0,658,52,710,710,0,0
36232,2019-09-27,787,0,787,62,849,849,0,0
36233,2019-09-27,1269,0,1269,101,1370,1370,0,0
36234,2019-09-27,760,0,760,60,820,820,0,0
36235,2019-09-27,787,0,787,62,849,849,0,0
36236,2019-09-27,787,0,787,62,849,849,0,0
36237,2019-09-27,787,0,787,62,849,849,0,0
36238,2019-09-27,472,0,472,37,509,0,509,0
36239,2019-09-27,2361,-236,2125,170,2295,2295,0,0
36240,2019-09-28,186,0,186,14,200,200,0,0
36241,2019-09-28,1814,0,1814,145,1959,1959,0,0
36242,2019-09-28,1002,0,1002,80,1082,0,1082,0
36243,2019-09-28,780,0,780,62,842,842,0,0
36244,2019-09-28,1228,0,1228,98,1326,1326,0,0
36245,2019-09-28,835,0,835,66,901,901,0,0
36246,2019-09-28,900,0,900,72,972,0,0,972
36247,2019-09-28,1157,0,1157,92,1249,1249,0,0
36248,2019-09-28,1814,0,1814,145,1959,1959,0,0
36249,2019-09-28,929,0,929,74,1003,1003,0,0
36250,2019-09-28,1115,0,1115,89,1204,0,1204,0
36251,2019-09-28,640,-64,576,46,622,622,0,0
36252,2019-09-28,1186,0,1186,94,1280,0,1280,0
36253,2019-09-28,288,0,288,23,311,311,0,0
36254,2019-09-28,279,0,279,22,301,301,0,0
36255,2019-09-28,167,0,167,13,180,180,0,0
36256,2019-09-28,260,0,260,20,280,280,0,0
36257,2019-09-28,2307,0,2307,184,2491,2491,0,0
36258,2019-09-28,1142,0,1142,91,1233,1233,0,0
36259,2019-09-28,667,0,667,53,720,0,0,720
36260,2019-09-28,1402,-140,1262,100,1362,1362,0,0
36261,2019-09-28,798,0,798,63,861,861,0,0
36262,2019-09-28,1445,0,1445,115,1560,1560,0,0
36263,2019-09-28,836,0,836,66,902,0,902,0
36264,2019-09-28,1814,0,1814,145,1959,1959,0,0
36265,2019-09-28,1223,0,1223,97,1320,1320,0,0
36266,2019-09-28,537,0,537,42,579,579,0,0
36267,2019-09-28,2721,0,2721,217,2938,2938,0,0
36268,2019-09-28,1574,0,1574,125,1699,1699,0,0
36269,2019-09-28,567,0,567,45,612,612,0,0
36270,2019-09-28,306,0,306,24,330,330,0,0
36271,2019-09-28,631,0,631,50,681,681,0,0
36272,2019-09-28,-631,0,-631,-50,-681,-681,0,0
36273,2019-09-28,633,0,633,50,683,683,0,0
36274,2019-09-28,631,-63,568,45,613,613,0,0
36275,2019-09-28,982,0,982,78,1060,1060,0,0
36276,2019-09-28,787,0,787,62,849,849,0,0
36277,2019-09-28,288,0,288,23,311,311,0,0
36278,2019-09-28,335,0,335,26,361,361,0,0
36279,2019-09-28,3299,0,3299,263,3562,3562,0,0
36280,2019-09-28,417,0,417,33,450,450,0,0
36281,2019-09-28,2361,0,2361,188,2549,2549,0,0
36282,2019-09-28,1020,0,1020,81,1101,1101,0,0
36283,2019-09-28,492,0,492,39,531,531,0,0
36284,2019-09-28,695,0,695,55,750,750,0,0
36285,2019-09-28,519,0,519,41,560,0,0,560
36286,2019-09-28,538,0,538,43,581,581,0,0
36287,2019-09-28,1038,0,1038,83,1121,1121,0,0
36288,2019-09-28,630,0,630,50,680,680,0,0
36289,2019-09-28,389,0,389,31,420,420,0,0
36290,2019-09-28,288,0,288,23,311,0,311,0
36291,2019-09-28,1467,0,1467,117,1584,1584,0,0
36292,2019-09-28,232,0,232,18,250,250,0,0
36293,2019-09-28,2721,0,2721,217,2938,2938,0,0
36294,2019-09-28,483,0,483,38,521,521,0,0
36295,2019-09-28,1298,0,1298,103,1401,1401,0,0
36296,2019-09-28,1131,0,1131,90,1221,1221,0,0
36297,2019-09-28,985,0,985,78,1063,0,0,1063
36298,2019-09-28,205,0,205,16,221,221,0,0
36299,2019-09-28,370,0,370,29,399,399,0,0
36300,2019-09-28,1321,0,1321,105,1426,1426,0,0
36301,2019-09-28,724,0,724,57,781,781,0,0
36302,2019-09-28,909,0,909,72,981,981,0,0
36303,2019-09-28,604,0,604,48,652,652,0,0
36304,2019-09-28,1900,0,1900,152,2052,2052,0,0
36305,2019-09-28,778,0,778,62,840,840,0,0
36306,2019-09-28,316,0,316,25,341,341,0,0
36307,2019-09-28,1500,0,1500,120,1620,0,1620,0
36308,2019-09-28,1371,0,1371,109,1480,1480,0,0
36309,2019-09-28,381,0,381,30,411,411,0,0
36310,2019-09-28,520,0,520,41,561,561,0,0
36311,2019-09-28,167,0,167,13,180,180,0,0
36312,2019-09-28,864,0,864,69,933,933,0,0
36313,2019-09-28,622,0,622,49,671,671,0,0
36314,2019-09-28,1140,0,1140,91,1231,0,1231,0
36315,2019-09-28,390,0,390,31,421,421,0,0
36316,2019-09-28,260,0,260,20,280,280,0,0
36317,2019-09-28,-389,0,-389,-31,-420,0,-420,0
36318,2019-09-28,491,0,491,39,530,530,0,0
36319,2019-09-28,455,0,455,36,491,491,0,0
36320,2019-09-28,1814,0,1814,145,1959,1959,0,0
36321,2019-09-28,845,0,845,67,912,912,0,0
36322,2019-09-28,907,0,907,72,979,979,0,0
36323,2019-09-28,389,0,389,31,420,420,0,0
36324,2019-09-28,726,0,726,58,784,784,0,0
36325,2019-09-28,1150,0,1150,92,1242,1242,0,0
36326,2019-09-28,279,0,279,22,301,301,0,0
36327,2019-09-28,1408,0,1408,112,1520,1520,0,0
36328,2019-09-28,503,0,503,40,543,543,0,0
36329,2019-09-28,984,-186,798,63,861,861,0,0
36330,2019-09-28,668,0,668,53,721,721,0,0
36331,2019-09-28,1041,0,1041,83,1124,1124,0,0
36332,2019-09-28,3189,0,3189,255,3444,3444,0,0
36333,2019-09-28,149,0,149,11,160,160,0,0
36334,2019-09-28,1814,0,1814,145,1959,1959,0,0
36335,2019-09-28,2232,0,2232,178,2410,2410,0,0
36336,2019-09-28,1346,0,1346,107,1453,1453,0,0
36337,2019-09-28,911,0,911,72,983,983,0,0
36338,2019-09-28,548,0,548,43,591,591,0,0
36339,2019-09-28,770,0,770,61,831,831,0,0
36340,2019-09-28,306,0,306,24,330,330,0,0
36341,2019-09-28,492,0,492,39,531,531,0,0
36342,2019-09-28,297,0,297,23,320,320,0,0
36343,2019-09-28,1814,0,1814,145,1959,1959,0,0
36344,2019-09-28,2721,0,2721,217,2938,2938,0,0
36345,2019-09-28,1122,0,1122,89,1211,1211,0,0
36346,2019-09-28,1814,0,1814,145,1959,1959,0,0
36347,2019-09-28,491,0,491,39,530,530,0,0
36348,2019-09-28,604,0,604,48,652,652,0,0
36349,2019-09-28,464,0,464,37,501,501,0,0
36350,2019-09-28,1316,0,1316,105,1421,1421,0,0
36351,2019-09-28,787,0,787,62,849,849,0,0
36352,2019-09-28,343,0,343,27,370,370,0,0
36353,2019-09-28,436,0,436,34,470,470,0,0
36354,2019-09-28,1417,0,1417,113,1530,1530,0,0
36355,2019-09-28,950,0,950,76,1026,1026,0,0
36356,2019-09-28,410,0,410,32,442,442,0,0
36357,2019-09-28,464,0,464,37,501,501,0,0
36358,2019-09-28,493,0,493,39,532,532,0,0
36359,2019-09-28,260,0,260,20,280,280,0,0
36360,2019-09-28,176,-35,141,11,152,152,0,0
36361,2019-09-28,306,0,306,24,330,330,0,0
36362,2019-09-28,678,0,678,54,732,732,0,0
36363,2019-09-28,437,0,437,34,471,471,0,0
36364,2019-09-28,186,0,186,14,200,200,0,0
36365,2019-09-28,686,0,686,54,740,740,0,0
36366,2019-09-28,2477,0,2477,198,2675,2675,0,0
36367,2019-09-28,2477,0,2477,198,2675,2675,0,0
36368,2019-09-28,232,0,232,18,250,250,0,0
36369,2019-09-28,392,0,392,31,423,423,0,0
36370,2019-09-28,1429,0,1429,114,1543,1543,0,0
36371,2019-09-28,362,0,362,28,390,390,0,0
36372,2019-09-28,798,0,798,63,861,861,0,0
36373,2019-09-28,158,0,158,12,170,170,0,0
36374,2019-09-28,761,0,761,60,821,821,0,0
36375,2019-09-28,362,0,362,28,390,390,0,0
36376,2019-09-28,362,0,362,28,390,390,0,0
36377,2019-09-28,167,0,167,13,180,180,0,0
36378,2019-09-28,639,0,639,51,690,690,0,0
36379,2019-09-28,740,0,740,59,799,799,0,0
36380,2019-09-28,695,0,695,55,750,750,0,0
36381,2019-09-28,695,0,695,55,750,750,0,0
36382,2019-09-28,640,0,640,51,691,691,0,0
36383,2019-09-28,269,0,269,21,290,0,0,290
36384,2019-09-28,269,0,269,21,290,290,0,0
36385,2019-09-28,1814,0,1814,145,1959,1959,0,0
36386,2019-09-28,1130,0,1130,90,1220,1220,0,0
36387,2019-09-28,260,0,260,20,280,280,0,0
36388,2019-09-28,436,0,436,34,470,0,470,0
36389,2019-09-28,1105,0,1105,88,1193,1193,0,0
36390,2019-09-28,668,0,668,53,721,721,0,0
36391,2019-09-28,214,0,214,17,231,231,0,0
36392,2019-09-28,895,0,895,71,966,966,0,0
36393,2019-09-28,1428,0,1428,114,1542,1542,0,0
36394,2019-09-28,316,0,316,25,341,341,0,0
36395,2019-09-28,232,0,232,18,250,0,0,250
36396,2019-09-28,946,0,946,75,1021,1021,0,0
36397,2019-09-28,381,0,381,30,411,411,0,0
36398,2019-09-28,280,0,280,22,302,302,0,0
36399,2019-09-28,834,0,834,66,900,900,0,0
36400,2019-09-28,370,0,370,29,399,399,0,0
36401,2019-09-28,464,0,464,37,501,501,0,0
36402,2019-09-28,371,0,371,29,400,400,0,0
36403,2019-09-28,1104,0,1104,88,1192,1192,0,0
36404,2019-09-28,919,0,919,73,992,992,0,0
36405,2019-09-28,740,0,740,59,799,799,0,0
36406,2019-09-28,759,0,759,60,819,819,0,0
36407,2019-09-28,659,0,659,52,711,711,0,0
36408,2019-09-28,297,0,297,23,320,320,0,0
36409,2019-09-28,501,0,501,40,541,541,0,0
36410,2019-09-28,844,0,844,67,911,911,0,0
36411,2019-09-28,463,0,463,37,500,500,0,0
36412,2019-09-28,1612,0,1612,128,1740,1740,0,0
36413,2019-09-28,695,0,695,55,750,750,0,0
36414,2019-09-28,834,0,834,66,900,900,0,0
36415,2019-09-28,389,0,389,31,420,420,0,0
36416,2019-09-28,1421,0,1421,113,1534,1534,0,0
36417,2019-09-28,288,0,288,23,311,311,0,0
36418,2019-09-28,1568,0,1568,125,1693,1693,0,0
36419,2019-09-28,519,0,519,41,560,0,0,560
36420,2019-09-28,426,0,426,34,460,460,0,0
36421,2019-09-28,1567,0,1567,125,1692,1692,0,0
36422,2019-09-28,2130,0,2130,170,2300,2300,0,0
36423,2019-09-28,278,0,278,22,300,300,0,0
36424,2019-09-28,343,0,343,27,370,370,0,0
36425,2019-09-28,436,0,436,34,470,470,0,0
36426,2019-09-28,788,0,788,63,851,851,0,0
36427,2019-09-28,1631,0,1631,130,1761,1761,0,0
36428,2019-09-28,778,0,778,62,840,840,0,0
36429,2019-09-28,556,0,556,44,600,600,0,0
36430,2019-09-28,408,0,408,32,440,440,0,0
36431,2019-09-28,787,0,787,62,849,849,0,0
36432,2019-09-28,789,0,789,63,852,852,0,0
36433,2019-09-28,787,0,787,62,849,0,849,0
36434,2019-09-28,334,0,334,26,360,360,0,0
36435,2019-09-28,1566,0,1566,125,1691,1691,0,0
36436,2019-09-28,575,0,575,46,621,621,0,0
36437,2019-09-28,593,0,593,47,640,0,0,640
36438,2019-09-28,-2477,0,-2477,-198,-2675,-2675,0,0
36439,2019-09-28,604,0,604,48,652,652,0,0
36440,2019-09-28,1574,0,1574,125,1699,0,0,1699
36441,2019-09-28,1574,0,1574,125,1699,1699,0,0
36442,2019-09-28,1574,0,1574,125,1699,1699,0,0
36443,2019-09-28,431,0,431,34,465,465,0,0
36444,2019-09-28,688,-137,551,44,595,595,0,0
36445,2019-09-28,1574,0,1574,125,1699,1699,0,0
36446,2019-09-28,787,0,787,62,849,849,0,0
36447,2019-09-28,787,0,787,62,849,849,0,0
36448,2019-09-28,436,0,436,34,470,470,0,0
36449,2019-09-28,3148,0,3148,251,3399,3399,0,0
36450,2019-09-28,1574,0,1574,125,1699,1699,0,0
36451,2019-09-28,3148,0,3148,251,3399,3399,0,0
36452,2019-09-28,241,0,241,19,260,260,0,0
36453,2019-09-28,1058,0,1058,84,1142,1142,0,0
36454,2019-09-28,1002,0,1002,80,1082,1082,0,0
36455,2019-09-28,167,0,167,13,180,180,0,0
36456,2019-09-28,1574,0,1574,125,1699,0,1699,0
36457,2019-09-28,910,0,910,72,982,982,0,0
36458,2019-09-28,1574,0,1574,125,1699,1699,0,0
36459,2019-09-28,1574,0,1574,125,1699,1699,0,0
36460,2019-09-28,139,0,139,11,150,150,0,0
36461,2019-09-28,2538,0,2538,203,2741,2741,0,0
36462,2019-09-28,352,0,352,28,380,380,0,0
36463,2019-09-29,1365,0,1365,109,1474,1474,0,0
36464,2019-09-29,854,0,854,68,922,0,922,0
36465,2019-09-29,1263,0,1263,101,1364,1364,0,0
36466,2019-09-29,1243,0,1243,99,1342,1342,0,0
36467,2019-09-29,1475,0,1475,118,1593,1593,0,0
36468,2019-09-29,742,0,742,59,801,801,0,0
36469,2019-09-29,907,0,907,72,979,979,0,0
36470,2019-09-29,907,0,907,72,979,979,0,0
36471,2019-09-29,577,0,577,46,623,623,0,0
36472,2019-09-29,603,0,603,48,651,651,0,0
36473,2019-09-29,1076,0,1076,86,1162,1162,0,0
36474,2019-09-29,1289,0,1289,103,1392,1392,0,0
36475,2019-09-29,2400,0,2400,192,2592,2592,0,0
36476,2019-09-29,907,0,907,72,979,979,0,0
36477,2019-09-29,707,0,707,56,763,763,0,0
36478,2019-09-29,854,0,854,68,922,922,0,0
36479,2019-09-29,1001,0,1001,80,1081,1081,0,0
36480,2019-09-29,325,0,325,26,351,351,0,0
36481,2019-09-29,465,0,465,37,502,502,0,0
36482,2019-09-29,232,0,232,18,250,250,0,0
36483,2019-09-29,343,0,343,27,370,370,0,0
36484,2019-09-29,907,0,907,72,979,979,0,0
36485,2019-09-29,744,0,744,59,803,803,0,0
36486,2019-09-29,574,0,574,45,619,619,0,0
36487,2019-09-29,603,0,603,48,651,651,0,0
36488,2019-09-29,1529,0,1529,122,1651,1651,0,0
36489,2019-09-29,650,0,650,52,702,702,0,0
36490,2019-09-29,278,0,278,22,300,300,0,0
36491,2019-09-29,1019,0,1019,81,1100,1100,0,0
36492,2019-09-29,112,0,112,8,120,120,0,0
36493,2019-09-29,334,-33,301,24,325,325,0,0
36494,2019-09-29,429,0,429,34,463,463,0,0
36495,2019-09-29,250,0,250,20,270,270,0,0
36496,2019-09-29,417,0,417,33,450,450,0,0
36497,2019-09-29,353,0,353,28,381,381,0,0
36498,2019-09-29,816,0,816,65,881,881,0,0
36499,2019-09-29,631,0,631,50,681,681,0,0
36500,2019-09-29,362,0,362,28,390,390,0,0
36501,2019-09-29,1203,0,1203,96,1299,1299,0,0
36502,2019-09-29,769,0,769,61,830,830,0,0
36503,2019-09-29,426,0,426,34,460,460,0,0
36504,2019-09-29,1456,0,1456,116,1572,1572,0,0
36505,2019-09-29,584,0,584,46,630,630,0,0
36506,2019-09-29,547,0,547,43,590,590,0,0
36507,2019-09-29,828,0,828,66,894,0,894,0
36508,2019-09-29,455,0,455,36,491,491,0,0
36509,2019-09-29,1197,0,1197,95,1292,1292,0,0
36510,2019-09-29,446,0,446,35,481,481,0,0
36511,2019-09-29,493,0,493,39,532,532,0,0
36512,2019-09-29,885,0,885,70,955,955,0,0
36513,2019-09-29,907,0,907,72,979,0,979,0
36514,2019-09-29,670,0,670,53,723,0,0,723
36515,2019-09-29,696,0,696,55,751,751,0,0
36516,2019-09-29,576,0,576,46,622,622,0,0
36517,2019-09-29,872,0,872,69,941,941,0,0
36518,2019-09-29,946,0,946,75,1021,1021,0,0
36519,2019-09-29,1131,0,1131,90,1221,1221,0,0
36520,2019-09-29,419,0,419,33,452,452,0,0
36521,2019-09-29,1033,0,1033,82,1115,1115,0,0
36522,2019-09-29,260,0,260,20,280,280,0,0
36523,2019-09-29,907,0,907,72,979,979,0,0
36524,2019-09-29,1354,0,1354,108,1462,1462,0,0
36525,2019-09-29,2177,0,2177,174,2351,2351,0,0
36526,2019-09-29,307,0,307,24,331,331,0,0
36527,2019-09-29,678,0,678,54,732,732,0,0
36528,2019-09-29,463,0,463,37,500,500,0,0
36529,2019-09-29,689,0,689,55,744,744,0,0
36530,2019-09-29,269,0,269,21,290,290,0,0
36531,2019-09-29,890,0,890,71,961,0,0,961
36532,2019-09-29,409,0,409,32,441,441,0,0
36533,2019-09-29,501,0,501,40,541,541,0,0
36534,2019-09-29,473,0,473,37,510,0,510,0
36535,2019-09-29,907,0,907,72,979,979,0,0
36536,2019-09-29,639,0,639,51,690,690,0,0
36537,2019-09-29,307,0,307,24,331,331,0,0
36538,2019-09-29,306,0,306,24,330,330,0,0
36539,2019-09-29,288,0,288,23,311,311,0,0
36540,2019-09-29,567,0,567,45,612,612,0,0
36541,2019-09-29,260,0,260,20,280,280,0,0
36542,2019-09-29,575,0,575,46,621,621,0,0
36543,2019-09-29,652,0,652,52,704,704,0,0
36544,2019-09-29,668,-66,602,48,650,0,650,0
36545,2019-09-29,1492,0,1492,119,1611,1611,0,0
36546,2019-09-29,1002,0,1002,80,1082,1082,0,0
36547,2019-09-29,1814,0,1814,145,1959,1959,0,0
36548,2019-09-29,1814,0,1814,145,1959,1959,0,0
36549,2019-09-29,855,0,855,68,923,923,0,0
36550,2019-09-29,336,0,336,26,362,362,0,0
36551,2019-09-29,308,0,308,24,332,332,0,0
36552,2019-09-29,604,0,604,48,652,652,0,0
36553,2019-09-29,585,0,585,46,631,631,0,0
36554,2019-09-29,1188,0,1188,95,1283,1283,0,0
36555,2019-09-29,907,0,907,72,979,979,0,0
36556,2019-09-29,907,0,907,72,979,979,0,0
36557,2019-09-29,493,0,493,39,532,532,0,0
36558,2019-09-29,907,0,907,72,979,979,0,0
36559,2019-09-29,410,0,410,32,442,442,0,0
36560,2019-09-29,1574,0,1574,125,1699,1699,0,0
36561,2019-09-29,1345,0,1345,107,1452,1452,0,0
36562,2019-09-29,1321,0,1321,105,1426,1426,0,0
36563,2019-09-29,224,0,224,17,241,241,0,0
36564,2019-09-29,389,0,389,31,420,420,0,0
36565,2019-09-29,223,0,223,17,240,240,0,0
36566,2019-09-29,806,0,806,64,870,870,0,0
36567,2019-09-29,362,0,362,28,390,390,0,0
36568,2019-09-29,232,0,232,18,250,250,0,0
36569,2019-09-29,557,0,557,44,601,0,0,601
36570,2019-09-29,168,0,168,13,181,0,0,181
36571,2019-09-29,427,0,427,34,461,461,0,0
36572,2019-09-29,528,0,528,42,570,570,0,0
36573,2019-09-29,593,0,593,47,640,640,0,0
36574,2019-09-29,529,0,529,42,571,571,0,0
36575,2019-09-29,538,0,538,43,581,581,0,0
36576,2019-09-29,808,0,808,64,872,872,0,0
36577,2019-09-29,511,0,511,40,551,551,0,0
36578,2019-09-29,584,0,584,46,630,630,0,0
36579,2019-09-29,1751,0,1751,140,1891,1891,0,0
36580,2019-09-29,139,0,139,11,150,150,0,0
36581,2019-09-29,463,0,463,37,500,500,0,0
36582,2019-09-29,520,0,520,41,561,561,0,0
36583,2019-09-29,1130,0,1130,90,1220,1220,0,0
36584,2019-09-29,881,0,881,70,951,951,0,0
36585,2019-09-29,1028,0,1028,82,1110,1110,0,0
36586,2019-09-29,1168,0,1168,93,1261,1261,0,0
36587,2019-09-29,334,0,334,26,360,360,0,0
36588,2019-09-29,1056,0,1056,84,1140,1140,0,0
36589,2019-09-29,1586,-158,1428,114,1542,0,1542,0
36590,2019-09-29,428,0,428,34,462,462,0,0
36591,2019-09-29,288,0,288,23,311,311,0,0
36592,2019-09-29,511,0,511,40,551,551,0,0
36593,2019-09-29,854,0,854,68,922,922,0,0
36594,2019-09-29,1225,0,1225,98,1323,1323,0,0
36595,2019-09-29,743,0,743,59,802,802,0,0
36596,2019-09-29,677,0,677,54,731,731,0,0
36597,2019-09-29,297,0,297,23,320,320,0,0
36598,2019-09-29,1337,0,1337,106,1443,1443,0,0
36599,2019-09-29,409,-40,369,29,398,398,0,0
36600,2019-09-29,993,0,993,79,1072,1072,0,0
36601,2019-09-29,603,0,603,48,651,651,0,0
36602,2019-09-29,353,0,353,28,381,381,0,0
36603,2019-09-29,854,0,854,68,922,922,0,0
36604,2019-09-29,460,0,460,36,496,496,0,0
36605,2019-09-29,417,0,417,33,450,450,0,0
36606,2019-09-29,3310,0,3310,264,3574,3574,0,0
36607,2019-09-29,390,0,390,31,421,421,0,0
36608,2019-09-29,2263,0,2263,181,2444,2444,0,0
36609,2019-09-29,1391,0,1391,111,1502,1502,0,0
36610,2019-09-29,707,0,707,56,763,763,0,0
36611,2019-09-29,740,0,740,59,799,799,0,0
36612,2019-09-29,491,0,491,39,530,530,0,0
36613,2019-09-29,733,0,733,58,791,791,0,0
36614,2019-09-29,635,0,635,50,685,685,0,0
36615,2019-09-29,1065,0,1065,85,1150,1150,0,0
36616,2019-09-29,436,0,436,34,470,470,0,0
36617,2019-09-29,1335,0,1335,106,1441,1441,0,0
36618,2019-09-29,1574,0,1574,125,1699,1699,0,0
36619,2019-09-29,1363,0,1363,109,1472,1472,0,0
36620,2019-09-29,778,0,778,62,840,840,0,0
36621,2019-09-29,74,0,74,5,79,79,0,0
36622,2019-09-29,742,0,742,59,801,801,0,0
36623,2019-09-29,306,0,306,24,330,330,0,0
36624,2019-09-29,1391,0,1391,111,1502,1502,0,0
36625,2019-09-29,1622,0,1622,129,1751,1751,0,0
36626,2019-09-29,1574,0,1574,125,1699,1699,0,0
36627,2019-09-29,1271,0,1271,101,1372,1372,0,0
36628,2019-09-29,826,0,826,66,892,892,0,0
36629,2019-09-29,807,0,807,64,871,871,0,0
36630,2019-09-29,1574,0,1574,125,1699,0,1699,0
36631,2019-09-29,787,0,787,62,849,849,0,0
36632,2019-09-29,167,0,167,13,180,180,0,0
36633,2019-09-29,787,0,787,62,849,849,0,0
36634,2019-09-29,787,0,787,62,849,849,0,0
36635,2019-09-29,297,0,297,23,320,320,0,0
36636,2019-09-29,1574,0,1574,125,1699,0,0,1699
36637,2019-09-29,641,0,641,51,692,692,0,0
36638,2019-09-29,787,0,787,62,849,849,0,0
36639,2019-09-29,260,0,260,20,280,280,0,0
36640,2019-09-29,334,0,334,26,360,360,0,0
36641,2019-09-29,871,0,871,69,940,940,0,0
36642,2019-09-29,195,0,195,15,210,210,0,0
36643,2019-09-29,632,0,632,50,682,682,0,0
36644,2019-09-29,1002,0,1002,80,1082,1082,0,0
36645,2019-09-29,705,0,705,56,761,761,0,0
36646,2019-09-29,669,0,669,53,722,722,0,0
36647,2019-09-29,464,0,464,37,501,501,0,0
36648,2019-09-29,1689,0,1689,135,1824,0,1824,0
36649,2019-09-29,956,0,956,76,1032,1032,0,0
36650,2019-09-29,232,0,232,18,250,250,0,0
36651,2019-09-29,1075,0,1075,86,1161,1161,0,0
36652,2019-09-29,371,0,371,29,400,400,0,0
36653,2019-09-29,787,0,787,62,849,849,0,0
36654,2019-09-29,436,0,436,34,470,470,0,0
36655,2019-09-29,362,0,362,28,390,390,0,0
36656,2019-09-29,1252,0,1252,100,1352,0,0,1352
36657,2019-09-29,1492,0,1492,119,1611,1611,0,0
36658,2019-09-29,1244,0,1244,99,1343,1343,0,0
36659,2019-09-30,1243,0,1243,99,1342,1342,0,0
36660,2019-09-30,308,0,308,30,338,338,0,0
36661,2019-09-30,640,0,640,51,691,691,0,0
36662,2019-09-30,844,0,844,84,928,928,0,0
36663,2019-09-30,1262,0,1262,100,1362,1362,0,0
36664,2019-09-30,1595,-159,1436,114,1550,1550,0,0
36665,2019-09-30,232,0,232,18,250,250,0,0
36666,2019-09-30,1132,0,1132,90,1222,0,1222,0
36667,2019-09-30,891,0,891,89,980,980,0,0
36668,2019-09-30,352,0,352,35,387,387,0,0
36669,2019-09-30,1762,0,1762,140,1902,0,1902,0
36670,2019-09-30,141,0,141,11,152,152,0,0
36671,2019-09-30,676,0,676,67,743,743,0,0
36672,2019-09-30,1782,0,1782,178,1960,1960,0,0
36673,2019-09-30,835,0,835,66,901,901,0,0
36674,2019-09-30,501,0,501,40,541,541,0,0
36675,2019-09-30,871,0,871,87,958,958,0,0
36676,2019-09-30,1104,0,1104,110,1214,1214,0,0
36677,2019-09-30,891,0,891,89,980,980,0,0
36678,2019-09-30,773,0,773,77,850,850,0,0
36679,2019-09-30,353,0,353,28,381,381,0,0
36680,2019-09-30,232,0,232,18,250,250,0,0
36681,2019-09-30,773,0,773,77,850,850,0,0
36682,2019-09-30,733,0,733,58,791,791,0,0
36683,2019-09-30,815,0,815,81,896,896,0,0
36684,2019-09-30,3875,0,3875,387,4262,4262,0,0
36685,2019-09-30,983,0,983,78,1061,1061,0,0
36686,2019-09-30,733,0,733,58,791,791,0,0
36687,2019-09-30,547,0,547,43,590,590,0,0
36688,2019-09-30,474,0,474,37,511,511,0,0
36689,2019-09-30,306,0,306,24,330,330,0,0
36690,2019-09-30,668,0,668,53,721,721,0,0
36691,2019-09-30,697,0,697,69,766,766,0,0
36692,2019-09-30,798,0,798,79,877,877,0,0
36693,2019-09-30,891,0,891,89,980,980,0,0
36694,2019-09-30,242,-24,218,17,235,235,0,0
36695,2019-09-30,916,0,916,91,1007,1007,0,0
36696,2019-09-30,436,0,436,34,470,470,0,0
36697,2019-09-30,3233,0,3233,323,3556,3556,0,0
36698,2019-09-30,770,0,770,77,847,847,0,0
36699,2019-09-30,724,0,724,57,781,781,0,0
36700,2019-09-30,1167,0,1167,116,1283,1283,0,0
36701,2019-09-30,121,0,121,9,130,130,0,0
36702,2019-09-30,491,0,491,49,540,540,0,0
36703,2019-09-30,875,0,875,70,945,945,0,0
36704,2019-09-30,501,0,501,50,551,551,0,0
36705,2019-09-30,967,0,967,77,1044,1044,0,0
36706,2019-09-30,306,0,306,24,330,330,0,0
36707,2019-09-30,651,0,651,65,716,716,0,0
36708,2019-09-30,491,0,491,49,540,0,0,540
36709,2019-09-30,158,0,158,12,170,0,170,0
36710,2019-09-30,2238,0,2238,223,2461,2461,0,0
36711,2019-09-30,1782,0,1782,178,1960,1960,0,0
36712,2019-09-30,492,0,492,39,531,531,0,0
36713,2019-09-30,722,0,722,72,794,0,794,0
36714,2019-09-30,602,0,602,60,662,662,0,0
36715,2019-09-30,603,0,603,48,651,651,0,0
36716,2019-09-30,548,0,548,43,591,591,0,0
36717,2019-09-30,1066,0,1066,106,1172,1172,0,0
36718,2019-09-30,1058,0,1058,84,1142,1142,0,0
36719,2019-09-30,1391,-139,1252,100,1352,1352,0,0
36720,2019-09-30,909,0,909,72,981,981,0,0
36721,2019-09-30,400,0,400,32,432,432,0,0
36722,2019-09-30,891,0,891,89,980,980,0,0
36723,2019-09-30,891,0,891,89,980,980,0,0
36724,2019-09-30,269,0,269,21,290,290,0,0
36725,2019-09-30,2481,0,2481,248,2729,0,0,2729
36726,2019-09-30,362,0,362,28,390,390,0,0
36727,2019-09-30,233,0,233,18,251,251,0,0
36728,2019-09-30,567,0,567,45,612,612,0,0
36729,2019-09-30,778,0,778,77,855,855,0,0
36730,2019-09-30,667,0,667,66,733,733,0,0
36731,2019-09-30,288,0,288,23,311,311,0,0
36732,2019-09-30,168,0,168,13,181,181,0,0
36733,2019-09-30,445,0,445,35,480,480,0,0
36734,2019-09-30,1290,0,1290,103,1393,1393,0,0
36735,2019-09-30,557,0,557,44,601,0,601,0
36736,2019-09-30,2048,0,2048,204,2252,2252,0,0
36737,2019-09-30,1546,0,1546,154,1700,0,1700,0
36738,2019-09-30,400,0,400,32,432,432,0,0
36739,2019-09-30,510,0,510,40,550,550,0,0
36740,2019-09-30,260,0,260,20,280,280,0,0
36741,2019-09-30,880,0,880,70,950,950,0,0
36742,2019-09-30,353,0,353,28,381,381,0,0
36743,2019-09-30,491,0,491,39,530,530,0,0
36744,2019-09-30,862,0,862,68,930,930,0,0
36745,2019-09-30,473,0,473,37,510,510,0,0
36746,2019-09-30,484,0,484,38,522,0,522,0
36747,2019-09-30,556,0,556,44,600,600,0,0
36748,2019-09-30,260,0,260,20,280,280,0,0
36749,2019-09-30,566,0,566,45,611,611,0,0
36750,2019-09-30,260,0,260,20,280,280,0,0
36751,2019-09-30,334,0,334,26,360,360,0,0
36752,2019-09-30,740,0,740,59,799,799,0,0
36753,2019-09-30,283,0,283,22,305,305,0,0
36754,2019-09-30,116,0,116,9,125,125,0,0
36755,2019-09-30,1039,0,1039,83,1122,1122,0,0
36756,2019-09-30,340,0,340,27,367,367,0,0
36757,2019-09-30,389,0,389,31,420,420,0,0
36758,2019-09-30,770,0,770,61,831,831,0,0
36759,2019-09-30,260,-26,234,18,252,252,0,0
36760,2019-09-30,511,0,511,40,551,551,0,0
36761,2019-09-30,788,0,788,63,851,851,0,0
36762,2019-09-30,149,0,149,11,160,160,0,0
36763,2019-09-30,759,0,759,60,819,819,0,0
36764,2019-09-30,232,0,232,18,250,250,0,0
36765,2019-09-30,417,0,417,33,450,450,0,0
36766,2019-09-30,232,0,232,18,250,250,0,0
36767,2019-09-30,399,0,399,31,430,0,430,0
36768,2019-09-30,687,0,687,54,741,741,0,0
36769,2019-09-30,1213,0,1213,97,1310,1310,0,0
36770,2019-09-30,366,0,366,29,395,395,0,0
36771,2019-09-30,2177,0,2177,174,2351,0,2351,0
36772,2019-09-30,167,0,167,13,180,180,0,0
36773,2019-09-30,139,0,139,11,150,150,0,0
36774,2019-09-30,612,0,612,48,660,660,0,0
36775,2019-09-30,778,0,778,62,840,840,0,0
36776,2019-09-30,232,0,232,18,250,250,0,0
36777,2019-09-30,269,0,269,21,290,290,0,0
36778,2019-09-30,1244,0,1244,124,1368,1368,0,0
36779,2019-09-30,1095,0,1095,109,1204,0,1204,0
36780,2019-09-30,984,0,984,98,1082,0,1082,0
36781,2019-09-30,-686,0,-686,-54,-740,-740,0,0
36782,2019-09-30,352,0,352,28,380,380,0,0
36783,2019-09-30,139,0,139,11,150,150,0,0
36784,2019-09-30,112,0,112,11,123,123,0,0
36785,2019-09-30,881,0,881,70,951,951,0,0
36786,2019-09-30,195,0,195,15,210,210,0,0
36787,2019-09-30,574,0,574,57,631,631,0,0
36788,2019-09-30,622,0,622,49,671,671,0,0
36789,2019-09-30,658,0,658,65,723,723,0,0
36790,2019-09-30,324,0,324,25,349,349,0,0
36791,2019-09-30,334,0,334,26,360,360,0,0
36792,2019-09-30,214,0,214,21,235,235,0,0
36793,2019-09-30,865,0,865,69,934,934,0,0
36794,2019-09-30,426,0,426,34,460,460,0,0
36795,2019-09-30,788,0,788,78,866,866,0,0
36796,2019-09-30,1288,-128,1160,92,1252,1252,0,0
36797,2019-09-30,686,0,686,68,754,754,0,0
36798,2019-09-30,345,0,345,27,372,372,0,0
36799,2019-09-30,880,0,880,88,968,968,0,0
36800,2019-09-30,2319,0,2319,231,2550,2550,0,0
36801,2019-09-30,417,0,417,41,458,458,0,0
36802,2019-09-30,1546,0,1546,154,1700,1700,0,0
36803,2019-09-30,1336,0,1336,133,1469,1469,0,0
36804,2019-09-30,1603,0,1603,160,1763,1763,0,0
36805,2019-09-30,250,0,250,25,275,275,0,0
36806,2019-09-30,612,0,612,48,660,660,0,0
36807,2019-09-30,1876,0,1876,187,2063,2063,0,0
36808,2019-09-30,491,0,491,49,540,540,0,0
36809,2019-09-30,723,0,723,72,795,795,0,0
36810,2019-09-30,1546,0,1546,154,1700,1700,0,0
36811,2019-09-30,2398,0,2398,239,2637,2637,0,0
36812,2019-09-30,773,0,773,77,850,850,0,0
36813,2019-09-30,167,0,167,13,180,180,0,0
36814,2019-09-30,1123,0,1123,89,1212,1212,0,0
36815,2019-09-30,686,0,686,54,740,740,0,0
36816,2019-10-01,1185,0,1185,118,1303,0,1303,0
36817,2019-10-01,829,0,829,66,895,895,0,0
36818,2019-10-01,556,0,556,55,611,611,0,0
36819,2019-10-01,1782,0,1782,178,1960,1960,0,0
36820,2019-10-01,255,0,255,20,275,275,0,0
36821,2019-10-01,826,0,826,66,892,892,0,0
36822,2019-10-01,891,0,891,89,980,980,0,0
36823,2019-10-01,557,0,557,44,601,601,0,0
36824,2019-10-01,827,0,827,66,893,893,0,0
36825,2019-10-01,556,0,556,44,600,600,0,0
36826,2019-10-01,1076,0,1076,86,1162,1162,0,0
36827,2019-10-01,1636,0,1636,130,1766,1766,0,0
36828,2019-10-01,1391,0,1391,131,1522,0,1522,0
36829,2019-10-01,232,0,232,18,250,0,250,0
36830,2019-10-01,705,0,705,56,761,761,0,0
36831,2019-10-01,167,0,167,13,180,180,0,0
36832,2019-10-01,1252,0,1252,125,1377,1377,0,0
36833,2019-10-01,751,0,751,60,811,811,0,0
36834,2019-10-01,1545,0,1545,123,1668,0,1668,0
36835,2019-10-01,850,0,850,68,918,918,0,0
36836,2019-10-01,542,0,542,43,585,585,0,0
36837,2019-10-01,1158,0,1158,115,1273,1273,0,0
36838,2019-10-01,1132,0,1132,90,1222,1222,0,0
36839,2019-10-01,808,0,808,64,872,872,0,0
36840,2019-10-01,260,0,260,20,280,280,0,0
36841,2019-10-01,585,0,585,46,631,631,0,0
36842,2019-10-01,139,0,139,11,150,150,0,0
36843,2019-10-01,891,0,891,89,980,980,0,0
36844,2019-10-01,2756,0,2756,220,2976,2976,0,0
36845,2019-10-01,1085,0,1085,86,1171,1171,0,0
36846,2019-10-01,353,0,353,28,381,381,0,0
36847,2019-10-01,1251,0,1251,100,1351,1351,0,0
36848,2019-10-01,1049,0,1049,104,1153,1153,0,0
36849,2019-10-01,455,0,455,36,491,491,0,0
36850,2019-10-01,121,0,121,9,130,130,0,0
36851,2019-10-01,362,0,362,28,390,390,0,0
36852,2019-10-01,334,0,334,33,367,367,0,0
36853,2019-10-01,853,0,853,68,921,0,921,0
36854,2019-10-01,974,0,974,77,1051,0,1051,0
36855,2019-10-01,752,0,752,60,812,812,0,0
36856,2019-10-01,195,0,195,15,210,210,0,0
36857,2019-10-01,891,0,891,89,980,980,0,0
36858,2019-10-01,891,0,891,89,980,980,0,0
36859,2019-10-01,1782,0,1782,178,1960,1960,0,0
36860,2019-10-01,112,0,112,8,120,120,0,0
36861,2019-10-01,596,0,596,47,643,0,643,0
36862,2019-10-01,585,0,585,46,631,631,0,0
36863,2019-10-01,547,0,547,43,590,590,0,0
36864,2019-10-01,158,0,158,12,170,170,0,0
36865,2019-10-01,537,0,537,53,590,590,0,0
36866,2019-10-01,1129,0,1129,112,1241,1241,0,0
36867,2019-10-01,1755,-175,1580,126,1706,0,1706,0
36868,2019-10-01,538,0,538,43,581,0,581,0
36869,2019-10-01,381,0,381,30,411,0,0,411
36870,2019-10-01,1382,0,1382,138,1520,1520,0,0
36871,2019-10-01,501,0,501,40,541,541,0,0
36872,2019-10-01,538,0,538,53,591,591,0,0
36873,2019-10-01,139,0,139,11,150,150,0,0
36874,2019-10-01,1782,0,1782,178,1960,1960,0,0
36875,2019-10-01,773,0,773,77,850,850,0,0
36876,2019-10-01,370,0,370,37,407,407,0,0
36877,2019-10-01,890,0,890,89,979,979,0,0
36878,2019-10-01,271,0,271,21,292,292,0,0
36879,2019-10-01,409,0,409,32,441,441,0,0
36880,2019-10-01,260,0,260,20,280,280,0,0
36881,2019-10-01,557,0,557,44,601,601,0,0
36882,2019-10-01,112,0,112,11,123,123,0,0
36883,2019-10-01,390,0,390,31,421,421,0,0
36884,2019-10-01,270,-27,243,24,267,0,0,267
36885,2019-10-01,1465,0,1465,117,1582,1582,0,0
36886,2019-10-01,752,0,752,60,812,812,0,0
36887,2019-10-01,390,0,390,31,421,421,0,0
36888,2019-10-01,1039,0,1039,83,1122,1122,0,0
36889,2019-10-01,538,0,538,43,581,581,0,0
36890,2019-10-01,-982,0,-982,-98,-1080,-1080,0,0
36891,2019-10-01,975,0,975,78,1053,1053,0,0
36892,2019-10-01,362,-36,326,26,352,352,0,0
36893,2019-10-01,491,0,491,39,530,530,0,0
36894,2019-10-01,389,0,389,31,420,420,0,0
36895,2019-10-01,744,0,744,59,803,803,0,0
36896,2019-10-01,335,0,335,26,361,361,0,0
36897,2019-10-01,1161,0,1161,92,1253,1253,0,0
36898,2019-10-01,502,0,502,40,542,0,542,0
36899,2019-10-01,628,0,628,62,690,0,690,0
36900,2019-10-01,232,0,232,18,250,0,0,250
36901,2019-10-01,973,0,973,77,1050,1050,0,0
36902,2019-10-01,1512,0,1512,120,1632,1632,0,0
36903,2019-10-01,102,0,102,8,110,0,0,110
36904,2019-10-01,838,0,838,67,905,905,0,0
36905,2019-10-01,547,0,547,43,590,590,0,0
36906,2019-10-01,773,0,773,77,850,850,0,0
36907,2019-10-01,-102,0,-102,-8,-110,0,0,-110
36908,2019-10-01,1546,0,1546,154,1700,0,1700,0
36909,2019-10-01,1837,0,1837,183,2020,2020,0,0
36910,2019-10-01,538,0,538,43,581,581,0,0
36911,2019-10-01,334,0,334,26,360,360,0,0
36912,2019-10-01,315,0,315,25,340,340,0,0
36913,2019-10-01,724,0,724,57,781,781,0,0
36914,2019-10-01,1945,0,1945,194,2139,2139,0,0
36915,2019-10-01,3865,0,3865,386,4251,4251,0,0
36916,2019-10-01,2736,0,2736,273,3009,3009,0,0
36917,2019-10-01,389,0,389,38,427,427,0,0
36918,2019-10-01,1844,0,1844,184,2028,2028,0,0
36919,2019-10-01,1345,0,1345,107,1452,1452,0,0
36920,2019-10-01,790,0,790,63,853,853,0,0
36921,2019-10-01,539,0,539,43,582,582,0,0
36922,2019-10-01,1120,0,1120,112,1232,1232,0,0
36923,2019-10-01,439,0,439,35,474,474,0,0
36924,2019-10-01,224,0,224,17,241,241,0,0
36925,2019-10-01,539,0,539,43,582,582,0,0
36926,2019-10-01,529,0,529,52,581,581,0,0
36927,2019-10-01,241,0,241,19,260,260,0,0
36928,2019-10-01,102,0,102,10,112,112,0,0
36929,2019-10-01,288,0,288,23,311,311,0,0
36930,2019-10-01,326,0,326,26,352,352,0,0
36931,2019-10-01,251,0,251,20,271,271,0,0
36932,2019-10-01,269,0,269,21,290,290,0,0
36933,2019-10-01,139,0,139,13,152,152,0,0
36934,2019-10-02,501,0,501,40,541,541,0,0
36935,2019-10-02,891,0,891,89,980,0,0,980
36936,2019-10-02,390,-39,351,28,379,379,0,0
36937,2019-10-02,993,0,993,79,1072,1072,0,0
36938,2019-10-02,538,0,538,43,581,581,0,0
36939,2019-10-02,1350,-135,1215,97,1312,1312,0,0
36940,2019-10-02,1344,0,1344,107,1451,1451,0,0
36941,2019-10-02,158,0,158,12,170,170,0,0
36942,2019-10-02,566,0,566,56,622,622,0,0
36943,2019-10-02,767,0,767,76,843,843,0,0
36944,2019-10-02,492,0,492,39,531,531,0,0
36945,2019-10-02,3336,0,3336,266,3602,0,3602,0
36946,2019-10-02,705,0,705,56,761,761,0,0
36947,2019-10-02,919,0,919,73,992,992,0,0
36948,2019-10-02,557,0,557,44,601,601,0,0
36949,2019-10-02,863,0,863,69,932,932,0,0
36950,2019-10-02,436,0,436,34,470,470,0,0
36951,2019-10-02,1782,0,1782,178,1960,1960,0,0
36952,2019-10-02,891,0,891,89,980,980,0,0
36953,2019-10-02,1863,0,1863,149,2012,2012,0,0
36954,2019-10-02,260,0,260,26,286,286,0,0
36955,2019-10-02,446,0,446,35,481,481,0,0
36956,2019-10-02,871,0,871,87,958,958,0,0
36957,2019-10-02,1381,0,1381,138,1519,1519,0,0
36958,2019-10-02,269,0,269,21,290,290,0,0
36959,2019-10-02,740,0,740,74,814,814,0,0
36960,2019-10-02,1557,0,1557,155,1712,1712,0,0
36961,2019-10-02,635,0,635,50,685,685,0,0
36962,2019-10-02,1065,0,1065,85,1150,0,1150,0
36963,2019-10-02,1011,0,1011,80,1091,0,1091,0
36964,2019-10-02,1197,0,1197,95,1292,0,1292,0
36965,2019-10-02,936,0,936,93,1029,1029,0,0
36966,2019-10-02,916,0,916,91,1007,1007,0,0
36967,2019-10-02,937,0,937,74,1011,1011,0,0
36968,2019-10-02,418,0,418,41,459,459,0,0
36969,2019-10-02,491,0,491,49,540,540,0,0
36970,2019-10-02,370,0,370,37,407,407,0,0
36971,2019-10-02,370,0,370,37,407,407,0,0
36972,2019-10-02,1011,0,1011,80,1091,1091,0,0
36973,2019-10-02,789,-78,711,56,767,767,0,0
36974,2019-10-02,242,0,242,24,266,266,0,0
36975,2019-10-02,891,0,891,89,980,980,0,0
36976,2019-10-02,436,0,436,34,470,470,0,0
36977,2019-10-02,891,0,891,89,980,980,0,0
36978,2019-10-02,223,0,223,17,240,240,0,0
36979,2019-10-02,659,0,659,52,711,711,0,0
36980,2019-10-02,1782,0,1782,178,1960,1960,0,0
36981,2019-10-02,1168,0,1168,116,1284,1284,0,0
36982,2019-10-02,362,0,362,28,390,390,0,0
36983,2019-10-02,787,0,787,78,865,0,865,0
36984,2019-10-02,510,0,510,40,550,550,0,0
36985,2019-10-02,399,0,399,39,438,438,0,0
36986,2019-10-02,324,0,324,25,349,349,0,0
36987,2019-10-02,47,0,47,3,50,50,0,0
36988,2019-10-02,714,0,714,71,785,785,0,0
36989,2019-10-02,56,0,56,5,61,61,0,0
36990,2019-10-02,334,0,334,26,360,360,0,0
36991,2019-10-02,790,0,790,63,853,0,853,0
36992,2019-10-02,269,0,269,21,290,290,0,0
36993,2019-10-02,1902,0,1902,152,2054,0,2054,0
36994,2019-10-02,594,-59,535,42,577,577,0,0
36995,2019-10-02,399,0,399,31,430,430,0,0
36996,2019-10-02,585,-58,527,42,569,569,0,0
36997,2019-10-02,334,0,334,26,360,360,0,0
36998,2019-10-02,427,0,427,34,461,461,0,0
36999,2019-10-02,566,0,566,45,611,611,0,0
37000,2019-10-02,891,0,891,89,980,980,0,0
37001,2019-10-02,2673,0,2673,267,2940,2940,0,0
37002,2019-10-02,621,0,621,62,683,0,683,0
37003,2019-10-02,566,0,566,45,611,611,0,0
37004,2019-10-02,937,-500,437,34,471,471,0,0
37005,2019-10-02,891,0,891,89,980,980,0,0
37006,2019-10-02,473,0,473,37,510,510,0,0
37007,2019-10-02,594,0,594,47,641,641,0,0
37008,2019-10-02,515,0,515,41,556,556,0,0
37009,2019-10-02,1782,0,1782,178,1960,0,1960,0
37010,2019-10-02,844,0,844,67,911,911,0,0
37011,2019-10-02,269,0,269,21,290,0,290,0
37012,2019-10-02,891,0,891,89,980,980,0,0
37013,2019-10-02,1115,0,1115,89,1204,1204,0,0
37014,2019-10-02,418,-83,335,26,361,361,0,0
37015,2019-10-02,445,0,445,35,480,480,0,0
37016,2019-10-02,370,0,370,37,407,0,0,407
37017,2019-10-02,-1596,0,-1596,-127,-1723,-1723,0,0
37018,2019-10-02,584,0,584,46,630,0,0,630
37019,2019-10-02,353,0,353,28,381,381,0,0
37020,2019-10-02,102,0,102,8,110,110,0,0
37021,2019-10-02,408,0,408,32,440,440,0,0
37022,2019-10-02,139,0,139,11,150,150,0,0
37023,2019-10-02,269,0,269,21,290,290,0,0
37024,2019-10-02,405,0,405,32,437,437,0,0
37025,2019-10-02,1022,0,1022,81,1103,1103,0,0
37026,2019-10-02,288,0,288,23,311,311,0,0
37027,2019-10-02,1289,0,1289,103,1392,1392,0,0
37028,2019-10-02,362,0,362,28,390,390,0,0
37029,2019-10-02,446,0,446,35,481,481,0,0
37030,2019-10-02,382,0,382,30,412,412,0,0
37031,2019-10-02,335,0,335,26,361,361,0,0
37032,2019-10-02,307,0,307,24,331,331,0,0
37033,2019-10-02,427,0,427,34,461,0,0,461
37034,2019-10-02,4074,0,4074,407,4481,4481,0,0
37035,2019-10-02,1732,0,1732,153,1885,1885,0,0
37036,2019-10-02,510,0,510,40,550,550,0,0
37037,2019-10-02,1546,0,1546,154,1700,1700,0,0
37038,2019-10-02,2002,0,2002,160,2162,2162,0,0
37039,2019-10-02,186,0,186,14,200,200,0,0
37040,2019-10-02,502,0,502,40,542,542,0,0
37041,2019-10-02,410,0,410,32,442,442,0,0
37042,2019-10-02,371,0,371,29,400,400,0,0
37043,2019-10-02,566,0,566,45,611,611,0,0
37044,2019-10-02,493,0,493,39,532,532,0,0
37045,2019-10-02,559,-55,504,40,544,0,544,0
37046,2019-10-02,1596,0,1596,127,1723,1723,0,0
37047,2019-10-02,746,0,746,59,805,805,0,0
37048,2019-10-02,1596,0,1596,127,1723,1723,0,0
37049,2019-10-02,696,0,696,55,751,751,0,0
37050,2019-10-02,335,0,335,26,361,361,0,0
37051,2019-10-02,853,0,853,68,921,921,0,0
37052,2019-10-02,381,0,381,30,411,411,0,0
37053,2019-10-02,788,0,788,78,866,866,0,0
37054,2019-10-02,112,0,112,11,123,123,0,0
37055,2019-10-02,390,0,390,31,421,421,0,0
37056,2019-10-02,260,0,260,20,280,280,0,0
37057,2019-10-02,894,0,894,71,965,965,0,0
37058,2019-10-02,417,0,417,41,458,458,0,0
37059,2019-10-02,1305,0,1305,130,1435,1435,0,0
37060,2019-10-02,773,0,773,77,850,850,0,0
37061,2019-10-02,503,0,503,40,543,543,0,0
37062,2019-10-02,167,0,167,13,180,180,0,0
37063,2019-10-02,204,0,204,16,220,220,0,0
37064,2019-10-02,2839,0,2839,227,3066,0,0,3066
37065,2019-10-02,1855,0,1855,185,2040,2040,0,0
37066,2019-10-02,1746,0,1746,139,1885,1885,0,0
37067,2019-10-02,1315,0,1315,131,1446,1446,0,0
37068,2019-10-02,297,0,297,29,326,326,0,0
37069,2019-10-02,-773,0,-773,-77,-850,-850,0,0
37070,2019-10-02,773,0,773,77,850,850,0,0
37071,2019-10-02,982,0,982,78,1060,1060,0,0
37072,2019-10-02,427,0,427,34,461,461,0,0
37073,2019-10-02,855,0,855,68,923,923,0,0
37074,2019-10-02,705,0,705,56,761,761,0,0
37075,2019-10-02,195,0,195,19,214,214,0,0
37076,2019-10-02,927,0,927,74,1001,1001,0,0
37077,2019-10-02,593,0,593,47,640,640,0,0
37078,2019-10-02,773,0,773,77,850,850,0,0
37079,2019-10-02,400,0,400,32,432,432,0,0
37080,2019-10-02,773,0,773,77,850,850,0,0
37081,2019-10-02,389,0,389,38,427,427,0,0
37082,2019-10-02,141,0,141,11,152,152,0,0
37083,2019-10-02,773,0,773,77,850,850,0,0
37084,2019-10-02,596,0,596,47,643,643,0,0
37085,2019-10-02,773,0,773,77,850,0,850,0
37086,2019-10-02,612,0,612,48,660,660,0,0
37087,2019-10-02,343,0,343,27,370,370,0,0
37088,2019-10-02,491,0,491,39,530,530,0,0
37089,2019-10-02,370,0,370,29,399,399,0,0
37090,2019-10-02,3854,0,3854,333,4187,0,4187,0
37091,2019-10-02,773,0,773,77,850,850,0,0
37092,2019-10-02,278,0,278,27,305,305,0,0
37093,2019-10-02,149,0,149,11,160,160,0,0
37094,2019-10-02,681,0,681,54,735,735,0,0
37095,2019-10-02,149,0,149,11,160,160,0,0
37096,2019-10-02,141,0,141,11,152,152,0,0
37097,2019-10-02,1546,0,1546,154,1700,1700,0,0
37098,2019-10-02,176,0,176,14,190,190,0,0
37099,2019-10-02,176,0,176,14,190,190,0,0
37100,2019-10-02,1327,0,1327,106,1433,1433,0,0
37101,2019-10-02,102,0,102,8,110,110,0,0
37102,2019-10-03,547,0,547,43,590,0,0,590
37103,2019-10-03,1465,0,1465,146,1611,1611,0,0
37104,2019-10-03,705,0,705,70,775,775,0,0
37105,2019-10-03,390,0,390,39,429,429,0,0
37106,2019-10-03,779,0,779,77,856,856,0,0
37107,2019-10-03,1021,0,1021,102,1123,1123,0,0
37108,2019-10-03,1216,0,1216,97,1313,1313,0,0
37109,2019-10-03,1133,0,1133,90,1223,1223,0,0
37110,2019-10-03,891,0,891,89,980,980,0,0
37111,2019-10-03,891,0,891,89,980,980,0,0
37112,2019-10-03,409,0,409,32,441,441,0,0
37113,2019-10-03,557,0,557,44,601,0,0,601
37114,2019-10-03,316,0,316,25,341,341,0,0
37115,2019-10-03,862,0,862,86,948,948,0,0
37116,2019-10-03,603,0,603,48,651,651,0,0
37117,2019-10-03,1334,0,1334,106,1440,1440,0,0
37118,2019-10-03,473,0,473,37,510,510,0,0
37119,2019-10-03,843,0,843,84,927,927,0,0
37120,2019-10-03,743,0,743,59,802,802,0,0
37121,2019-10-03,864,0,864,69,933,933,0,0
37122,2019-10-03,483,0,483,38,521,521,0,0
37123,2019-10-03,1325,0,1325,106,1431,0,1431,0
37124,2019-10-03,575,0,575,57,632,632,0,0
37125,2019-10-03,1235,0,1235,98,1333,1333,0,0
37126,2019-10-03,1021,0,1021,102,1123,1123,0,0
37127,2019-10-03,204,0,204,20,224,224,0,0
37128,2019-10-03,919,0,919,73,992,992,0,0
37129,2019-10-03,1662,0,1662,132,1794,1794,0,0
37130,2019-10-03,529,0,529,42,571,571,0,0
37131,2019-10-03,520,0,520,41,561,561,0,0
37132,2019-10-03,1198,0,1198,95,1293,1293,0,0
37133,2019-10-03,510,0,510,40,550,550,0,0
37134,2019-10-03,1113,-222,891,71,962,962,0,0
37135,2019-10-03,566,-56,510,40,550,550,0,0
37136,2019-10-03,318,0,318,25,343,343,0,0
37137,2019-10-03,1021,0,1021,81,1102,1102,0,0
37138,2019-10-03,269,0,269,21,290,290,0,0
37139,2019-10-03,1091,0,1091,109,1200,1200,0,0
37140,2019-10-03,204,0,204,20,224,224,0,0
37141,2019-10-03,474,0,474,37,511,511,0,0
37142,2019-10-03,436,0,436,34,470,470,0,0
37143,2019-10-03,344,0,344,27,371,371,0,0
37144,2019-10-03,558,0,558,44,602,602,0,0
37145,2019-10-03,658,0,658,65,723,723,0,0
37146,2019-10-03,732,0,732,73,805,805,0,0
37147,2019-10-03,463,0,463,46,509,509,0,0
37148,2019-10-03,344,0,344,34,378,0,378,0
37149,2019-10-03,1207,0,1207,96,1303,1303,0,0
37150,2019-10-03,370,0,370,37,407,407,0,0
37151,2019-10-03,325,0,325,26,351,351,0,0
37152,2019-10-03,695,0,695,69,764,764,0,0
37153,2019-10-03,741,0,741,74,815,815,0,0
37154,2019-10-03,1660,0,1660,166,1826,1826,0,0
37155,2019-10-03,743,0,743,59,802,802,0,0
37156,2019-10-03,659,0,659,52,711,711,0,0
37157,2019-10-03,139,0,139,11,150,150,0,0
37158,2019-10-03,176,0,176,14,190,190,0,0
37159,2019-10-03,856,0,856,68,924,924,0,0
37160,2019-10-03,1040,0,1040,83,1123,1123,0,0
37161,2019-10-03,761,0,761,60,821,821,0,0
37162,2019-10-03,343,0,343,27,370,370,0,0
37163,2019-10-03,473,0,473,47,520,520,0,0
37164,2019-10-03,1119,0,1119,111,1230,1230,0,0
37165,2019-10-03,1017,0,1017,101,1118,1118,0,0
37166,2019-10-03,1139,0,1139,113,1252,1252,0,0
37167,2019-10-03,3136,0,3136,313,3449,3449,0,0
37168,2019-10-03,306,0,306,24,330,330,0,0
37169,2019-10-03,1261,0,1261,126,1387,1387,0,0
37170,2019-10-03,205,0,205,16,221,0,221,0
37171,2019-10-03,288,0,288,23,311,311,0,0
37172,2019-10-03,593,0,593,47,640,640,0,0
37173,2019-10-03,909,0,909,72,981,981,0,0
37174,2019-10-03,1019,0,1019,81,1100,0,1100,0
37175,2019-10-03,529,0,529,42,571,571,0,0
37176,2019-10-03,335,0,335,26,361,361,0,0
37177,2019-10-03,242,0,242,19,261,261,0,0
37178,2019-10-03,587,0,587,46,633,633,0,0
37179,2019-10-03,632,0,632,50,682,682,0,0
37180,2019-10-03,669,0,669,53,722,722,0,0
37181,2019-10-03,818,0,818,65,883,883,0,0
37182,2019-10-03,186,0,186,14,200,200,0,0
37183,2019-10-03,261,0,261,20,281,281,0,0
37184,2019-10-03,456,0,456,36,492,0,492,0
37185,2019-10-03,3094,0,3094,277,3371,3371,0,0
37186,2019-10-03,2195,0,2195,201,2396,0,2396,0
37187,2019-10-03,2319,0,2319,231,2550,0,2550,0
37188,2019-10-03,2319,0,2319,231,2550,2550,0,0
37189,2019-10-03,446,0,446,35,481,481,0,0
37190,2019-10-03,370,0,370,29,399,399,0,0
37191,2019-10-03,158,0,158,12,170,170,0,0
37192,2019-10-03,370,0,370,29,399,399,0,0
37193,2019-10-03,1114,0,1114,89,1203,1203,0,0
37194,2019-10-03,1012,0,1012,80,1092,1092,0,0
37195,2019-10-03,186,0,186,14,200,200,0,0
37196,2019-10-03,446,0,446,35,481,481,0,0
37197,2019-10-03,1337,0,1337,133,1470,1470,0,0
37198,2019-10-03,604,0,604,48,652,652,0,0
37199,2019-10-03,139,0,139,11,150,150,0,0
37200,2019-10-03,660,0,660,52,712,712,0,0
37201,2019-10-03,260,0,260,20,280,280,0,0
37202,2019-10-03,491,0,491,49,540,540,0,0
37203,2019-10-03,370,0,370,37,407,407,0,0
37204,2019-10-03,370,0,370,37,407,407,0,0
37205,2019-10-03,1198,0,1198,95,1293,1293,0,0
37206,2019-10-03,334,0,334,26,360,360,0,0
37207,2019-10-03,418,0,418,33,451,451,0,0
37208,2019-10-03,2319,0,2319,231,2550,0,0,2550
37209,2019-10-03,773,0,773,77,850,850,0,0
37210,2019-10-03,538,0,538,43,581,581,0,0
37211,2019-10-03,334,0,334,26,360,360,0,0
37212,2019-10-03,1464,0,1464,146,1610,1610,0,0
37213,2019-10-03,1086,0,1086,86,1172,1172,0,0
37214,2019-10-03,1065,0,1065,106,1171,0,0,1171
37215,2019-10-03,519,0,519,51,570,570,0,0
37216,2019-10-03,1355,0,1355,108,1463,1463,0,0
37217,2019-10-03,773,0,773,77,850,850,0,0
37218,2019-10-03,344,0,344,27,371,0,371,0
37219,2019-10-03,455,0,455,45,500,500,0,0
37220,2019-10-03,102,0,102,8,110,110,0,0
37221,2019-10-03,2590,0,2590,259,2849,2849,0,0
37222,2019-10-03,733,0,733,58,791,791,0,0
37223,2019-10-03,399,0,399,31,430,430,0,0
37224,2019-10-03,1705,0,1705,170,1875,0,1875,0
37225,2019-10-03,353,0,353,28,381,381,0,0
37226,2019-10-03,519,0,519,51,570,570,0,0
37227,2019-10-03,630,0,630,63,693,693,0,0
37228,2019-10-03,773,0,773,77,850,850,0,0
37229,2019-10-03,1546,0,1546,154,1700,1700,0,0
37230,2019-10-03,1075,0,1075,86,1161,1161,0,0
37231,2019-10-03,343,0,343,27,370,370,0,0
37232,2019-10-03,-2319,0,-2319,-231,-2550,-2550,0,0
37233,2019-10-03,1622,-162,1460,146,1606,0,0,1606
37234,2019-10-03,307,0,307,30,337,337,0,0
37235,2019-10-03,1074,0,1074,107,1181,1181,0,0
37236,2019-10-03,861,0,861,68,929,929,0,0
37237,2019-10-03,861,0,861,86,947,947,0,0
37238,2019-10-03,861,0,861,86,947,947,0,0
37239,2019-10-03,-861,0,-861,-86,-947,-947,0,0
37240,2019-10-03,204,0,204,16,220,220,0,0
37241,2019-10-03,370,0,370,37,407,407,0,0
37242,2019-10-03,233,0,233,18,251,251,0,0
37243,2019-10-03,1546,0,1546,154,1700,1700,0,0
37244,2019-10-03,1558,0,1558,155,1713,1713,0,0
37245,2019-10-03,370,0,370,37,407,407,0,0
37246,2019-10-04,269,0,269,26,295,295,0,0
37247,2019-10-04,456,0,456,36,492,492,0,0
37248,2019-10-04,706,0,706,70,776,776,0,0
37249,2019-10-04,417,0,417,33,450,450,0,0
37250,2019-10-04,1040,0,1040,83,1123,1123,0,0
37251,2019-10-04,632,0,632,50,682,682,0,0
37252,2019-10-04,891,0,891,89,980,980,0,0
37253,2019-10-04,1782,0,1782,178,1960,0,1960,0
37254,2019-10-04,483,0,483,48,531,531,0,0
37255,2019-10-04,1782,0,1782,178,1960,1960,0,0
37256,2019-10-04,1782,0,1782,178,1960,1960,0,0
37257,2019-10-04,1347,0,1347,134,1481,0,1481,0
37258,2019-10-04,668,0,668,53,721,721,0,0
37259,2019-10-04,891,0,891,89,980,980,0,0
37260,2019-10-04,186,0,186,14,200,0,0,200
37261,2019-10-04,1890,0,1890,189,2079,2079,0,0
37262,2019-10-04,464,0,464,37,501,0,501,0
37263,2019-10-04,818,0,818,65,883,883,0,0
37264,2019-10-04,900,0,900,72,972,972,0,0
37265,2019-10-04,465,0,465,37,502,502,0,0
37266,2019-10-04,945,0,945,94,1039,1039,0,0
37267,2019-10-04,891,0,891,89,980,980,0,0
37268,2019-10-04,826,0,826,66,892,892,0,0
37269,2019-10-04,773,0,773,77,850,850,0,0
37270,2019-10-04,992,0,992,79,1071,1071,0,0
37271,2019-10-04,1879,0,1879,150,2029,2029,0,0
37272,2019-10-04,278,0,278,22,300,300,0,0
37273,2019-10-04,714,0,714,57,771,771,0,0
37274,2019-10-04,679,0,679,67,746,746,0,0
37275,2019-10-04,180,0,180,14,194,194,0,0
37276,2019-10-04,334,0,334,26,360,0,0,360
37277,2019-10-04,1058,0,1058,84,1142,1142,0,0
37278,2019-10-04,501,0,501,50,551,551,0,0
37279,2019-10-04,667,0,667,66,733,733,0,0
37280,2019-10-04,3330,0,3330,333,3663,3663,0,0
37281,2019-10-04,816,0,816,65,881,881,0,0
37282,2019-10-04,1309,0,1309,104,1413,1413,0,0
37283,2019-10-04,1504,0,1504,120,1624,1624,0,0
37284,2019-10-04,806,0,806,80,886,0,0,886
37285,2019-10-04,510,0,510,51,561,561,0,0
37286,2019-10-04,891,0,891,89,980,980,0,0
37287,2019-10-04,956,0,956,76,1032,1032,0,0
37288,2019-10-04,538,0,538,43,581,581,0,0
37289,2019-10-04,622,0,622,49,671,671,0,0
37290,2019-10-04,116,0,116,9,125,0,125,0
37291,2019-10-04,613,0,613,49,662,0,0,662
37292,2019-10-04,1589,0,1589,127,1716,1716,0,0
37293,2019-10-04,306,0,306,24,330,330,0,0
37294,2019-10-04,352,-35,317,25,342,342,0,0
37295,2019-10-04,761,0,761,60,821,821,0,0
37296,2019-10-04,733,0,733,58,791,791,0,0
37297,2019-10-04,1484,0,1484,118,1602,1602,0,0
37298,2019-10-04,288,0,288,23,311,311,0,0
37299,2019-10-04,306,0,306,24,330,330,0,0
37300,2019-10-04,891,0,891,89,980,980,0,0
37301,2019-10-04,139,0,139,13,152,152,0,0
37302,2019-10-04,556,0,556,55,611,0,611,0
37303,2019-10-04,529,0,529,42,571,0,571,0
37304,2019-10-04,343,0,343,27,370,370,0,0
37305,2019-10-04,891,0,891,89,980,980,0,0
37306,2019-10-04,622,0,622,49,671,0,0,671
37307,2019-10-04,891,0,891,89,980,980,0,0
37308,2019-10-04,390,-39,351,28,379,0,0,379
37309,2019-10-04,149,0,149,14,163,163,0,0
37310,2019-10-04,269,0,269,26,295,295,0,0
37311,2019-10-04,603,0,603,60,663,663,0,0
37312,2019-10-04,891,0,891,89,980,980,0,0
37313,2019-10-04,3564,0,3564,356,3920,3920,0,0
37314,2019-10-04,556,0,556,44,600,600,0,0
37315,2019-10-04,1419,0,1419,141,1560,1560,0,0
37316,2019-10-04,835,0,835,66,901,901,0,0
37317,2019-10-04,232,0,232,18,250,250,0,0
37318,2019-10-04,1841,0,1841,184,2025,2025,0,0
37319,2019-10-04,510,0,510,40,550,550,0,0
37320,2019-10-04,400,0,400,32,432,432,0,0
37321,2019-10-04,1327,0,1327,106,1433,1433,0,0
37322,2019-10-04,789,0,789,63,852,0,0,852
37323,2019-10-04,464,0,464,37,501,501,0,0
37324,2019-10-04,279,0,279,22,301,301,0,0
37325,2019-10-04,483,0,483,38,521,521,0,0
37326,2019-10-04,946,0,946,75,1021,1021,0,0
37327,2019-10-04,1289,0,1289,103,1392,1392,0,0
37328,2019-10-04,483,-483,0,0,0,0,0,0
37329,2019-10-04,2174,0,2174,217,2391,0,0,2391
37330,2019-10-04,808,0,808,64,872,872,0,0
37331,2019-10-04,688,0,688,55,743,743,0,0
37332,2019-10-04,668,0,668,53,721,721,0,0
37333,2019-10-04,1092,0,1092,109,1201,1201,0,0
37334,2019-10-04,371,0,371,29,400,400,0,0
37335,2019-10-04,780,0,780,62,842,842,0,0
37336,2019-10-04,900,0,900,72,972,972,0,0
37337,2019-10-04,371,0,371,37,408,408,0,0
37338,2019-10-04,446,0,446,35,481,481,0,0
37339,2019-10-04,740,0,740,74,814,0,814,0
37340,2019-10-04,352,0,352,35,387,387,0,0
37341,2019-10-04,464,0,464,37,501,501,0,0
37342,2019-10-04,1077,0,1077,86,1163,1163,0,0
37343,2019-10-04,650,0,650,52,702,702,0,0
37344,2019-10-04,362,0,362,28,390,390,0,0
37345,2019-10-04,668,0,668,53,721,721,0,0
37346,2019-10-04,621,0,621,62,683,683,0,0
37347,2019-10-04,409,0,409,32,441,441,0,0
37348,2019-10-04,733,0,733,58,791,791,0,0
37349,2019-10-04,842,0,842,84,926,926,0,0
37350,2019-10-04,158,0,158,12,170,170,0,0
37351,2019-10-04,1437,0,1437,114,1551,1551,0,0
37352,2019-10-04,1256,0,1256,125,1381,1381,0,0
37353,2019-10-04,891,0,891,89,980,980,0,0
37354,2019-10-04,188,0,188,15,203,203,0,0
37355,2019-10-04,528,0,528,52,580,580,0,0
37356,2019-10-04,946,0,946,94,1040,1040,0,0
37357,2019-10-04,382,0,382,30,412,412,0,0
37358,2019-10-04,334,0,334,26,360,360,0,0
37359,2019-10-04,514,0,514,41,555,555,0,0
37360,2019-10-04,362,0,362,28,390,390,0,0
37361,2019-10-04,1216,0,1216,97,1313,1313,0,0
37362,2019-10-04,473,0,473,37,510,510,0,0
37363,2019-10-04,1334,0,1334,133,1467,0,0,1467
37364,2019-10-04,167,0,167,13,180,180,0,0
37365,2019-10-04,158,0,158,12,170,170,0,0
37366,2019-10-04,962,0,962,96,1058,1058,0,0
37367,2019-10-04,167,0,167,16,183,183,0,0
37368,2019-10-04,800,0,800,64,864,864,0,0
37369,2019-10-04,640,0,640,51,691,691,0,0
37370,2019-10-04,370,0,370,37,407,0,407,0
37371,2019-10-04,445,0,445,35,480,480,0,0
37372,2019-10-04,269,0,269,21,290,290,0,0
37373,2019-10-04,510,0,510,40,550,550,0,0
37374,2019-10-04,696,-69,627,50,677,677,0,0
37375,2019-10-04,773,0,773,77,850,850,0,0
37376,2019-10-04,705,0,705,70,775,775,0,0
37377,2019-10-04,945,0,945,75,1020,1020,0,0
37378,2019-10-04,556,0,556,44,600,600,0,0
37379,2019-10-04,139,-13,126,10,136,136,0,0
37380,2019-10-04,2319,0,2319,231,2550,2550,0,0
37381,2019-10-04,-2319,0,-2319,-231,-2550,-2550,0,0
37382,2019-10-04,1002,0,1002,80,1082,1082,0,0
37383,2019-10-04,2319,0,2319,231,2550,0,2550,0
37384,2019-10-04,445,0,445,35,480,480,0,0
37385,2019-10-04,408,0,408,32,440,440,0,0
37386,2019-10-04,1546,0,1546,154,1700,1700,0,0
37387,2019-10-04,965,0,965,77,1042,0,0,1042
37388,2019-10-04,773,0,773,77,850,0,850,0
37389,2019-10-04,538,0,538,43,581,581,0,0
37390,2019-10-04,889,0,889,88,977,977,0,0
37391,2019-10-04,307,-30,277,22,299,299,0,0
37392,2019-10-04,1742,0,1742,174,1916,1916,0,0
37393,2019-10-04,1546,0,1546,154,1700,1700,0,0
37394,2019-10-04,537,0,537,53,590,0,0,590
37395,2019-10-04,773,0,773,77,850,850,0,0
37396,2019-10-04,773,0,773,77,850,850,0,0
37397,2019-10-04,773,0,773,77,850,850,0,0
37398,2019-10-04,773,0,773,77,850,850,0,0
37399,2019-10-04,916,0,916,83,999,999,0,0
37400,2019-10-04,2092,0,2092,197,2289,2289,0,0
37401,2019-10-04,2319,0,2319,231,2550,0,2550,0
37402,2019-10-04,389,0,389,38,427,427,0,0
37403,2019-10-04,297,0,297,23,320,320,0,0
37404,2019-10-04,1546,0,1546,154,1700,1700,0,0
37405,2019-10-04,556,0,556,55,611,611,0,0
37406,2019-10-04,3092,0,3092,309,3401,0,0,3401
37407,2019-10-04,306,0,306,24,330,330,0,0
37408,2019-10-04,593,0,593,47,640,0,0,640
37409,2019-10-04,2319,0,2319,231,2550,2550,0,0
37410,2019-10-04,798,0,798,63,861,861,0,0
37411,2019-10-04,819,0,819,65,884,884,0,0
37412,2019-10-05,-529,0,-529,-42,-571,-571,0,0
37413,2019-10-05,778,0,778,77,855,855,0,0
37414,2019-10-05,586,0,586,46,632,632,0,0
37415,2019-10-05,576,0,576,46,622,622,0,0
37416,2019-10-05,-778,0,-778,-77,-855,-855,0,0
37417,2019-10-05,778,-77,701,70,771,771,0,0
37418,2019-10-05,529,0,529,42,571,571,0,0
37419,2019-10-05,742,0,742,59,801,801,0,0
37420,2019-10-05,529,-52,477,38,515,515,0,0
37421,2019-10-05,548,0,548,43,591,591,0,0
37422,2019-10-05,658,0,658,65,723,723,0,0
37423,2019-10-05,1171,0,1171,93,1264,1264,0,0
37424,2019-10-05,826,0,826,66,892,892,0,0
37425,2019-10-05,612,0,612,48,660,660,0,0
37426,2019-10-05,1782,0,1782,178,1960,0,0,1960
37427,2019-10-05,491,0,491,49,540,540,0,0
37428,2019-10-05,279,0,279,22,301,0,301,0
37429,2019-10-05,1782,0,1782,178,1960,1960,0,0
37430,2019-10-05,936,0,936,74,1010,1010,0,0
37431,2019-10-05,269,0,269,21,290,290,0,0
37432,2019-10-05,724,0,724,57,781,781,0,0
37433,2019-10-05,585,0,585,58,643,643,0,0
37434,2019-10-05,2319,0,2319,231,2550,0,0,2550
37435,2019-10-05,928,0,928,74,1002,1002,0,0
37436,2019-10-05,141,0,141,11,152,152,0,0
37437,2019-10-05,2156,0,2156,172,2328,2328,0,0
37438,2019-10-05,669,0,669,53,722,722,0,0
37439,2019-10-05,167,0,167,13,180,180,0,0
37440,2019-10-05,417,0,417,33,450,450,0,0
37441,2019-10-05,260,-26,234,18,252,252,0,0
37442,2019-10-05,1546,0,1546,154,1700,1700,0,0
37443,2019-10-05,773,0,773,77,850,0,850,0
37444,2019-10-05,288,0,288,23,311,311,0,0
37445,2019-10-05,307,0,307,24,331,331,0,0
37446,2019-10-05,631,0,631,50,681,681,0,0
37447,2019-10-05,381,0,381,30,411,411,0,0
37448,2019-10-05,1447,0,1447,144,1591,1591,0,0
37449,2019-10-05,779,0,779,62,841,841,0,0
37450,2019-10-05,752,0,752,60,812,812,0,0
37451,2019-10-05,1546,0,1546,154,1700,1700,0,0
37452,2019-10-05,548,0,548,43,591,591,0,0
37453,2019-10-05,957,0,957,95,1052,1052,0,0
37454,2019-10-05,891,0,891,89,980,980,0,0
37455,2019-10-05,1222,0,1222,122,1344,1344,0,0
37456,2019-10-05,2555,0,2555,255,2810,2810,0,0
37457,2019-10-05,1520,0,1520,121,1641,1641,0,0
37458,2019-10-05,1160,0,1160,92,1252,1252,0,0
37459,2019-10-05,1261,0,1261,126,1387,0,1387,0
37460,2019-10-05,891,0,891,89,980,980,0,0
37461,2019-10-05,816,0,816,65,881,881,0,0
37462,2019-10-05,846,0,846,67,913,913,0,0
37463,2019-10-05,167,0,167,16,183,183,0,0
37464,2019-10-05,371,0,371,29,400,400,0,0
37465,2019-10-05,1889,0,1889,188,2077,2077,0,0
37466,2019-10-05,575,0,575,46,621,621,0,0
37467,2019-10-05,1782,0,1782,178,1960,1960,0,0
37468,2019-10-05,1031,0,1031,82,1113,0,1113,0
37469,2019-10-05,251,0,251,25,276,276,0,0
37470,2019-10-05,167,0,167,13,180,180,0,0
37471,2019-10-05,1234,0,1234,98,1332,1332,0,0
37472,2019-10-05,390,0,390,31,421,421,0,0
37473,2019-10-05,353,0,353,35,388,388,0,0
37474,2019-10-05,390,0,390,31,421,421,0,0
37475,2019-10-05,1546,0,1546,154,1700,1700,0,0
37476,2019-10-05,743,0,743,59,802,802,0,0
37477,2019-10-05,891,0,891,89,980,980,0,0
37478,2019-10-05,344,0,344,27,371,371,0,0
37479,2019-10-05,1782,0,1782,178,1960,1960,0,0
37480,2019-10-05,891,0,891,89,980,980,0,0
37481,2019-10-05,891,0,891,89,980,980,0,0
37482,2019-10-05,854,0,854,68,922,922,0,0
37483,2019-10-05,696,0,696,55,751,751,0,0
37484,2019-10-05,1049,0,1049,83,1132,1132,0,0
37485,2019-10-05,2673,0,2673,267,2940,2940,0,0
37486,2019-10-05,1123,0,1123,89,1212,1212,0,0
37487,2019-10-05,891,0,891,89,980,980,0,0
37488,2019-10-05,269,0,269,21,290,290,0,0
37489,2019-10-05,260,-52,208,16,224,224,0,0
37490,2019-10-05,279,0,279,27,306,306,0,0
37491,2019-10-05,548,0,548,43,591,591,0,0
37492,2019-10-05,594,0,594,47,641,641,0,0
37493,2019-10-05,288,-57,231,18,249,249,0,0
37494,2019-10-05,204,0,204,20,224,224,0,0
37495,2019-10-05,112,0,112,8,120,120,0,0
37496,2019-10-05,2273,-227,2046,163,2209,0,2209,0
37497,2019-10-05,1197,-119,1078,107,1185,0,0,1185
37498,2019-10-05,936,0,936,74,1010,1010,0,0
37499,2019-10-05,1040,0,1040,83,1123,1123,0,0
37500,2019-10-05,584,0,584,46,630,630,0,0
37501,2019-10-05,1364,0,1364,136,1500,1500,0,0
37502,2019-10-05,1956,0,1956,156,2112,2112,0,0
37503,2019-10-05,557,0,557,44,601,601,0,0
37504,2019-10-05,622,0,622,49,671,671,0,0
37505,2019-10-05,982,0,982,98,1080,1080,0,0
37506,2019-10-05,250,0,250,25,275,275,0,0
37507,2019-10-05,232,0,232,18,250,250,0,0
37508,2019-10-05,640,0,640,51,691,691,0,0
37509,2019-10-05,773,0,773,77,850,850,0,0
37510,2019-10-05,563,0,563,56,619,619,0,0
37511,2019-10-05,576,0,576,46,622,622,0,0
37512,2019-10-05,1636,0,1636,130,1766,0,1766,0
37513,2019-10-05,920,0,920,73,993,0,0,993
37514,2019-10-05,167,-16,151,12,163,163,0,0
37515,2019-10-05,116,0,116,9,125,125,0,0
37516,2019-10-05,769,0,769,76,845,845,0,0
37517,2019-10-05,2858,0,2858,228,3086,3086,0,0
37518,2019-10-05,269,0,269,21,290,290,0,0
37519,2019-10-05,399,0,399,31,430,430,0,0
37520,2019-10-05,456,0,456,36,492,492,0,0
37521,2019-10-05,556,0,556,44,600,600,0,0
37522,2019-10-05,547,0,547,43,590,590,0,0
37523,2019-10-05,575,0,575,46,621,621,0,0
37524,2019-10-05,141,0,141,11,152,152,0,0
37525,2019-10-05,1149,0,1149,114,1263,1263,0,0
37526,2019-10-05,224,0,224,17,241,241,0,0
37527,2019-10-05,214,0,214,17,231,231,0,0
37528,2019-10-05,325,0,325,26,351,351,0,0
37529,2019-10-05,326,0,326,26,352,352,0,0
37530,2019-10-05,324,0,324,25,349,349,0,0
37531,2019-10-05,1095,0,1095,87,1182,1182,0,0
37532,2019-10-05,389,0,389,38,427,427,0,0
37533,2019-10-05,584,0,584,46,630,630,0,0
37534,2019-10-05,149,0,149,11,160,160,0,0
37535,2019-10-05,2083,0,2083,208,2291,2291,0,0
37536,2019-10-05,417,0,417,41,458,458,0,0
37537,2019-10-05,474,0,474,47,521,521,0,0
37538,2019-10-05,389,0,389,38,427,427,0,0
37539,2019-10-05,399,0,399,39,438,438,0,0
37540,2019-10-05,370,0,370,37,407,407,0,0
37541,2019-10-05,389,0,389,38,427,427,0,0
37542,2019-10-05,491,0,491,49,540,540,0,0
37543,2019-10-05,399,0,399,39,438,438,0,0
37544,2019-10-05,399,0,399,39,438,438,0,0
37545,2019-10-05,491,0,491,49,540,540,0,0
37546,2019-10-05,370,0,370,37,407,407,0,0
37547,2019-10-05,491,0,491,49,540,540,0,0
37548,2019-10-05,1018,0,1018,101,1119,1119,0,0
37549,2019-10-05,260,0,260,20,280,280,0,0
37550,2019-10-05,546,0,546,54,600,600,0,0
37551,2019-10-05,695,0,695,55,750,750,0,0
37552,2019-10-05,455,0,455,36,491,491,0,0
37553,2019-10-05,102,0,102,10,112,112,0,0
37554,2019-10-05,826,0,826,66,892,892,0,0
37555,2019-10-05,967,0,967,77,1044,1044,0,0
37556,2019-10-05,501,0,501,40,541,0,0,541
37557,2019-10-05,1028,0,1028,53,1081,1081,0,0
37558,2019-10-05,389,0,389,38,427,427,0,0
37559,2019-10-05,94,-9,85,6,91,91,0,0
37560,2019-10-05,509,0,509,50,559,559,0,0
37561,2019-10-05,491,0,491,49,540,540,0,0
37562,2019-10-05,3439,0,3439,343,3782,3782,0,0
37563,2019-10-05,615,-61,554,44,598,598,0,0
37564,2019-10-05,1315,0,1315,131,1446,1446,0,0
37565,2019-10-05,954,0,954,95,1049,1049,0,0
37566,2019-10-05,790,0,790,63,853,853,0,0
37567,2019-10-05,334,0,334,26,360,360,0,0
37568,2019-10-05,557,0,557,44,601,601,0,0
37569,2019-10-05,773,0,773,77,850,850,0,0
37570,2019-10-05,370,0,370,37,407,0,407,0
37571,2019-10-05,773,0,773,77,850,0,850,0
37572,2019-10-05,556,0,556,44,600,600,0,0
37573,2019-10-05,574,0,574,57,631,0,631,0
37574,2019-10-05,1546,0,1546,154,1700,1700,0,0
37575,2019-10-05,473,0,473,37,510,0,0,510
37576,2019-10-05,501,0,501,40,541,541,0,0
37577,2019-10-05,696,0,696,55,751,751,0,0
37578,2019-10-05,1546,0,1546,154,1700,0,1700,0
37579,2019-10-05,308,0,308,24,332,332,0,0
37580,2019-10-05,1403,0,1403,140,1543,1543,0,0
37581,2019-10-05,139,0,139,13,152,152,0,0
37582,2019-10-05,362,0,362,28,390,0,0,390
37583,2019-10-05,773,0,773,77,850,850,0,0
37584,2019-10-05,2530,0,2530,253,2783,2783,0,0
37585,2019-10-05,273,0,273,27,300,300,0,0
37586,2019-10-05,330,0,330,26,356,356,0,0
37587,2019-10-05,418,0,418,33,451,451,0,0
37588,2019-10-05,1017,0,1017,101,1118,1118,0,0
37589,2019-10-05,316,0,316,31,347,347,0,0
37590,2019-10-05,362,0,362,28,390,390,0,0
37591,2019-10-05,513,0,513,41,554,554,0,0
37592,2019-10-05,482,0,482,48,530,530,0,0
37593,2019-10-05,436,0,436,34,470,0,0,470
37594,2019-10-05,139,0,139,11,150,150,0,0
37595,2019-10-05,519,0,519,41,560,560,0,0
37596,2019-10-05,297,0,297,23,320,320,0,0
37597,2019-10-05,149,0,149,11,160,160,0,0
37598,2019-10-05,273,0,273,27,300,300,0,0
37599,2019-10-05,1198,0,1198,95,1293,1293,0,0
37600,2019-10-05,1185,0,1185,118,1303,0,1303,0
37601,2019-10-05,1546,0,1546,154,1700,1700,0,0
37602,2019-10-05,241,0,241,19,260,260,0,0
37603,2019-10-05,705,0,705,56,761,0,0,761
37604,2019-10-05,327,0,327,26,353,353,0,0
37605,2019-10-05,510,0,510,40,550,550,0,0
37606,2019-10-05,773,0,773,77,850,850,0,0
37607,2019-10-06,695,0,695,55,750,750,0,0
37608,2019-10-06,854,0,854,68,922,0,922,0
37609,2019-10-06,427,0,427,34,461,461,0,0
37610,2019-10-06,649,0,649,51,700,700,0,0
37611,2019-10-06,594,0,594,47,641,641,0,0
37612,2019-10-06,139,0,139,11,150,150,0,0
37613,2019-10-06,872,0,872,87,959,959,0,0
37614,2019-10-06,584,0,584,46,630,630,0,0
37615,2019-10-06,112,0,112,8,120,120,0,0
37616,2019-10-06,408,0,408,32,440,440,0,0
37617,2019-10-06,891,0,891,89,980,980,0,0
37618,2019-10-06,724,0,724,57,781,781,0,0
37619,2019-10-06,483,0,483,38,521,521,0,0
37620,2019-10-06,705,0,705,56,761,761,0,0
37621,2019-10-06,1782,0,1782,178,1960,1960,0,0
37622,2019-10-06,371,0,371,29,400,400,0,0
37623,2019-10-06,253,0,253,20,273,273,0,0
37624,2019-10-06,289,0,289,23,312,312,0,0
37625,2019-10-06,891,0,891,89,980,980,0,0
37626,2019-10-06,269,0,269,21,290,290,0,0
37627,2019-10-06,1235,0,1235,98,1333,1333,0,0
37628,2019-10-06,427,0,427,34,461,461,0,0
37629,2019-10-06,2238,0,2238,223,2461,2461,0,0
37630,2019-10-06,556,0,556,44,600,600,0,0
37631,2019-10-06,529,0,529,42,571,571,0,0
37632,2019-10-06,752,0,752,60,812,0,0,812
37633,2019-10-06,891,0,891,89,980,980,0,0
37634,2019-10-06,1782,0,1782,178,1960,1960,0,0
37635,2019-10-06,660,0,660,52,712,0,712,0
37636,2019-10-06,2969,0,2969,237,3206,0,3206,0
37637,2019-10-06,1114,0,1114,89,1203,0,1203,0
37638,2019-10-06,1384,0,1384,110,1494,1494,0,0
37639,2019-10-06,1810,0,1810,144,1954,0,1954,0
37640,2019-10-06,353,0,353,28,381,381,0,0
37641,2019-10-06,232,0,232,18,250,250,0,0
37642,2019-10-06,474,0,474,47,521,521,0,0
37643,2019-10-06,620,0,620,62,682,682,0,0
37644,2019-10-06,436,0,436,34,470,470,0,0
37645,2019-10-06,177,0,177,14,191,191,0,0
37646,2019-10-06,1132,0,1132,90,1222,0,1222,0
37647,2019-10-06,891,0,891,89,980,980,0,0
37648,2019-10-06,502,0,502,40,542,542,0,0
37649,2019-10-06,334,0,334,26,360,360,0,0
37650,2019-10-06,251,0,251,20,271,271,0,0
37651,2019-10-06,381,0,381,30,411,411,0,0
37652,2019-10-06,734,0,734,58,792,792,0,0
37653,2019-10-06,390,0,390,31,421,421,0,0
37654,2019-10-06,1123,0,1123,89,1212,1212,0,0
37655,2019-10-06,1289,0,1289,128,1417,1417,0,0
37656,2019-10-06,1289,0,1289,128,1417,1417,0,0
37657,2019-10-06,-1289,0,-1289,-128,-1417,-1417,0,0
37658,2019-10-06,316,0,316,25,341,341,0,0
37659,2019-10-06,611,0,611,61,672,672,0,0
37660,2019-10-06,474,0,474,37,511,511,0,0
37661,2019-10-06,375,0,375,30,405,405,0,0
37662,2019-10-06,1023,0,1023,81,1104,1104,0,0
37663,2019-10-06,204,0,204,16,220,220,0,0
37664,2019-10-06,1040,-104,936,93,1029,1029,0,0
37665,2019-10-06,949,0,949,75,1024,1024,0,0
37666,2019-10-06,298,0,298,23,321,321,0,0
37667,2019-10-06,400,0,400,40,440,440,0,0
37668,2019-10-06,1382,0,1382,138,1520,0,1520,0
37669,2019-10-06,891,0,891,89,980,980,0,0
37670,2019-10-06,891,0,891,89,980,980,0,0
37671,2019-10-06,298,0,298,23,321,321,0,0
37672,2019-10-06,409,0,409,32,441,441,0,0
37673,2019-10-06,689,0,689,55,744,744,0,0
37674,2019-10-06,835,0,835,66,901,0,0,901
37675,2019-10-06,557,0,557,44,601,601,0,0
37676,2019-10-06,1087,0,1087,86,1173,0,1173,0
37677,2019-10-06,1935,0,1935,193,2128,2128,0,0
37678,2019-10-06,576,0,576,57,633,633,0,0
37679,2019-10-06,891,0,891,89,980,980,0,0
37680,2019-10-06,474,0,474,37,511,511,0,0
37681,2019-10-06,230,0,230,23,253,253,0,0
37682,2019-10-06,251,0,251,20,271,271,0,0
37683,2019-10-06,91,0,91,9,100,100,0,0
37684,2019-10-06,1334,0,1334,133,1467,1467,0,0
37685,2019-10-06,891,0,891,89,980,0,980,0
37686,2019-10-06,891,0,891,89,980,980,0,0
37687,2019-10-06,890,0,890,71,961,961,0,0
37688,2019-10-06,464,0,464,37,501,501,0,0
37689,2019-10-06,1399,0,1399,139,1538,1538,0,0
37690,2019-10-06,836,0,836,66,902,902,0,0
37691,2019-10-06,389,0,389,31,420,420,0,0
37692,2019-10-06,920,0,920,73,993,993,0,0
37693,2019-10-06,1708,0,1708,136,1844,1844,0,0
37694,2019-10-06,724,0,724,57,781,781,0,0
37695,2019-10-06,2163,0,2163,173,2336,0,0,2336
37696,2019-10-06,1068,0,1068,85,1153,1153,0,0
37697,2019-10-06,428,0,428,34,462,462,0,0
37698,2019-10-06,715,0,715,57,772,0,772,0
37699,2019-10-06,261,0,261,20,281,281,0,0
37700,2019-10-06,558,0,558,44,602,602,0,0
37701,2019-10-06,278,0,278,22,300,300,0,0
37702,2019-10-06,889,0,889,71,960,960,0,0
37703,2019-10-06,1307,0,1307,130,1437,1437,0,0
37704,2019-10-06,47,0,47,4,51,51,0,0
37705,2019-10-06,491,0,491,39,530,530,0,0
37706,2019-10-06,332,0,332,26,358,358,0,0
37707,2019-10-06,1000,0,1000,80,1080,1080,0,0
37708,2019-10-06,371,0,371,29,400,400,0,0
37709,2019-10-06,1240,0,1240,124,1364,1364,0,0
37710,2019-10-06,753,0,753,60,813,813,0,0
37711,2019-10-06,167,0,167,13,180,0,0,180
37712,2019-10-06,1362,0,1362,136,1498,1498,0,0
37713,2019-10-06,278,0,278,22,300,300,0,0
37714,2019-10-06,269,0,269,21,290,290,0,0
37715,2019-10-06,167,0,167,13,180,180,0,0
37716,2019-10-06,881,0,881,88,969,969,0,0
37717,2019-10-06,269,0,269,21,290,290,0,0
37718,2019-10-06,557,0,557,44,601,0,601,0
37719,2019-10-06,343,0,343,27,370,370,0,0
37720,2019-10-06,371,0,371,37,408,408,0,0
37721,2019-10-06,370,0,370,37,407,407,0,0
37722,2019-10-06,789,0,789,63,852,852,0,0
37723,2019-10-06,874,0,874,69,943,943,0,0
37724,2019-10-06,390,0,390,31,421,421,0,0
37725,2019-10-06,437,0,437,43,480,0,480,0
37726,2019-10-06,362,0,362,28,390,390,0,0
37727,2019-10-06,167,0,167,13,180,0,180,0
37728,2019-10-06,307,0,307,24,331,331,0,0
37729,2019-10-06,871,0,871,87,958,958,0,0
37730,2019-10-06,306,0,306,24,330,330,0,0
37731,2019-10-06,334,0,334,26,360,360,0,0
37732,2019-10-06,483,0,483,38,521,521,0,0
37733,2019-10-06,278,0,278,22,300,300,0,0
37734,2019-10-06,352,0,352,35,387,387,0,0
37735,2019-10-06,167,0,167,16,183,183,0,0
37736,2019-10-06,288,0,288,23,311,311,0,0
37737,2019-10-06,696,0,696,55,751,751,0,0
37738,2019-10-06,298,0,298,23,321,321,0,0
37739,2019-10-06,352,0,352,28,380,380,0,0
37740,2019-10-06,649,0,649,51,700,700,0,0
37741,2019-10-06,504,0,504,40,544,544,0,0
37742,2019-10-06,389,0,389,31,420,420,0,0
37743,2019-10-06,1059,0,1059,84,1143,0,1143,0
37744,2019-10-06,1046,0,1046,104,1150,1150,0,0
37745,2019-10-06,139,0,139,11,150,150,0,0
37746,2019-10-06,743,0,743,59,802,0,0,802
37747,2019-10-06,501,0,501,40,541,541,0,0
37748,2019-10-06,1290,0,1290,103,1393,1393,0,0
37749,2019-10-06,640,0,640,51,691,691,0,0
37750,2019-10-06,779,0,779,62,841,841,0,0
37751,2019-10-06,881,0,881,70,951,951,0,0
37752,2019-10-06,297,0,297,23,320,320,0,0
37753,2019-10-06,974,0,974,77,1051,1051,0,0
37754,2019-10-06,232,0,232,18,250,250,0,0
37755,2019-10-06,1129,0,1129,112,1241,0,1241,0
37756,2019-10-06,250,0,250,20,270,270,0,0
37757,2019-10-06,640,0,640,51,691,691,0,0
37758,2019-10-06,773,0,773,77,850,850,0,0
37759,2019-10-06,306,0,306,24,330,330,0,0
37760,2019-10-06,660,0,660,52,712,0,712,0
37761,2019-10-06,1876,0,1876,187,2063,0,2063,0
37762,2019-10-06,1084,0,1084,86,1170,1170,0,0
37763,2019-10-06,1546,0,1546,154,1700,1700,0,0
37764,2019-10-06,269,0,269,21,290,290,0,0
37765,2019-10-06,426,0,426,34,460,460,0,0
37766,2019-10-06,566,0,566,45,611,611,0,0
37767,2019-10-06,1546,0,1546,154,1700,0,0,1700
37768,2019-10-06,306,0,306,24,330,330,0,0
37769,2019-10-06,344,0,344,27,371,371,0,0
37770,2019-10-06,509,0,509,50,559,559,0,0
37771,2019-10-06,1096,0,1096,87,1183,0,1183,0
37772,2019-10-06,306,0,306,24,330,330,0,0
37773,2019-10-07,1577,0,1577,126,1703,0,1703,0
37774,2019-10-07,288,0,288,23,311,311,0,0
37775,2019-10-07,1782,0,1782,178,1960,1960,0,0
37776,2019-10-07,697,0,697,55,752,0,752,0
37777,2019-10-07,742,0,742,59,801,0,801,0
37778,2019-10-07,269,0,269,21,290,290,0,0
37779,2019-10-07,595,0,595,47,642,642,0,0
37780,2019-10-07,288,0,288,28,316,316,0,0
37781,2019-10-07,529,0,529,42,571,571,0,0
37782,2019-10-07,186,-37,149,11,160,160,0,0
37783,2019-10-07,1280,0,1280,102,1382,1382,0,0
37784,2019-10-07,1048,0,1048,83,1131,1131,0,0
37785,2019-10-07,408,0,408,32,440,0,0,440
37786,2019-10-07,1234,0,1234,123,1357,1357,0,0
37787,2019-10-07,891,0,891,89,980,980,0,0
37788,2019-10-07,1782,0,1782,178,1960,1960,0,0
37789,2019-10-07,891,0,891,89,980,980,0,0
37790,2019-10-07,167,0,167,13,180,180,0,0
37791,2019-10-07,652,0,652,52,704,704,0,0
37792,2019-10-07,370,0,370,37,407,407,0,0
37793,2019-10-07,269,0,269,21,290,290,0,0
37794,2019-10-07,278,0,278,22,300,300,0,0
37795,2019-10-07,-491,0,-491,-48,-539,0,-539,0
37796,2019-10-07,1105,0,1105,88,1193,1193,0,0
37797,2019-10-07,389,0,389,31,420,420,0,0
37798,2019-10-07,808,0,808,80,888,888,0,0
37799,2019-10-07,928,0,928,74,1002,1002,0,0
37800,2019-10-07,362,0,362,28,390,390,0,0
37801,2019-10-07,900,0,900,72,972,972,0,0
37802,2019-10-07,362,0,362,28,390,390,0,0
37803,2019-10-07,891,0,891,89,980,980,0,0
37804,2019-10-07,773,0,773,77,850,850,0,0
37805,2019-10-07,548,0,548,43,591,591,0,0
37806,2019-10-07,1256,0,1256,125,1381,1381,0,0
37807,2019-10-07,371,0,371,29,400,400,0,0
37808,2019-10-07,743,0,743,59,802,802,0,0
37809,2019-10-07,389,0,389,38,427,427,0,0
37810,2019-10-07,788,0,788,78,866,866,0,0
37811,2019-10-07,223,0,223,17,240,240,0,0
37812,2019-10-07,491,0,491,49,540,540,0,0
37813,2019-10-07,491,0,491,49,540,540,0,0
37814,2019-10-07,417,0,417,33,450,450,0,0
37815,2019-10-07,241,0,241,24,265,265,0,0
37816,2019-10-07,891,0,891,89,980,980,0,0
37817,2019-10-07,409,0,409,32,441,441,0,0
37818,2019-10-07,370,0,370,29,399,399,0,0
37819,2019-10-07,370,0,370,37,407,407,0,0
37820,2019-10-07,370,0,370,37,407,407,0,0
37821,2019-10-07,547,0,547,43,590,590,0,0
37822,2019-10-07,891,0,891,89,980,980,0,0
37823,2019-10-07,1799,0,1799,143,1942,1942,0,0
37824,2019-10-07,1058,0,1058,84,1142,1142,0,0
37825,2019-10-07,260,0,260,20,280,280,0,0
37826,2019-10-07,585,0,585,46,631,631,0,0
37827,2019-10-07,687,0,687,54,741,741,0,0
37828,2019-10-07,835,0,835,66,901,901,0,0
37829,2019-10-07,1669,-166,1503,120,1623,1623,0,0
37830,2019-10-07,493,0,493,39,532,532,0,0
37831,2019-10-07,1494,0,1494,119,1613,1613,0,0
37832,2019-10-07,630,0,630,63,693,693,0,0
37833,2019-10-07,1326,0,1326,132,1458,1458,0,0
37834,2019-10-07,455,0,455,36,491,491,0,0
37835,2019-10-07,344,0,344,27,371,371,0,0
37836,2019-10-07,288,0,288,23,311,311,0,0
37837,2019-10-07,1772,0,1772,177,1949,1949,0,0
37838,2019-10-07,297,0,297,23,320,320,0,0
37839,2019-10-07,861,0,861,68,929,929,0,0
37840,2019-10-07,919,0,919,73,992,0,992,0
37841,2019-10-07,389,0,389,38,427,0,427,0
37842,2019-10-07,399,0,399,31,430,0,430,0
37843,2019-10-07,695,0,695,55,750,750,0,0
37844,2019-10-07,742,0,742,59,801,801,0,0
37845,2019-10-07,260,0,260,20,280,280,0,0
37846,2019-10-07,484,0,484,38,522,522,0,0
37847,2019-10-07,501,0,501,40,541,541,0,0
37848,2019-10-07,334,0,334,26,360,360,0,0
37849,2019-10-07,232,0,232,18,250,250,0,0
37850,2019-10-07,381,0,381,30,411,411,0,0
37851,2019-10-07,1817,0,1817,145,1962,1962,0,0
37852,2019-10-07,204,0,204,16,220,220,0,0
37853,2019-10-07,409,0,409,32,441,441,0,0
37854,2019-10-07,251,0,251,20,271,271,0,0
37855,2019-10-07,316,0,316,31,347,347,0,0
37856,2019-10-07,538,0,538,43,581,581,0,0
37857,2019-10-07,418,0,418,33,451,451,0,0
37858,2019-10-07,1633,0,1633,130,1763,1763,0,0
37859,2019-10-07,1844,0,1844,184,2028,2028,0,0
37860,2019-10-07,594,0,594,47,641,641,0,0
37861,2019-10-07,539,0,539,43,582,0,582,0
37862,2019-10-07,1132,0,1132,90,1222,1222,0,0
37863,2019-10-07,891,0,891,89,980,0,980,0
37864,2019-10-07,362,0,362,28,390,390,0,0
37865,2019-10-07,937,0,937,74,1011,1011,0,0
37866,2019-10-07,446,0,446,35,481,481,0,0
37867,2019-10-07,1037,0,1037,103,1140,1140,0,0
37868,2019-10-07,1557,0,1557,155,1712,0,1712,0
37869,2019-10-07,631,-63,568,45,613,613,0,0
37870,2019-10-07,353,0,353,28,381,381,0,0
37871,2019-10-07,438,0,438,35,473,473,0,0
37872,2019-10-07,667,0,667,53,720,720,0,0
37873,2019-10-07,149,0,149,11,160,160,0,0
37874,2019-10-07,344,0,344,27,371,371,0,0
37875,2019-10-07,362,0,362,28,390,0,390,0
37876,2019-10-07,390,0,390,31,421,421,0,0
37877,2019-10-07,3092,0,3092,309,3401,3401,0,0
37878,2019-10-07,324,0,324,25,349,349,0,0
37879,2019-10-07,1862,0,1862,186,2048,0,0,2048
37880,2019-10-07,537,0,537,53,590,590,0,0
37881,2019-10-07,797,0,797,79,876,876,0,0
37882,2019-10-07,149,-14,135,10,145,145,0,0
37883,2019-10-07,1546,0,1546,154,1700,0,1700,0
37884,2019-10-07,899,0,899,89,988,988,0,0
37885,2019-10-07,752,0,752,75,827,827,0,0
37886,2019-10-07,1681,0,1681,168,1849,1849,0,0
37887,2019-10-07,1624,0,1624,162,1786,1786,0,0
37888,2019-10-07,445,0,445,35,480,480,0,0
37889,2019-10-07,1118,0,1118,89,1207,1207,0,0
37890,2019-10-07,808,0,808,64,872,872,0,0
37891,2019-10-07,167,0,167,13,180,180,0,0
37892,2019-10-07,547,0,547,54,601,0,601,0
37893,2019-10-07,741,0,741,74,815,815,0,0
37894,2019-10-07,1601,0,1601,160,1761,1761,0,0
37895,2019-10-07,1472,0,1472,147,1619,1619,0,0
37896,2019-10-07,390,0,390,31,421,0,421,0
37897,2019-10-07,773,0,773,77,850,0,0,850
37898,2019-10-07,773,0,773,77,850,0,850,0
37899,2019-10-07,214,0,214,21,235,235,0,0
37900,2019-10-07,102,0,102,10,112,112,0,0
37901,2019-10-07,761,0,761,60,821,821,0,0
37902,2019-10-07,139,0,139,11,150,150,0,0
37903,2019-10-07,306,0,306,24,330,330,0,0
37904,2019-10-07,714,0,714,57,771,771,0,0
37905,2019-10-07,334,0,334,26,360,360,0,0
37906,2019-10-07,773,0,773,77,850,850,0,0
37907,2019-10-07,1119,0,1119,111,1230,1230,0,0
37908,2019-10-07,1956,0,1956,156,2112,2112,0,0
37909,2019-10-07,529,0,529,42,571,571,0,0
37910,2019-10-07,529,0,529,42,571,571,0,0
37911,2019-10-07,-529,0,-529,-42,-571,-571,0,0
37912,2019-10-07,773,0,773,77,850,850,0,0
37913,2019-10-08,269,0,269,21,290,290,0,0
37914,2019-10-08,1149,0,1149,114,1263,1263,0,0
37915,2019-10-08,334,0,334,26,360,360,0,0
37916,2019-10-08,260,0,260,20,280,280,0,0
37917,2019-10-08,232,0,232,18,250,250,0,0
37918,2019-10-08,938,0,938,75,1013,1013,0,0
37919,2019-10-08,324,0,324,25,349,349,0,0
37920,2019-10-08,1149,0,1149,114,1263,1263,0,0
37921,2019-10-08,1371,0,1371,137,1508,1508,0,0
37922,2019-10-08,362,0,362,28,390,390,0,0
37923,2019-10-08,-1371,0,-1371,-137,-1508,-1508,0,0
37924,2019-10-08,316,0,316,25,341,341,0,0
37925,2019-10-08,790,0,790,63,853,853,0,0
37926,2019-10-08,1380,0,1380,138,1518,1518,0,0
37927,2019-10-08,874,0,874,69,943,943,0,0
37928,2019-10-08,1824,0,1824,182,2006,2006,0,0
37929,2019-10-08,103,0,103,8,111,111,0,0
37930,2019-10-08,298,0,298,23,321,321,0,0
37931,2019-10-08,1371,0,1371,137,1508,0,0,1508
37932,2019-10-08,167,0,167,13,180,180,0,0
37933,2019-10-08,223,0,223,17,240,240,0,0
37934,2019-10-08,399,0,399,39,438,0,438,0
37935,2019-10-08,826,0,826,66,892,892,0,0
37936,2019-10-08,585,0,585,46,631,631,0,0
37937,2019-10-08,566,0,566,45,611,611,0,0
37938,2019-10-08,848,0,848,67,915,915,0,0
37939,2019-10-08,381,0,381,30,411,0,0,411
37940,2019-10-08,260,0,260,20,280,280,0,0
37941,2019-10-08,1676,0,1676,167,1843,1843,0,0
37942,2019-10-08,139,0,139,11,150,150,0,0
37943,2019-10-08,595,0,595,47,642,642,0,0
37944,2019-10-08,362,0,362,28,390,390,0,0
37945,2019-10-08,492,0,492,39,531,531,0,0
37946,2019-10-08,740,0,740,59,799,799,0,0
37947,2019-10-08,1057,0,1057,105,1162,1162,0,0
37948,2019-10-08,1403,0,1403,112,1515,1515,0,0
37949,2019-10-08,742,0,742,74,816,816,0,0
37950,2019-10-08,2338,0,2338,233,2571,0,2571,0
37951,2019-10-08,493,0,493,39,532,532,0,0
37952,2019-10-08,640,0,640,64,704,0,704,0
37953,2019-10-08,390,0,390,31,421,421,0,0
37954,2019-10-09,891,0,891,89,980,980,0,0
37955,2019-10-09,130,0,130,13,143,143,0,0
37956,2019-10-09,1486,0,1486,118,1604,1604,0,0
37957,2019-10-09,891,0,891,89,980,980,0,0
37958,2019-10-09,399,0,399,39,438,438,0,0
37959,2019-10-09,297,0,297,23,320,320,0,0
37960,2019-10-09,1299,0,1299,103,1402,1402,0,0
37961,2019-10-09,250,0,250,20,270,270,0,0
37962,2019-10-09,575,0,575,46,621,621,0,0
37963,2019-10-09,808,0,808,64,872,872,0,0
37964,2019-10-09,1243,0,1243,117,1360,1360,0,0
37965,2019-10-09,325,0,325,26,351,351,0,0
37966,2019-10-09,742,0,742,59,801,801,0,0
37967,2019-10-09,1585,0,1585,158,1743,1743,0,0
37968,2019-10-09,891,0,891,89,980,980,0,0
37969,2019-10-09,465,0,465,37,502,502,0,0
37970,2019-10-09,493,-49,444,35,479,479,0,0
37971,2019-10-09,510,0,510,40,550,550,0,0
37972,2019-10-09,891,0,891,89,980,980,0,0
37973,2019-10-09,-1243,0,-1243,-117,-1360,-1360,0,0
37974,2019-10-09,1551,0,1551,124,1675,1675,0,0
37975,2019-10-09,232,0,232,18,250,250,0,0
37976,2019-10-09,1782,0,1782,178,1960,1960,0,0
37977,2019-10-09,457,0,457,36,493,493,0,0
37978,2019-10-09,242,0,242,19,261,261,0,0
37979,2019-10-09,1782,0,1782,178,1960,1960,0,0
37980,2019-10-09,677,0,677,54,731,731,0,0
37981,2019-10-09,658,0,658,65,723,723,0,0
37982,2019-10-09,399,0,399,31,430,430,0,0
37983,2019-10-09,1393,0,1393,111,1504,1504,0,0
37984,2019-10-09,306,-30,276,22,298,0,298,0
37985,2019-10-09,687,0,687,54,741,0,741,0
37986,2019-10-09,724,0,724,72,796,796,0,0
37987,2019-10-09,417,0,417,33,450,450,0,0
37988,2019-10-09,1782,0,1782,178,1960,0,1960,0
37989,2019-10-09,688,0,688,55,743,743,0,0
37990,2019-10-09,603,0,603,60,663,663,0,0
37991,2019-10-09,519,0,519,51,570,570,0,0
37992,2019-10-09,483,0,483,38,521,521,0,0
37993,2019-10-09,260,0,260,20,280,280,0,0
37994,2019-10-09,732,0,732,58,790,790,0,0
37995,2019-10-09,566,0,566,45,611,611,0,0
37996,2019-10-09,324,0,324,25,349,349,0,0
37997,2019-10-09,1782,0,1782,178,1960,1960,0,0
37998,2019-10-09,853,0,853,68,921,921,0,0
37999,2019-10-09,652,0,652,52,704,704,0,0
38000,2019-10-09,891,0,891,89,980,980,0,0
38001,2019-10-09,875,0,875,70,945,945,0,0
38002,2019-10-09,1104,0,1104,88,1192,1192,0,0
38003,2019-10-09,1159,0,1159,115,1274,1274,0,0
38004,2019-10-09,576,0,576,46,622,622,0,0
38005,2019-10-09,279,0,279,22,301,301,0,0
38006,2019-10-09,473,0,473,37,510,510,0,0
38007,2019-10-09,642,0,642,51,693,0,693,0
38008,2019-10-09,780,0,780,62,842,0,842,0
38009,2019-10-09,158,0,158,12,170,170,0,0
38010,2019-10-09,306,0,306,24,330,330,0,0
38011,2019-10-09,854,0,854,68,922,922,0,0
38012,2019-10-09,1046,0,1046,104,1150,0,0,1150
38013,2019-10-09,762,0,762,60,822,822,0,0
38014,2019-10-09,1964,0,1964,196,2160,2160,0,0
38015,2019-10-09,1315,0,1315,115,1430,1430,0,0
38016,2019-10-09,1046,0,1046,104,1150,1150,0,0
38017,2019-10-09,501,0,501,50,551,551,0,0
38018,2019-10-09,773,0,773,77,850,850,0,0
38019,2019-10-09,510,0,510,40,550,550,0,0
38020,2019-10-09,891,0,891,89,980,980,0,0
38021,2019-10-09,936,0,936,74,1010,1010,0,0
38022,2019-10-09,566,0,566,45,611,611,0,0
38023,2019-10-09,789,-157,632,50,682,682,0,0
38024,2019-10-09,139,0,139,11,150,150,0,0
38025,2019-10-09,891,0,891,89,980,980,0,0
38026,2019-10-09,1953,0,1953,195,2148,2148,0,0
38027,2019-10-09,891,0,891,89,980,980,0,0
38028,2019-10-09,426,0,426,42,468,468,0,0
38029,2019-10-09,511,0,511,40,551,551,0,0
38030,2019-10-09,760,0,760,76,836,836,0,0
38031,2019-10-09,613,0,613,49,662,662,0,0
38032,2019-10-09,334,0,334,26,360,360,0,0
38033,2019-10-09,1016,0,1016,81,1097,1097,0,0
38034,2019-10-09,650,0,650,52,702,702,0,0
38035,2019-10-09,1446,0,1446,144,1590,1590,0,0
38036,2019-10-09,260,0,260,20,280,280,0,0
38037,2019-10-09,1298,0,1298,129,1427,1427,0,0
38038,2019-10-09,399,0,399,31,430,430,0,0
38039,2019-10-09,1057,0,1057,84,1141,1141,0,0
38040,2019-10-09,1464,0,1464,146,1610,1610,0,0
38041,2019-10-09,1344,-268,1076,86,1162,1162,0,0
38042,2019-10-09,552,0,552,44,596,0,596,0
38043,2019-10-09,139,-27,112,11,123,123,0,0
38044,2019-10-09,316,0,316,31,347,347,0,0
38045,2019-10-09,1096,0,1096,87,1183,1183,0,0
38046,2019-10-10,891,0,891,89,980,980,0,0
38047,2019-10-10,797,0,797,79,876,876,0,0
38048,2019-10-10,1001,0,1001,80,1081,1081,0,0
38049,2019-10-10,676,0,676,67,743,743,0,0
38050,2019-10-10,678,0,678,54,732,732,0,0
38051,2019-10-10,788,0,788,63,851,851,0,0
38052,2019-10-10,2293,0,2293,183,2476,2476,0,0
38053,2019-10-10,520,0,520,41,561,561,0,0
38054,2019-10-10,1252,0,1252,100,1352,1352,0,0
38055,2019-10-10,855,0,855,68,923,923,0,0
38056,2019-10-10,352,0,352,35,387,387,0,0
38057,2019-10-10,556,0,556,44,600,600,0,0
38058,2019-10-10,891,0,891,89,980,980,0,0
38059,2019-10-10,891,0,891,89,980,980,0,0
38060,2019-10-10,1346,0,1346,107,1453,1453,0,0
38061,2019-10-10,961,0,961,76,1037,1037,0,0
38062,2019-10-10,1795,0,1795,143,1938,0,1938,0
38063,2019-10-10,1017,0,1017,101,1118,1118,0,0
38064,2019-10-10,706,-70,636,50,686,686,0,0
38065,2019-10-10,586,0,586,46,632,632,0,0
38066,2019-10-10,668,0,668,53,721,721,0,0
38067,2019-10-10,738,0,738,59,797,797,0,0
38068,2019-10-10,278,0,278,22,300,300,0,0
38069,2019-10-10,269,0,269,21,290,290,0,0
38070,2019-10-10,482,0,482,38,520,520,0,0
38071,2019-10-10,788,0,788,63,851,851,0,0
38072,2019-10-10,1428,0,1428,114,1542,1542,0,0
38073,2019-10-10,1020,0,1020,102,1122,0,0,1122
38074,2019-10-10,558,0,558,44,602,602,0,0
38075,2019-10-10,909,0,909,90,999,0,0,999
38076,2019-10-10,818,0,818,65,883,883,0,0
38077,2019-10-10,733,0,733,73,806,806,0,0
38078,2019-10-10,935,0,935,93,1028,1028,0,0
38079,2019-10-10,1782,0,1782,178,1960,0,1960,0
38080,2019-10-10,891,-89,802,80,882,882,0,0
38081,2019-10-10,1371,0,1371,137,1508,1508,0,0
38082,2019-10-10,326,0,326,26,352,352,0,0
38083,2019-10-10,707,-141,566,45,611,0,0,611
38084,2019-10-10,1116,0,1116,89,1205,1205,0,0
38085,2019-10-10,454,0,454,36,490,0,490,0
38086,2019-10-10,613,0,613,49,662,0,662,0
38087,2019-10-10,483,0,483,38,521,521,0,0
38088,2019-10-10,500,0,500,40,540,540,0,0
38089,2019-10-10,891,0,891,89,980,980,0,0
38090,2019-10-10,343,0,343,27,370,370,0,0
38091,2019-10-10,436,0,436,34,470,470,0,0
38092,2019-10-10,427,0,427,34,461,461,0,0
38093,2019-10-10,139,0,139,13,152,0,152,0
38094,2019-10-10,186,0,186,18,204,0,204,0
38095,2019-10-10,149,0,149,14,163,163,0,0
38096,2019-10-10,1158,0,1158,92,1250,1250,0,0
38097,2019-10-10,603,0,603,48,651,651,0,0
38098,2019-10-10,390,0,390,31,421,421,0,0
38099,2019-10-10,891,0,891,89,980,980,0,0
38100,2019-10-10,1782,0,1782,178,1960,0,1960,0
38101,2019-10-10,482,0,482,48,530,530,0,0
38102,2019-10-10,891,0,891,89,980,980,0,0
38103,2019-10-10,1782,0,1782,178,1960,1960,0,0
38104,2019-10-10,2525,-252,2273,181,2454,2454,0,0
38105,2019-10-10,678,0,678,54,732,732,0,0
38106,2019-10-10,706,0,706,56,762,762,0,0
38107,2019-10-10,1003,0,1003,80,1083,0,0,1083
38108,2019-10-10,632,0,632,50,682,682,0,0
38109,2019-10-10,501,0,501,40,541,541,0,0
38110,2019-10-10,1012,-101,911,72,983,983,0,0
38111,2019-10-10,1207,0,1207,96,1303,1303,0,0
38112,2019-10-10,1252,0,1252,100,1352,0,1352,0
38113,2019-10-10,343,0,343,27,370,370,0,0
38114,2019-10-10,520,0,520,41,561,0,561,0
38115,2019-10-10,334,0,334,26,360,360,0,0
38116,2019-10-10,1382,0,1382,138,1520,1520,0,0
38117,2019-10-10,891,0,891,89,980,980,0,0
38118,2019-10-10,47,0,47,4,51,51,0,0
38119,2019-10-10,400,0,400,32,432,432,0,0
38120,2019-10-10,773,0,773,77,850,850,0,0
38121,2019-10-10,660,0,660,52,712,712,0,0
38122,2019-10-10,250,0,250,20,270,270,0,0
38123,2019-10-10,982,0,982,98,1080,1080,0,0
38124,2019-10-10,2500,0,2500,250,2750,2750,0,0
38125,2019-10-10,334,0,334,33,367,0,0,367
38126,2019-10-10,994,0,994,79,1073,1073,0,0
38127,2019-10-10,139,0,139,11,150,150,0,0
38128,2019-10-10,269,0,269,21,290,290,0,0
38129,2019-10-10,446,0,446,35,481,481,0,0
38130,2019-10-10,417,0,417,33,450,450,0,0
38131,2019-10-10,630,0,630,63,693,0,693,0
38132,2019-10-10,631,0,631,50,681,681,0,0
38133,2019-10-10,399,0,399,39,438,0,438,0
38134,2019-10-10,678,0,678,54,732,0,732,0
38135,2019-10-10,141,0,141,11,152,152,0,0
38136,2019-10-10,1523,0,1523,121,1644,1644,0,0
38137,2019-10-10,510,0,510,40,550,550,0,0
38138,2019-10-10,427,0,427,34,461,461,0,0
38139,2019-10-10,797,0,797,63,860,860,0,0
38140,2019-10-10,56,0,56,4,60,60,0,0
38141,2019-10-10,399,0,399,39,438,438,0,0
38142,2019-10-10,399,0,399,39,438,438,0,0
38143,2019-10-10,509,0,509,50,559,559,0,0
38144,2019-10-10,316,0,316,31,347,347,0,0
38145,2019-10-10,288,0,288,23,311,311,0,0
38146,2019-10-10,696,0,696,69,765,765,0,0
38147,2019-10-10,622,0,622,62,684,684,0,0
38148,2019-10-10,316,0,316,25,341,341,0,0
38149,2019-10-10,372,0,372,29,401,401,0,0
38150,2019-10-10,863,0,863,69,932,932,0,0
38151,2019-10-10,548,-54,494,39,533,0,533,0
38152,2019-10-10,1199,0,1199,95,1294,1294,0,0
38153,2019-10-10,566,0,566,45,611,611,0,0
38154,2019-10-10,771,0,771,61,832,832,0,0
38155,2019-10-10,593,0,593,47,640,640,0,0
38156,2019-10-10,1104,0,1104,88,1192,1192,0,0
38157,2019-10-10,826,0,826,66,892,892,0,0
38158,2019-10-10,566,0,566,56,622,622,0,0
38159,2019-10-10,773,0,773,77,850,850,0,0
38160,2019-10-10,1389,0,1389,111,1500,1500,0,0
38161,2019-10-10,1335,0,1335,106,1441,1441,0,0
38162,2019-10-10,659,0,659,52,711,711,0,0
38163,2019-10-10,677,-67,610,48,658,658,0,0
38164,2019-10-10,773,0,773,77,850,850,0,0
38165,2019-10-10,1119,0,1119,111,1230,1230,0,0
38166,2019-10-10,455,0,455,45,500,500,0,0
38167,2019-10-10,773,0,773,77,850,850,0,0
38168,2019-10-10,232,0,232,18,250,250,0,0
38169,2019-10-10,556,0,556,55,611,611,0,0
38170,2019-10-10,1546,0,1546,154,1700,0,1700,0
38171,2019-10-10,929,0,929,74,1003,0,0,1003
38172,2019-10-10,835,0,835,66,901,901,0,0
38173,2019-10-10,552,0,552,44,596,596,0,0
38174,2019-10-10,1546,0,1546,154,1700,1700,0,0
38175,2019-10-10,740,0,740,74,814,814,0,0
38176,2019-10-10,998,0,998,99,1097,1097,0,0
38177,2019-10-10,546,0,546,54,600,600,0,0
38178,2019-10-10,576,0,576,46,622,0,622,0
38179,2019-10-10,1161,0,1161,116,1277,1277,0,0
38180,2019-10-10,612,0,612,48,660,660,0,0
38181,2019-10-10,557,0,557,44,601,601,0,0
38182,2019-10-10,956,0,956,76,1032,1032,0,0
38183,2019-10-10,773,0,773,77,850,850,0,0
38184,2019-10-10,773,0,773,77,850,850,0,0
38185,2019-10-10,773,0,773,77,850,0,850,0
38186,2019-10-10,773,0,773,77,850,850,0,0
38187,2019-10-10,679,0,679,54,733,733,0,0
38188,2019-10-10,882,0,882,70,952,0,952,0
38189,2019-10-10,288,0,288,23,311,311,0,0
38190,2019-10-10,740,0,740,74,814,814,0,0
38191,2019-10-10,773,0,773,77,850,850,0,0
38192,2019-10-10,1222,0,1222,122,1344,1344,0,0
38193,2019-10-10,428,0,428,34,462,462,0,0
38194,2019-10-11,1168,0,1168,116,1284,1284,0,0
38195,2019-10-11,2446,0,2446,244,2690,2690,0,0
38196,2019-10-11,871,0,871,87,958,958,0,0
38197,2019-10-11,732,0,732,73,805,805,0,0
38198,2019-10-11,2391,0,2391,239,2630,2630,0,0
38199,2019-10-11,668,0,668,53,721,721,0,0
38200,2019-10-11,1137,0,1137,113,1250,1250,0,0
38201,2019-10-11,1546,0,1546,154,1700,0,0,1700
38202,2019-10-11,306,0,306,24,330,330,0,0
38203,2019-10-11,37,0,37,2,39,39,0,0
38204,2019-10-11,1696,0,1696,169,1865,1865,0,0
38205,2019-10-11,371,-37,334,26,360,360,0,0
38206,2019-10-11,1546,0,1546,154,1700,1700,0,0
38207,2019-10-11,593,0,593,47,640,0,0,640
38208,2019-10-11,608,0,608,48,656,656,0,0
38209,2019-10-11,2050,0,2050,164,2214,2214,0,0
38210,2019-10-11,1414,-282,1132,102,1234,1234,0,0
38211,2019-10-11,25,0,25,2,27,27,0,0
38212,2019-10-11,1494,0,1494,119,1613,1613,0,0
38213,2019-10-11,1741,0,1741,174,1915,1915,0,0
38214,2019-10-11,861,0,861,86,947,947,0,0
38215,2019-10-11,2319,0,2319,231,2550,2550,0,0
38216,2019-10-11,223,0,223,22,245,245,0,0
38217,2019-10-11,874,0,874,69,943,943,0,0
38218,2019-10-11,733,-73,660,52,712,712,0,0
38219,2019-10-11,826,0,826,66,892,892,0,0
38220,2019-10-11,769,0,769,61,830,830,0,0
38221,2019-10-11,575,0,575,46,621,621,0,0
38222,2019-10-11,1237,0,1237,123,1360,1360,0,0
38223,2019-10-11,139,-27,112,8,120,120,0,0
38224,2019-10-11,779,0,779,62,841,841,0,0
38225,2019-10-11,306,0,306,24,330,330,0,0
38226,2019-10-11,911,0,911,72,983,983,0,0
38227,2019-10-11,1215,0,1215,97,1312,0,1312,0
38228,2019-10-11,241,0,241,24,265,265,0,0
38229,2019-10-11,1782,0,1782,178,1960,1960,0,0
38230,2019-10-11,25,0,25,2,27,27,0,0
38231,2019-10-11,1724,0,1724,172,1896,1896,0,0
38232,2019-10-11,1383,0,1383,138,1521,1521,0,0
38233,2019-10-11,436,0,436,34,470,470,0,0
38234,2019-10-11,1363,0,1363,136,1499,0,1499,0
38235,2019-10-11,409,0,409,32,441,441,0,0
38236,2019-10-11,775,0,775,62,837,837,0,0
38237,2019-10-11,352,0,352,28,380,0,0,380
38238,2019-10-11,260,0,260,20,280,280,0,0
38239,2019-10-11,1271,0,1271,127,1398,1398,0,0
38240,2019-10-11,158,0,158,12,170,170,0,0
38241,2019-10-11,102,0,102,8,110,110,0,0
38242,2019-10-11,463,0,463,46,509,509,0,0
38243,2019-10-11,269,0,269,21,290,290,0,0
38244,2019-10-11,306,0,306,24,330,330,0,0
38245,2019-10-11,1151,0,1151,92,1243,1243,0,0
38246,2019-10-11,288,0,288,28,316,316,0,0
38247,2019-10-11,167,0,167,13,180,180,0,0
38248,2019-10-11,955,0,955,95,1050,1050,0,0
38249,2019-10-11,510,0,510,40,550,550,0,0
38250,2019-10-11,1496,0,1496,119,1615,1615,0,0
38251,2019-10-11,1141,0,1141,91,1232,1232,0,0
38252,2019-10-11,909,0,909,72,981,981,0,0
38253,2019-10-11,576,0,576,46,622,0,0,622
38254,2019-10-11,948,0,948,75,1023,1023,0,0
38255,2019-10-11,1558,0,1558,124,1682,1682,0,0
38256,2019-10-11,241,0,241,24,265,265,0,0
38257,2019-10-11,427,0,427,34,461,461,0,0
38258,2019-10-11,325,0,325,26,351,351,0,0
38259,2019-10-11,465,0,465,37,502,0,502,0
38260,2019-10-11,325,0,325,26,351,351,0,0
38261,2019-10-11,478,0,478,38,516,516,0,0
38262,2019-10-11,232,0,232,18,250,250,0,0
38263,2019-10-11,260,0,260,20,280,280,0,0
38264,2019-10-11,94,0,94,7,101,101,0,0
38265,2019-10-11,139,0,139,11,150,150,0,0
38266,2019-10-11,593,0,593,47,640,640,0,0
38267,2019-10-11,1168,-116,1052,105,1157,1157,0,0
38268,2019-10-11,640,0,640,51,691,691,0,0
38269,2019-10-11,631,0,631,50,681,681,0,0
38270,2019-10-11,1678,0,1678,167,1845,0,1845,0
38271,2019-10-11,834,0,834,66,900,900,0,0
38272,2019-10-11,658,0,658,65,723,0,723,0
38273,2019-10-11,491,0,491,49,540,0,540,0
38274,2019-10-11,371,0,371,29,400,400,0,0
38275,2019-10-11,982,0,982,98,1080,1080,0,0
38276,2019-10-12,891,0,891,89,980,980,0,0
38277,2019-10-12,2673,0,2673,267,2940,2940,0,0
38278,2019-10-12,324,0,324,25,349,349,0,0
38279,2019-10-12,547,0,547,54,601,0,601,0
38280,2019-10-12,800,0,800,64,864,864,0,0
38281,2019-10-12,446,0,446,35,481,481,0,0
38282,2019-10-12,919,0,919,73,992,992,0,0
38283,2019-10-12,1419,0,1419,141,1560,0,1560,0
38284,2019-10-12,882,0,882,88,970,970,0,0
38285,2019-10-12,566,0,566,45,611,611,0,0
38286,2019-10-12,529,0,529,42,571,571,0,0
38287,2019-10-12,1782,0,1782,178,1960,0,1960,0
38288,2019-10-12,232,0,232,18,250,250,0,0
38289,2019-10-12,704,0,704,56,760,760,0,0
38290,2019-10-12,761,0,761,60,821,821,0,0
38291,2019-10-12,826,0,826,66,892,892,0,0
38292,2019-10-12,232,0,232,18,250,250,0,0
38293,2019-10-12,112,0,112,8,120,120,0,0
38294,2019-10-12,734,0,734,58,792,792,0,0
38295,2019-10-12,1782,0,1782,178,1960,1960,0,0
38296,2019-10-12,1398,0,1398,139,1537,1537,0,0
38297,2019-10-12,1006,0,1006,80,1086,1086,0,0
38298,2019-10-12,463,0,463,46,509,509,0,0
38299,2019-10-12,529,0,529,42,571,571,0,0
38300,2019-10-12,1160,0,1160,92,1252,1252,0,0
38301,2019-10-12,334,0,334,26,360,360,0,0
38302,2019-10-12,334,0,334,33,367,0,367,0
38303,2019-10-12,445,0,445,35,480,480,0,0
38304,2019-10-12,501,0,501,40,541,541,0,0
38305,2019-10-12,1951,0,1951,156,2107,0,0,2107
38306,2019-10-12,816,0,816,65,881,0,881,0
38307,2019-10-12,1012,0,1012,80,1092,0,1092,0
38308,2019-10-12,1782,0,1782,178,1960,1960,0,0
38309,2019-10-12,2156,0,2156,215,2371,2371,0,0
38310,2019-10-12,2326,0,2326,186,2512,2512,0,0
38311,2019-10-12,1140,0,1140,91,1231,1231,0,0
38312,2019-10-12,306,0,306,24,330,330,0,0
38313,2019-10-12,3532,0,3532,282,3814,3814,0,0
38314,2019-10-12,455,0,455,36,491,491,0,0
38315,2019-10-12,576,0,576,46,622,622,0,0
38316,2019-10-12,585,0,585,46,631,631,0,0
38317,2019-10-12,628,0,628,62,690,690,0,0
38318,2019-10-12,1057,0,1057,84,1141,1141,0,0
38319,2019-10-12,502,0,502,40,542,542,0,0
38320,2019-10-12,492,0,492,39,531,531,0,0
38321,2019-10-12,1215,0,1215,97,1312,1312,0,0
38322,2019-10-12,604,0,604,48,652,652,0,0
38323,2019-10-12,167,-16,151,12,163,163,0,0
38324,2019-10-12,370,0,370,37,407,407,0,0
38325,2019-10-12,1782,0,1782,178,1960,0,0,1960
38326,2019-10-12,528,0,528,42,570,570,0,0
38327,2019-10-12,1256,0,1256,125,1381,1381,0,0
38328,2019-10-12,575,0,575,46,621,621,0,0
38329,2019-10-12,121,0,121,12,133,133,0,0
38330,2019-10-12,1334,0,1334,106,1440,1440,0,0
38331,2019-10-12,501,0,501,40,541,541,0,0
38332,2019-10-12,882,0,882,70,952,952,0,0
38333,2019-10-12,773,0,773,77,850,850,0,0
38334,2019-10-12,733,0,733,73,806,806,0,0
38335,2019-10-12,1046,0,1046,104,1150,1150,0,0
38336,2019-10-12,1046,0,1046,104,1150,1150,0,0
38337,2019-10-12,632,-63,569,45,614,0,614,0
38338,2019-10-12,548,0,548,43,591,0,591,0
38339,2019-10-12,773,0,773,77,850,850,0,0
38340,2019-10-12,567,0,567,45,612,0,0,612
38341,2019-10-12,584,0,584,46,630,630,0,0
38342,2019-10-12,992,0,992,99,1091,1091,0,0
38343,2019-10-12,2319,0,2319,231,2550,2550,0,0
38344,2019-10-12,502,0,502,40,542,542,0,0
38345,2019-10-12,1546,0,1546,154,1700,1700,0,0
38346,2019-10-12,773,0,773,77,850,0,0,850
38347,2019-10-12,556,0,556,44,600,600,0,0
38348,2019-10-12,181,0,181,14,195,195,0,0
38349,2019-10-12,740,0,740,74,814,814,0,0
38350,2019-10-12,779,0,779,62,841,841,0,0
38351,2019-10-12,1546,-154,1392,139,1531,0,1531,0
38352,2019-10-12,370,0,370,37,407,407,0,0
38353,2019-10-12,1546,0,1546,154,1700,1700,0,0
38354,2019-10-12,284,0,284,22,306,306,0,0
38355,2019-10-12,1019,0,1019,81,1100,1100,0,0
38356,2019-10-12,139,0,139,11,150,150,0,0
38357,2019-10-12,713,0,713,71,784,784,0,0
38358,2019-10-12,556,0,556,55,611,611,0,0
38359,2019-10-12,891,0,891,89,980,980,0,0
38360,2019-10-12,1046,0,1046,104,1150,1150,0,0
38361,2019-10-12,1546,0,1546,154,1700,0,0,1700
38362,2019-10-12,436,0,436,34,470,470,0,0
38363,2019-10-12,389,0,389,38,427,427,0,0
38364,2019-10-12,1782,0,1782,178,1960,1960,0,0
38365,2019-10-12,370,0,370,37,407,407,0,0
38366,2019-10-12,3564,0,3564,356,3920,3920,0,0
38367,2019-10-12,622,0,622,49,671,671,0,0
38368,2019-10-12,998,0,998,99,1097,1097,0,0
38369,2019-10-12,998,0,998,99,1097,1097,0,0
38370,2019-10-12,1328,0,1328,106,1434,1434,0,0
38371,2019-10-12,734,0,734,58,792,792,0,0
38372,2019-10-12,1050,0,1050,84,1134,1134,0,0
38373,2019-10-12,2006,0,2006,160,2166,2166,0,0
38374,2019-10-12,354,0,354,28,382,382,0,0
38375,2019-10-12,232,0,232,18,250,250,0,0
38376,2019-10-12,1681,0,1681,134,1815,1815,0,0
38377,2019-10-12,556,0,556,44,600,600,0,0
38378,2019-10-12,391,0,391,31,422,422,0,0
38379,2019-10-12,399,0,399,31,430,430,0,0
38380,2019-10-12,269,0,269,21,290,290,0,0
38381,2019-10-12,334,0,334,26,360,360,0,0
38382,2019-10-12,417,0,417,33,450,450,0,0
38383,2019-10-12,773,0,773,77,850,850,0,0
38384,2019-10-12,632,0,632,63,695,695,0,0
38385,2019-10-12,696,0,696,55,751,751,0,0
38386,2019-10-12,528,0,528,52,580,0,580,0
38387,2019-10-12,584,0,584,46,630,630,0,0
38388,2019-10-12,176,0,176,14,190,190,0,0
38389,2019-10-12,705,0,705,56,761,761,0,0
38390,2019-10-12,139,0,139,13,152,152,0,0
38391,2019-10-13,770,0,770,77,847,847,0,0
38392,2019-10-13,575,0,575,46,621,621,0,0
38393,2019-10-13,149,0,149,11,160,160,0,0
38394,2019-10-13,447,0,447,35,482,482,0,0
38395,2019-10-13,892,0,892,71,963,963,0,0
38396,2019-10-13,773,0,773,77,850,850,0,0
38397,2019-10-13,510,0,510,40,550,550,0,0
38398,2019-10-13,149,0,149,11,160,160,0,0
38399,2019-10-13,1001,0,1001,100,1101,1101,0,0
38400,2019-10-13,1696,0,1696,169,1865,1865,0,0
38401,2019-10-13,1772,0,1772,141,1913,1913,0,0
38402,2019-10-13,-167,0,-167,-13,-180,-180,0,0
38403,2019-10-13,1160,0,1160,92,1252,1252,0,0
38404,2019-10-13,826,0,826,82,908,908,0,0
38405,2019-10-13,-389,0,-389,-31,-420,-420,0,0
38406,2019-10-13,-1546,0,-1546,-154,-1700,0,-1700,0
38407,2019-10-13,919,0,919,73,992,992,0,0
38408,2019-10-13,365,0,365,29,394,394,0,0
38409,2019-10-13,1110,0,1110,111,1221,1221,0,0
38410,2019-10-13,790,0,790,79,869,869,0,0
38411,2019-10-13,1546,0,1546,154,1700,0,1700,0
38412,2019-10-13,1196,0,1196,95,1291,1291,0,0
38413,2019-10-13,343,0,343,27,370,370,0,0
38414,2019-10-13,1607,0,1607,143,1750,1750,0,0
38415,2019-10-13,408,0,408,32,440,440,0,0
38416,2019-10-13,1546,0,1546,154,1700,0,0,1700
38417,2019-10-13,788,0,788,78,866,866,0,0
38418,2019-10-13,273,0,273,27,300,0,0,300
38419,2019-10-13,1094,0,1094,87,1181,0,0,1181
38420,2019-10-13,1150,0,1150,92,1242,1242,0,0
38421,2019-10-13,670,0,670,53,723,723,0,0
38422,2019-10-13,622,0,622,62,684,684,0,0
38423,2019-10-13,1004,0,1004,80,1084,1084,0,0
38424,2019-10-13,900,0,900,72,972,972,0,0
38425,2019-10-13,846,0,846,67,913,913,0,0
38426,2019-10-13,917,0,917,91,1008,1008,0,0
38427,2019-10-13,399,0,399,31,430,430,0,0
38428,2019-10-13,866,0,866,69,935,935,0,0
38429,2019-10-13,2092,0,2092,197,2289,2289,0,0
38430,2019-10-13,-2324,0,-2324,-232,-2556,0,0,-2556
38431,2019-10-13,1782,0,1782,178,1960,1960,0,0
38432,2019-10-13,771,0,771,61,832,832,0,0
38433,2019-10-13,845,0,845,67,912,912,0,0
38434,2019-10-13,1846,0,1846,184,2030,2030,0,0
38435,2019-10-13,529,0,529,42,571,571,0,0
38436,2019-10-13,139,0,139,11,150,150,0,0
38437,2019-10-13,1782,0,1782,178,1960,1960,0,0
38438,2019-10-13,474,-47,427,34,461,461,0,0
38439,2019-10-13,612,0,612,48,660,660,0,0
38440,2019-10-13,306,0,306,24,330,330,0,0
38441,2019-10-13,686,-68,618,49,667,667,0,0
38442,2019-10-13,1950,0,1950,156,2106,2106,0,0
38443,2019-10-13,260,0,260,20,280,280,0,0
38444,2019-10-13,1782,0,1782,178,1960,1960,0,0
38445,2019-10-13,1782,0,1782,178,1960,1960,0,0
38446,2019-10-13,260,0,260,20,280,280,0,0
38447,2019-10-13,1204,0,1204,96,1300,0,1300,0
38448,2019-10-13,232,0,232,18,250,250,0,0
38449,2019-10-13,465,0,465,37,502,502,0,0
38450,2019-10-13,891,0,891,89,980,980,0,0
38451,2019-10-13,2061,0,2061,206,2267,0,2267,0
38452,2019-10-13,139,0,139,11,150,150,0,0
38453,2019-10-13,612,0,612,48,660,660,0,0
38454,2019-10-13,482,0,482,38,520,520,0,0
38455,2019-10-13,740,0,740,59,799,0,0,799
38456,2019-10-13,2483,0,2483,198,2681,2681,0,0
38457,2019-10-13,623,0,623,49,672,672,0,0
38458,2019-10-13,-491,0,-491,-39,-530,-530,0,0
38459,2019-10-13,446,0,446,35,481,481,0,0
38460,2019-10-13,232,0,232,18,250,250,0,0
38461,2019-10-13,260,0,260,20,280,280,0,0
38462,2019-10-13,734,0,734,58,792,792,0,0
38463,2019-10-13,761,0,761,60,821,821,0,0
38464,2019-10-13,584,0,584,58,642,642,0,0
38465,2019-10-13,353,0,353,28,381,381,0,0
38466,2019-10-13,232,0,232,18,250,250,0,0
38467,2019-10-13,973,0,973,97,1070,1070,0,0
38468,2019-10-13,260,0,260,20,280,280,0,0
38469,2019-10-13,168,0,168,13,181,181,0,0
38470,2019-10-13,567,-56,511,40,551,551,0,0
38471,2019-10-13,352,0,352,35,387,387,0,0
38472,2019-10-13,1241,0,1241,124,1365,1365,0,0
38473,2019-10-13,370,0,370,37,407,0,407,0
38474,2019-10-13,204,0,204,16,220,0,220,0
38475,2019-10-13,446,0,446,44,490,490,0,0
38476,2019-10-13,324,0,324,25,349,349,0,0
38477,2019-10-13,473,0,473,47,520,520,0,0
38478,2019-10-13,1149,0,1149,91,1240,1240,0,0
38479,2019-10-13,371,0,371,29,400,400,0,0
38480,2019-10-13,1240,0,1240,124,1364,1364,0,0
38481,2019-10-13,862,0,862,68,930,930,0,0
38482,2019-10-13,399,0,399,31,430,0,430,0
38483,2019-10-13,501,0,501,40,541,541,0,0
38484,2019-10-13,167,0,167,13,180,180,0,0
38485,2019-10-13,362,0,362,28,390,390,0,0
38486,2019-10-13,2473,0,2473,247,2720,2720,0,0
38487,2019-10-13,50,0,50,5,55,55,0,0
38488,2019-10-13,798,0,798,63,861,861,0,0
38489,2019-10-13,1093,0,1093,109,1202,0,0,1202
38490,2019-10-13,270,0,270,21,291,0,291,0
38491,2019-10-13,514,0,514,41,555,555,0,0
38492,2019-10-13,251,0,251,20,271,271,0,0
38493,2019-10-13,900,0,900,72,972,972,0,0
38494,2019-10-13,167,0,167,13,180,180,0,0
38495,2019-10-13,167,0,167,13,180,180,0,0
38496,2019-10-13,167,0,167,16,183,183,0,0
38497,2019-10-13,2088,0,2088,167,2255,2255,0,0
38498,2019-10-13,1113,0,1113,89,1202,1202,0,0
38499,2019-10-13,1546,0,1546,154,1700,1700,0,0
38500,2019-10-13,937,0,937,74,1011,1011,0,0
38501,2019-10-13,769,0,769,76,845,845,0,0
38502,2019-10-13,963,0,963,77,1040,1040,0,0
38503,2019-10-13,773,0,773,77,850,850,0,0
38504,2019-10-13,1546,0,1546,154,1700,1700,0,0
38505,2019-10-13,1602,0,1602,160,1762,0,1762,0
38506,2019-10-13,2324,0,2324,232,2556,0,0,2556
38507,2019-10-13,1426,0,1426,142,1568,0,1568,0
38508,2019-10-13,278,0,278,22,300,300,0,0
38509,2019-10-13,1194,0,1194,119,1313,1313,0,0
38510,2019-10-13,773,0,773,77,850,850,0,0
38511,2019-10-13,159,0,159,12,171,0,171,0
38512,2019-10-13,1546,0,1546,154,1700,0,1700,0
38513,2019-10-13,818,0,818,65,883,883,0,0
38514,2019-10-13,1546,0,1546,154,1700,1700,0,0
38515,2019-10-13,408,0,408,32,440,440,0,0
38516,2019-10-13,251,0,251,20,271,271,0,0
38517,2019-10-13,344,0,344,27,371,371,0,0
38518,2019-10-13,205,0,205,16,221,0,221,0
38519,2019-10-13,280,0,280,22,302,302,0,0
38520,2019-10-13,352,-70,282,28,310,310,0,0
38521,2019-10-13,686,0,686,54,740,740,0,0
38522,2019-10-13,428,0,428,34,462,462,0,0
38523,2019-10-13,2319,0,2319,231,2550,2550,0,0
38524,2019-10-13,861,0,861,68,929,929,0,0
38525,2019-10-13,2319,0,2319,231,2550,2550,0,0
38526,2019-10-13,-370,0,-370,-29,-399,-399,0,0
38527,2019-10-13,547,0,547,43,590,590,0,0
38528,2019-10-13,1834,-366,1468,146,1614,1614,0,0
38529,2019-10-14,1207,0,1207,96,1303,1303,0,0
38530,2019-10-14,1485,0,1485,118,1603,1603,0,0
38531,2019-10-14,-130,0,-130,-10,-140,-140,0,0
38532,2019-10-14,595,0,595,47,642,642,0,0
38533,2019-10-14,1522,-152,1370,109,1479,1479,0,0
38534,2019-10-14,1058,0,1058,84,1142,1142,0,0
38535,2019-10-14,891,0,891,89,980,980,0,0
38536,2019-10-14,362,0,362,28,390,390,0,0
38537,2019-10-14,2673,0,2673,267,2940,2940,0,0
38538,2019-10-14,576,0,576,57,633,633,0,0
38539,2019-10-14,130,0,130,10,140,140,0,0
38540,2019-10-14,130,0,130,10,140,140,0,0
38541,2019-10-14,566,0,566,45,611,611,0,0
38542,2019-10-14,325,0,325,26,351,351,0,0
38543,2019-10-14,891,0,891,89,980,980,0,0
38544,2019-10-14,1001,0,1001,100,1101,1101,0,0
38545,2019-10-14,787,0,787,78,865,865,0,0
38546,2019-10-14,158,0,158,12,170,0,0,170
38547,2019-10-14,650,0,650,52,702,0,702,0
38548,2019-10-14,253,0,253,20,273,273,0,0
38549,2019-10-14,483,0,483,38,521,0,521,0
38550,2019-10-14,1039,0,1039,83,1122,1122,0,0
38551,2019-10-14,1235,0,1235,98,1333,1333,0,0
38552,2019-10-14,584,0,584,46,630,630,0,0
38553,2019-10-14,1131,0,1131,113,1244,1244,0,0
38554,2019-10-14,1217,0,1217,97,1314,1314,0,0
38555,2019-10-14,658,0,658,65,723,723,0,0
38556,2019-10-14,548,0,548,43,591,591,0,0
38557,2019-10-14,446,0,446,35,481,481,0,0
38558,2019-10-14,1782,0,1782,178,1960,1960,0,0
38559,2019-10-14,734,0,734,58,792,792,0,0
38560,2019-10-14,706,0,706,56,762,762,0,0
38561,2019-10-14,891,0,891,89,980,980,0,0
38562,2019-10-14,188,0,188,15,203,203,0,0
38563,2019-10-14,891,0,891,89,980,980,0,0
38564,2019-10-14,408,0,408,32,440,440,0,0
38565,2019-10-14,149,0,149,11,160,160,0,0
38566,2019-10-14,1289,0,1289,128,1417,0,1417,0
38567,2019-10-14,891,0,891,89,980,980,0,0
38568,2019-10-14,455,0,455,36,491,491,0,0
38569,2019-10-14,1782,0,1782,178,1960,0,1960,0
38570,2019-10-14,307,0,307,30,337,337,0,0
38571,2019-10-14,1493,0,1493,149,1642,1642,0,0
38572,2019-10-14,538,0,538,43,581,581,0,0
38573,2019-10-14,1149,0,1149,114,1263,1263,0,0
38574,2019-10-14,835,0,835,66,901,0,901,0
38575,2019-10-14,604,0,604,48,652,652,0,0
38576,2019-10-14,424,0,424,33,457,457,0,0
38577,2019-10-14,650,0,650,52,702,702,0,0
38578,2019-10-14,1226,0,1226,98,1324,0,1324,0
38579,2019-10-14,159,0,159,15,174,174,0,0
38580,2019-10-14,891,0,891,89,980,980,0,0
38581,2019-10-14,325,0,325,26,351,351,0,0
38582,2019-10-14,251,0,251,20,271,271,0,0
38583,2019-10-14,1226,0,1226,98,1324,1324,0,0
38584,2019-10-14,520,0,520,41,561,561,0,0
38585,2019-10-14,493,0,493,39,532,0,532,0
38586,2019-10-14,354,0,354,35,389,0,389,0
38587,2019-10-14,1587,-158,1429,114,1543,0,1543,0
38588,2019-10-14,445,0,445,35,480,480,0,0
38589,2019-10-14,436,0,436,43,479,0,479,0
38590,2019-10-14,1797,0,1797,179,1976,1976,0,0
38591,2019-10-14,837,0,837,66,903,903,0,0
38592,2019-10-14,315,0,315,25,340,340,0,0
38593,2019-10-14,696,0,696,55,751,751,0,0
38594,2019-10-14,891,0,891,89,980,980,0,0
38595,2019-10-14,279,0,279,27,306,306,0,0
38596,2019-10-14,1131,0,1131,90,1221,0,0,1221
38597,2019-10-14,891,0,891,89,980,980,0,0
38598,2019-10-14,1782,0,1782,178,1960,0,1960,0
38599,2019-10-14,548,0,548,43,591,591,0,0
38600,2019-10-14,736,0,736,58,794,0,0,794
38601,2019-10-14,345,0,345,34,379,379,0,0
38602,2019-10-14,1121,0,1121,112,1233,1233,0,0
38603,2019-10-14,798,0,798,63,861,861,0,0
38604,2019-10-14,715,0,715,57,772,772,0,0
38605,2019-10-14,966,0,966,77,1043,1043,0,0
38606,2019-10-14,168,0,168,13,181,181,0,0
38607,2019-10-14,594,0,594,59,653,653,0,0
38608,2019-10-14,1547,0,1547,154,1701,1701,0,0
38609,2019-10-14,668,0,668,53,721,721,0,0
38610,2019-10-14,232,0,232,18,250,250,0,0
38611,2019-10-14,446,0,446,35,481,481,0,0
38612,2019-10-14,2105,0,2105,210,2315,0,2315,0
38613,2019-10-14,140,-28,112,8,120,0,0,120
38614,2019-10-14,1065,0,1065,106,1171,1171,0,0
38615,2019-10-14,195,0,195,15,210,210,0,0
38616,2019-10-14,139,0,139,13,152,152,0,0
38617,2019-10-14,761,0,761,60,821,821,0,0
38618,2019-10-14,167,0,167,13,180,180,0,0
38619,2019-10-14,993,0,993,79,1072,1072,0,0
38620,2019-10-14,2990,0,2990,299,3289,3289,0,0
38621,2019-10-14,548,0,548,43,591,591,0,0
38622,2019-10-14,622,0,622,49,671,671,0,0
38623,2019-10-14,566,0,566,45,611,611,0,0
38624,2019-10-14,760,0,760,76,836,836,0,0
38625,2019-10-14,316,0,316,25,341,341,0,0
38626,2019-10-14,400,0,400,32,432,0,0,432
38627,2019-10-14,298,0,298,23,321,321,0,0
38628,2019-10-14,371,0,371,29,400,400,0,0
38629,2019-10-14,371,0,371,29,400,400,0,0
38630,2019-10-14,232,0,232,18,250,250,0,0
38631,2019-10-14,352,0,352,35,387,0,0,387
38632,2019-10-14,352,0,352,35,387,387,0,0
38633,2019-10-14,352,0,352,35,387,387,0,0
38634,2019-10-14,872,0,872,87,959,959,0,0
38635,2019-10-14,399,0,399,39,438,438,0,0
38636,2019-10-14,324,0,324,25,349,349,0,0
38637,2019-10-14,324,0,324,25,349,349,0,0
38638,2019-10-14,1676,0,1676,167,1843,1843,0,0
38639,2019-10-14,1546,0,1546,154,1700,1700,0,0
38640,2019-10-14,773,0,773,77,850,850,0,0
38641,2019-10-14,948,0,948,75,1023,1023,0,0
38642,2019-10-14,306,0,306,24,330,330,0,0
38643,2019-10-14,585,0,585,46,631,631,0,0
38644,2019-10-14,-324,0,-324,-25,-349,-349,0,0
38645,2019-10-14,436,0,436,34,470,470,0,0
38646,2019-10-14,501,0,501,40,541,541,0,0
38647,2019-10-14,773,0,773,77,850,850,0,0
38648,2019-10-14,1152,0,1152,92,1244,1244,0,0
38649,2019-10-14,425,0,425,34,459,459,0,0
38650,2019-10-14,1538,0,1538,153,1691,1691,0,0
38651,2019-10-14,740,0,740,74,814,814,0,0
38652,2019-10-14,842,0,842,84,926,926,0,0
38653,2019-10-14,370,0,370,37,407,407,0,0
38654,2019-10-14,982,0,982,98,1080,1080,0,0
38655,2019-10-14,1507,0,1507,120,1627,1627,0,0
38656,2019-10-14,773,0,773,77,850,850,0,0
38657,2019-10-14,483,0,483,38,521,0,521,0
38658,2019-10-14,696,0,696,55,751,751,0,0
38659,2019-10-14,751,0,751,60,811,811,0,0
38660,2019-10-14,1122,0,1122,89,1211,1211,0,0
38661,2019-10-14,1546,0,1546,154,1700,1700,0,0
38662,2019-10-14,1546,0,1546,154,1700,1700,0,0
38663,2019-10-14,1169,0,1169,93,1262,1262,0,0
38664,2019-10-14,1503,0,1503,120,1623,1623,0,0
38665,2019-10-14,1546,0,1546,154,1700,1700,0,0
38666,2019-10-14,1546,0,1546,154,1700,1700,0,0
38667,2019-10-14,667,0,667,66,733,733,0,0
38668,2019-10-14,880,0,880,88,968,0,968,0
38669,2019-10-14,1140,0,1140,91,1231,1231,0,0
38670,2019-10-14,620,0,620,49,669,669,0,0
38671,2019-10-14,502,0,502,40,542,542,0,0
38672,2019-10-14,1028,0,1028,102,1130,1130,0,0
38673,2019-10-14,1271,0,1271,101,1372,0,1372,0
38674,2019-10-14,1546,0,1546,154,1700,1700,0,0
38675,2019-10-15,307,0,307,24,331,331,0,0
38676,2019-10-15,334,0,334,26,360,360,0,0
38677,2019-10-15,686,-68,618,49,667,667,0,0
38678,2019-10-15,353,0,353,28,381,381,0,0
38679,2019-10-15,637,0,637,50,687,687,0,0
38680,2019-10-15,501,0,501,40,541,541,0,0
38681,2019-10-15,139,0,139,11,150,150,0,0
38682,2019-10-15,279,0,279,22,301,301,0,0
38683,2019-10-15,362,0,362,28,390,390,0,0
38684,2019-10-15,232,0,232,18,250,250,0,0
38685,2019-10-15,501,0,501,40,541,541,0,0
38686,2019-10-15,352,0,352,28,380,380,0,0
38687,2019-10-15,752,0,752,60,812,812,0,0
38688,2019-10-15,511,0,511,40,551,551,0,0
38689,2019-10-15,102,0,102,8,110,110,0,0
38690,2019-10-15,204,0,204,16,220,220,0,0
38691,2019-10-15,325,0,325,26,351,351,0,0
38692,2019-10-15,334,0,334,26,360,360,0,0
38693,2019-10-15,603,0,603,48,651,651,0,0
38694,2019-10-15,232,0,232,18,250,250,0,0
38695,2019-10-15,614,0,614,49,663,663,0,0
38696,2019-10-15,269,0,269,21,290,290,0,0
38697,2019-10-15,202,0,202,16,218,218,0,0
38698,2019-10-15,519,0,519,41,560,560,0,0
38699,2019-10-15,409,0,409,32,441,441,0,0
38700,2019-10-15,436,0,436,34,470,470,0,0
38701,2019-10-15,370,0,370,29,399,399,0,0
38702,2019-10-15,492,0,492,39,531,531,0,0
38703,2019-10-15,1085,0,1085,86,1171,1171,0,0
38704,2019-10-15,187,-18,169,13,182,182,0,0
38705,2019-10-15,1971,0,1971,157,2128,0,0,2128
38706,2019-10-15,214,0,214,17,231,231,0,0
38707,2019-10-15,916,0,916,91,1007,1007,0,0
38708,2019-10-16,891,0,891,89,980,980,0,0
38709,2019-10-16,492,0,492,39,531,531,0,0
38710,2019-10-16,891,0,891,89,980,980,0,0
38711,2019-10-16,1153,0,1153,92,1245,1245,0,0
38712,2019-10-16,1298,0,1298,129,1427,0,0,1427
38713,2019-10-16,967,0,967,77,1044,1044,0,0
38714,2019-10-16,651,0,651,52,703,703,0,0
38715,2019-10-16,1540,0,1540,123,1663,1663,0,0
38716,2019-10-16,909,0,909,72,981,981,0,0
38717,2019-10-16,761,0,761,60,821,821,0,0
38718,2019-10-16,743,0,743,59,802,802,0,0
38719,2019-10-16,1620,0,1620,162,1782,1782,0,0
38720,2019-10-16,1002,0,1002,80,1082,1082,0,0
38721,2019-10-16,466,0,466,37,503,0,0,503
38722,2019-10-16,567,0,567,45,612,0,612,0
38723,2019-10-16,576,0,576,46,622,622,0,0
38724,2019-10-16,298,0,298,23,321,321,0,0
38725,2019-10-16,158,0,158,12,170,170,0,0
38726,2019-10-16,594,0,594,47,641,641,0,0
38727,2019-10-16,640,0,640,51,691,691,0,0
38728,2019-10-16,409,0,409,32,441,441,0,0
38729,2019-10-16,1976,0,1976,158,2134,2134,0,0
38730,2019-10-16,891,0,891,89,980,980,0,0
38731,2019-10-16,761,0,761,60,821,821,0,0
38732,2019-10-16,401,0,401,32,433,433,0,0
38733,2019-10-16,538,0,538,43,581,581,0,0
38734,2019-10-16,1084,-1000,84,6,90,90,0,0
38735,2019-10-16,204,0,204,16,220,220,0,0
38736,2019-10-16,538,0,538,43,581,581,0,0
38737,2019-10-16,520,0,520,41,561,561,0,0
38738,2019-10-16,112,0,112,8,120,120,0,0
38739,2019-10-16,353,0,353,28,381,381,0,0
38740,2019-10-16,939,0,939,75,1014,1014,0,0
38741,2019-10-16,1306,0,1306,130,1436,1436,0,0
38742,2019-10-16,316,0,316,25,341,0,341,0
38743,2019-10-16,612,0,612,48,660,660,0,0
38744,2019-10-16,1059,0,1059,84,1143,1143,0,0
38745,2019-10-16,891,0,891,89,980,980,0,0
38746,2019-10-16,594,0,594,47,641,641,0,0
38747,2019-10-16,891,0,891,89,980,980,0,0
38748,2019-10-16,473,0,473,37,510,0,0,510
38749,2019-10-16,686,0,686,68,754,754,0,0
38750,2019-10-16,621,0,621,62,683,0,683,0
38751,2019-10-16,381,0,381,30,411,411,0,0
38752,2019-10-16,343,0,343,34,377,377,0,0
38753,2019-10-16,668,0,668,53,721,721,0,0
38754,2019-10-16,409,0,409,32,441,0,0,441
38755,2019-10-16,446,0,446,35,481,481,0,0
38756,2019-10-16,279,0,279,22,301,0,0,301
38757,2019-10-16,724,0,724,57,781,0,0,781
38758,2019-10-16,1099,0,1099,87,1186,1186,0,0
38759,2019-10-16,773,0,773,77,850,850,0,0
38760,2019-10-16,1184,0,1184,118,1302,1302,0,0
38761,2019-10-16,1123,0,1123,89,1212,1212,0,0
38762,2019-10-16,677,0,677,54,731,731,0,0
38763,2019-10-16,722,0,722,57,779,779,0,0
38764,2019-10-16,1158,0,1158,115,1273,1273,0,0
38765,2019-10-16,167,0,167,13,180,180,0,0
38766,2019-10-16,773,0,773,77,850,850,0,0
38767,2019-10-16,1546,0,1546,154,1700,1700,0,0
38768,2019-10-16,569,0,569,45,614,614,0,0
38769,2019-10-16,825,0,825,66,891,891,0,0
38770,2019-10-16,1250,0,1250,125,1375,1375,0,0
38771,2019-10-16,843,0,843,84,927,927,0,0
38772,2019-10-16,2592,0,2592,259,2851,2851,0,0
38773,2019-10-16,1039,0,1039,83,1122,1122,0,0
38774,2019-10-16,445,0,445,35,480,480,0,0
38775,2019-10-16,260,0,260,20,280,0,280,0
38776,2019-10-16,389,0,389,38,427,0,427,0
38777,2019-10-16,-260,0,-260,-26,-286,0,-286,0
38778,2019-10-16,630,0,630,63,693,0,693,0
38779,2019-10-16,352,0,352,35,387,0,387,0
38780,2019-10-16,260,0,260,20,280,280,0,0
38781,2019-10-16,773,0,773,77,850,850,0,0
38782,2019-10-16,751,0,751,60,811,811,0,0
38783,2019-10-16,773,0,773,77,850,850,0,0
38784,2019-10-16,1094,0,1094,109,1203,1203,0,0
38785,2019-10-16,399,0,399,31,430,0,430,0
38786,2019-10-16,1020,0,1020,81,1101,1101,0,0
38787,2019-10-16,955,0,955,76,1031,1031,0,0
38788,2019-10-16,176,0,176,17,193,193,0,0
38789,2019-10-16,501,0,501,40,541,541,0,0
38790,2019-10-16,1097,0,1097,87,1184,1184,0,0
38791,2019-10-16,809,0,809,64,873,873,0,0
38792,2019-10-16,917,0,917,91,1008,1008,0,0
38793,2019-10-16,640,0,640,51,691,691,0,0
38794,2019-10-16,576,0,576,46,622,622,0,0
38795,2019-10-16,983,0,983,78,1061,1061,0,0
38796,2019-10-16,400,0,400,32,432,432,0,0
38797,2019-10-16,1077,0,1077,107,1184,1184,0,0
38798,2019-10-16,1224,0,1224,97,1321,1321,0,0
38799,2019-10-16,716,0,716,57,773,773,0,0
38800,2019-10-16,1546,0,1546,154,1700,1700,0,0
38801,2019-10-16,585,0,585,46,631,631,0,0
38802,2019-10-16,927,0,927,74,1001,0,1001,0
38803,2019-10-16,306,0,306,24,330,330,0,0
38804,2019-10-16,510,0,510,40,550,550,0,0
38805,2019-10-16,1546,0,1546,154,1700,1700,0,0
38806,2019-10-16,773,0,773,77,850,850,0,0
38807,2019-10-16,890,0,890,71,961,0,961,0
38808,2019-10-16,773,0,773,77,850,850,0,0
38809,2019-10-16,873,0,873,69,942,942,0,0
38810,2019-10-16,787,0,787,78,865,865,0,0
38811,2019-10-17,778,0,778,62,840,840,0,0
38812,2019-10-17,1042,0,1042,83,1125,1125,0,0
38813,2019-10-17,695,0,695,69,764,764,0,0
38814,2019-10-17,1763,0,1763,141,1904,1904,0,0
38815,2019-10-17,891,0,891,89,980,0,0,980
38816,2019-10-17,891,0,891,89,980,0,0,980
38817,2019-10-17,121,0,121,12,133,133,0,0
38818,2019-10-17,854,0,854,68,922,922,0,0
38819,2019-10-17,667,-133,534,42,576,576,0,0
38820,2019-10-17,893,0,893,71,964,964,0,0
38821,2019-10-17,706,0,706,56,762,762,0,0
38822,2019-10-17,519,0,519,41,560,560,0,0
38823,2019-10-17,974,0,974,77,1051,0,1051,0
38824,2019-10-17,400,0,400,32,432,432,0,0
38825,2019-10-17,732,0,732,58,790,0,0,790
38826,2019-10-17,861,0,861,86,947,947,0,0
38827,2019-10-17,732,0,732,73,805,805,0,0
38828,2019-10-17,1065,0,1065,106,1171,1171,0,0
38829,2019-10-17,770,0,770,61,831,831,0,0
38830,2019-10-17,352,0,352,35,387,0,387,0
38831,2019-10-17,1546,0,1546,154,1700,1700,0,0
38832,2019-10-17,3092,0,3092,309,3401,3401,0,0
38833,2019-10-17,622,0,622,49,671,671,0,0
38834,2019-10-17,371,0,371,29,400,400,0,0
38835,2019-10-17,455,0,455,36,491,491,0,0
38836,2019-10-17,47,0,47,4,51,51,0,0
38837,2019-10-17,809,0,809,64,873,873,0,0
38838,2019-10-17,436,0,436,34,470,470,0,0
38839,2019-10-17,1093,0,1093,109,1202,1202,0,0
38840,2019-10-17,1782,0,1782,178,1960,0,0,1960
38841,2019-10-17,742,0,742,59,801,801,0,0
38842,2019-10-17,1782,0,1782,178,1960,1960,0,0
38843,2019-10-17,519,0,519,51,570,570,0,0
38844,2019-10-17,678,0,678,67,745,0,0,745
38845,2019-10-17,779,0,779,62,841,841,0,0
38846,2019-10-17,512,0,512,40,552,0,552,0
38847,2019-10-17,689,0,689,55,744,744,0,0
38848,2019-10-17,167,0,167,16,183,183,0,0
38849,2019-10-17,1925,0,1925,192,2117,2117,0,0
38850,2019-10-17,1538,0,1538,123,1661,1661,0,0
38851,2019-10-17,789,0,789,63,852,0,852,0
38852,2019-10-17,546,0,546,54,600,600,0,0
38853,2019-10-17,399,0,399,31,430,430,0,0
38854,2019-10-17,427,0,427,34,461,461,0,0
38855,2019-10-17,836,0,836,66,902,902,0,0
38856,2019-10-17,436,0,436,34,470,470,0,0
38857,2019-10-17,1418,0,1418,113,1531,0,1531,0
38858,2019-10-17,1253,0,1253,125,1378,0,1378,0
38859,2019-10-17,1050,0,1050,84,1134,0,1134,0
38860,2019-10-17,167,0,167,16,183,183,0,0
38861,2019-10-17,279,0,279,22,301,301,0,0
38862,2019-10-17,427,0,427,34,461,461,0,0
38863,2019-10-17,612,0,612,48,660,660,0,0
38864,2019-10-17,316,0,316,25,341,0,0,341
38865,2019-10-17,241,0,241,19,260,260,0,0
38866,2019-10-17,250,0,250,20,270,270,0,0
38867,2019-10-17,464,0,464,37,501,0,501,0
38868,2019-10-17,686,0,686,54,740,740,0,0
38869,2019-10-17,288,0,288,23,311,311,0,0
38870,2019-10-17,557,0,557,44,601,601,0,0
38871,2019-10-17,632,0,632,50,682,682,0,0
38872,2019-10-17,500,0,500,40,540,540,0,0
38873,2019-10-17,1782,0,1782,178,1960,1960,0,0
38874,2019-10-17,176,0,176,17,193,0,193,0
38875,2019-10-17,362,0,362,28,390,390,0,0
38876,2019-10-17,797,0,797,79,876,876,0,0
38877,2019-10-17,891,0,891,89,980,980,0,0
38878,2019-10-17,891,0,891,89,980,980,0,0
38879,2019-10-17,418,0,418,41,459,459,0,0
38880,2019-10-17,1552,0,1552,124,1676,1676,0,0
38881,2019-10-17,1103,0,1103,110,1213,0,1213,0
38882,2019-10-17,269,0,269,21,290,290,0,0
38883,2019-10-17,1279,0,1279,102,1381,1381,0,0
38884,2019-10-17,269,0,269,21,290,290,0,0
38885,2019-10-17,809,0,809,64,873,873,0,0
38886,2019-10-17,752,0,752,60,812,812,0,0
38887,2019-10-17,1159,0,1159,115,1274,1274,0,0
38888,2019-10-17,260,0,260,20,280,280,0,0
38889,2019-10-17,269,0,269,21,290,290,0,0
38890,2019-10-17,1150,0,1150,92,1242,1242,0,0
38891,2019-10-17,1372,0,1372,137,1509,0,1509,0
38892,2019-10-17,483,0,483,38,521,521,0,0
38893,2019-10-17,566,0,566,45,611,611,0,0
38894,2019-10-17,465,0,465,37,502,502,0,0
38895,2019-10-17,539,-107,432,34,466,466,0,0
38896,2019-10-17,537,0,537,42,579,0,579,0
38897,2019-10-17,336,0,336,26,362,362,0,0
38898,2019-10-17,232,0,232,18,250,250,0,0
38899,2019-10-17,324,0,324,25,349,349,0,0
38900,2019-10-17,1130,0,1130,113,1243,1243,0,0
38901,2019-10-17,381,0,381,30,411,411,0,0
38902,2019-10-17,1546,0,1546,154,1700,0,1700,0
38903,2019-10-17,298,0,298,23,321,0,0,321
38904,2019-10-17,232,0,232,18,250,250,0,0
38905,2019-10-17,371,0,371,29,400,400,0,0
38906,2019-10-17,631,0,631,50,681,681,0,0
38907,2019-10-17,316,0,316,25,341,341,0,0
38908,2019-10-17,650,0,650,52,702,702,0,0
38909,2019-10-17,370,0,370,37,407,407,0,0
38910,2019-10-17,389,0,389,38,427,0,0,427
38911,2019-10-17,427,0,427,34,461,461,0,0
38912,2019-10-17,389,0,389,38,427,427,0,0
38913,2019-10-17,370,0,370,37,407,407,0,0
38914,2019-10-17,436,0,436,34,470,470,0,0
38915,2019-10-17,559,0,559,44,603,603,0,0
38916,2019-10-17,547,0,547,54,601,601,0,0
38917,2019-10-17,761,0,761,76,837,837,0,0
38918,2019-10-17,455,0,455,36,491,491,0,0
38919,2019-10-17,521,0,521,41,562,562,0,0
38920,2019-10-17,817,0,817,81,898,898,0,0
38921,2019-10-17,705,0,705,70,775,0,775,0
38922,2019-10-17,668,0,668,66,734,734,0,0
38923,2019-10-17,1114,0,1114,89,1203,1203,0,0
38924,2019-10-17,1546,0,1546,154,1700,1700,0,0
38925,2019-10-17,1819,0,1819,181,2000,2000,0,0
38926,2019-10-17,773,0,773,77,850,850,0,0
38927,2019-10-17,761,0,761,76,837,837,0,0
38928,2019-10-17,1546,0,1546,154,1700,1700,0,0
38929,2019-10-17,232,0,232,18,250,250,0,0
38930,2019-10-17,232,0,232,18,250,250,0,0
38931,2019-10-17,269,0,269,21,290,290,0,0
38932,2019-10-17,509,0,509,40,549,549,0,0
38933,2019-10-17,390,0,390,31,421,0,421,0
38934,2019-10-17,555,0,555,55,610,610,0,0
38935,2019-10-17,1215,0,1215,97,1312,1312,0,0
38936,2019-10-17,773,0,773,77,850,850,0,0
38937,2019-10-17,773,0,773,77,850,850,0,0
38938,2019-10-17,158,0,158,12,170,170,0,0
38939,2019-10-17,566,0,566,45,611,611,0,0
38940,2019-10-17,1371,0,1371,137,1508,1508,0,0
38941,2019-10-17,232,0,232,18,250,250,0,0
38942,2019-10-17,1030,0,1030,82,1112,1112,0,0
38943,2019-10-17,224,0,224,22,246,246,0,0
38944,2019-10-17,158,0,158,12,170,170,0,0
38945,2019-10-17,474,0,474,37,511,511,0,0
38946,2019-10-17,324,0,324,25,349,349,0,0
38947,2019-10-17,773,0,773,77,850,850,0,0
38948,2019-10-17,740,0,740,74,814,814,0,0
38949,2019-10-17,491,0,491,49,540,540,0,0
38950,2019-10-17,510,0,510,51,561,561,0,0
38951,2019-10-17,528,0,528,52,580,580,0,0
38952,2019-10-17,773,0,773,77,850,0,0,850
38953,2019-10-17,658,0,658,65,723,723,0,0
38954,2019-10-17,476,0,476,38,514,514,0,0
38955,2019-10-18,112,0,112,8,120,120,0,0
38956,2019-10-18,463,0,463,46,509,509,0,0
38957,2019-10-18,648,0,648,51,699,699,0,0
38958,2019-10-18,575,0,575,46,621,621,0,0
38959,2019-10-18,474,0,474,37,511,511,0,0
38960,2019-10-18,445,0,445,35,480,480,0,0
38961,2019-10-18,389,0,389,38,427,0,427,0
38962,2019-10-18,297,0,297,23,320,320,0,0
38963,2019-10-18,510,0,510,40,550,550,0,0
38964,2019-10-18,1782,0,1782,178,1960,1960,0,0
38965,2019-10-18,260,0,260,20,280,280,0,0
38966,2019-10-18,334,0,334,26,360,360,0,0
38967,2019-10-18,391,0,391,31,422,422,0,0
38968,2019-10-18,512,0,512,51,563,563,0,0
38969,2019-10-18,2829,0,2829,282,3111,3111,0,0
38970,2019-10-18,465,0,465,37,502,502,0,0
38971,2019-10-18,288,0,288,23,311,311,0,0
38972,2019-10-18,390,0,390,31,421,421,0,0
38973,2019-10-18,566,0,566,45,611,0,0,611
38974,2019-10-18,417,0,417,33,450,450,0,0
38975,2019-10-18,372,0,372,37,409,409,0,0
38976,2019-10-18,740,0,740,74,814,814,0,0
38977,2019-10-18,269,0,269,21,290,290,0,0
38978,2019-10-18,1566,0,1566,156,1722,1722,0,0
38979,2019-10-18,427,0,427,34,461,461,0,0
38980,2019-10-18,307,0,307,24,331,331,0,0
38981,2019-10-18,158,0,158,12,170,170,0,0
38982,2019-10-18,2181,0,2181,218,2399,2399,0,0
38983,2019-10-18,204,0,204,16,220,220,0,0
38984,2019-10-18,1336,0,1336,106,1442,1442,0,0
38985,2019-10-18,2962,0,2962,296,3258,0,3258,0
38986,2019-10-18,982,0,982,98,1080,1080,0,0
38987,2019-10-18,410,0,410,32,442,442,0,0
38988,2019-10-18,1782,0,1782,178,1960,1960,0,0
38989,2019-10-18,1910,0,1910,191,2101,2101,0,0
38990,2019-10-18,1585,0,1585,158,1743,0,1743,0
38991,2019-10-18,1076,0,1076,86,1162,0,1162,0
38992,2019-10-18,3564,0,3564,356,3920,3920,0,0
38993,2019-10-18,233,0,233,18,251,251,0,0
38994,2019-10-18,362,0,362,28,390,390,0,0
38995,2019-10-18,714,0,714,71,785,785,0,0
38996,2019-10-18,1078,-107,971,77,1048,1048,0,0
38997,2019-10-18,529,0,529,42,571,0,571,0
38998,2019-10-18,1058,-211,847,67,914,914,0,0
38999,2019-10-18,474,0,474,37,511,511,0,0
39000,2019-10-18,1058,0,1058,105,1163,1163,0,0
39001,2019-10-18,530,0,530,42,572,572,0,0
39002,2019-10-18,1256,0,1256,125,1381,1381,0,0
39003,2019-10-18,911,-182,729,58,787,787,0,0
39004,2019-10-18,735,0,735,58,793,793,0,0
39005,2019-10-18,139,0,139,13,152,152,0,0
39006,2019-10-18,742,0,742,59,801,0,801,0
39007,2019-10-18,352,0,352,35,387,387,0,0
39008,2019-10-18,269,0,269,21,290,0,0,290
39009,2019-10-18,370,0,370,37,407,407,0,0
39010,2019-10-18,491,0,491,49,540,540,0,0
39011,2019-10-18,529,0,529,42,571,571,0,0
39012,2019-10-18,736,0,736,58,794,794,0,0
39013,2019-10-18,315,0,315,25,340,340,0,0
39014,2019-10-18,941,0,941,75,1016,1016,0,0
39015,2019-10-18,445,0,445,44,489,489,0,0
39016,2019-10-18,389,0,389,38,427,427,0,0
39017,2019-10-18,1335,0,1335,133,1468,1468,0,0
39018,2019-10-18,214,0,214,17,231,231,0,0
39019,2019-10-18,1001,0,1001,80,1081,1081,0,0
39020,2019-10-18,1256,0,1256,100,1356,1356,0,0
39021,2019-10-18,1707,0,1707,136,1843,0,1843,0
39022,2019-10-18,288,0,288,23,311,311,0,0
39023,2019-10-18,167,0,167,13,180,180,0,0
39024,2019-10-18,381,0,381,30,411,411,0,0
39025,2019-10-18,556,0,556,55,611,0,611,0
39026,2019-10-18,725,0,725,58,783,783,0,0
39027,2019-10-18,891,0,891,89,980,980,0,0
39028,2019-10-18,891,0,891,89,980,980,0,0
39029,2019-10-18,938,0,938,75,1013,0,1013,0
39030,2019-10-18,650,0,650,52,702,702,0,0
39031,2019-10-18,947,0,947,75,1022,0,1022,0
39032,2019-10-18,1699,0,1699,135,1834,0,0,1834
39033,2019-10-18,436,0,436,43,479,479,0,0
39034,2019-10-18,594,0,594,47,641,641,0,0
39035,2019-10-18,640,0,640,51,691,691,0,0
39036,2019-10-18,1141,0,1141,91,1232,1232,0,0
39037,2019-10-18,773,0,773,77,850,850,0,0
39038,2019-10-18,874,0,874,69,943,943,0,0
39039,2019-10-18,362,0,362,28,390,390,0,0
39040,2019-10-18,1546,0,1546,154,1700,1700,0,0
39041,2019-10-18,773,0,773,77,850,850,0,0
39042,2019-10-18,2319,0,2319,231,2550,0,0,2550
39043,2019-10-18,1546,0,1546,154,1700,1700,0,0
39044,2019-10-18,306,0,306,24,330,330,0,0
39045,2019-10-18,492,0,492,39,531,531,0,0
39046,2019-10-18,1546,0,1546,154,1700,0,1700,0
39047,2019-10-18,159,0,159,12,171,171,0,0
39048,2019-10-18,501,0,501,40,541,541,0,0
39049,2019-10-18,1546,0,1546,154,1700,1700,0,0
39050,2019-10-18,418,0,418,33,451,451,0,0
39051,2019-10-18,389,0,389,31,420,420,0,0
39052,2019-10-18,1374,0,1374,109,1483,1483,0,0
39053,2019-10-18,740,0,740,74,814,814,0,0
39054,2019-10-18,251,0,251,20,271,271,0,0
39055,2019-10-18,1558,0,1558,124,1682,1682,0,0
39056,2019-10-18,141,0,141,11,152,152,0,0
39057,2019-10-18,438,0,438,35,473,473,0,0
39058,2019-10-18,740,0,740,74,814,814,0,0
39059,2019-10-18,251,0,251,20,271,271,0,0
39060,2019-10-18,501,0,501,40,541,0,0,541
39061,2019-10-18,1419,-1000,419,33,452,452,0,0
39062,2019-10-18,613,0,613,49,662,662,0,0
39063,2019-10-18,1277,0,1277,127,1404,1404,0,0
39064,2019-10-18,520,0,520,41,561,561,0,0
39065,2019-10-18,428,0,428,34,462,462,0,0
39066,2019-10-18,538,0,538,43,581,581,0,0
39067,2019-10-18,167,0,167,13,180,180,0,0
39068,2019-10-18,465,0,465,37,502,502,0,0
39069,2019-10-18,615,0,615,49,664,664,0,0
39070,2019-10-18,509,0,509,50,559,559,0,0
39071,2019-10-18,509,0,509,50,559,559,0,0
39072,2019-10-18,843,0,843,84,927,927,0,0
39073,2019-10-18,696,0,696,55,751,751,0,0
39074,2019-10-18,752,0,752,60,812,812,0,0
39075,2019-10-18,1002,0,1002,80,1082,1082,0,0
39076,2019-10-18,604,0,604,48,652,652,0,0
39077,2019-10-18,993,0,993,79,1072,1072,0,0
39078,2019-10-18,306,0,306,24,330,330,0,0
39079,2019-10-18,352,-35,317,25,342,342,0,0
39080,2019-10-18,687,0,687,54,741,741,0,0
39081,2019-10-18,825,0,825,66,891,0,0,891
39082,2019-10-18,909,0,909,72,981,981,0,0
39083,2019-10-18,649,0,649,51,700,700,0,0
39084,2019-10-18,529,0,529,42,571,571,0,0
39085,2019-10-18,306,0,306,24,330,330,0,0
39086,2019-10-18,445,-44,401,32,433,0,433,0
39087,2019-10-18,417,0,417,33,450,450,0,0
39088,2019-10-18,575,0,575,46,621,621,0,0
39089,2019-10-18,584,0,584,46,630,630,0,0
39090,2019-10-18,1808,0,1808,144,1952,1952,0,0
39091,2019-10-18,778,0,778,77,855,855,0,0
39092,2019-10-18,1546,0,1546,154,1700,1700,0,0
39093,2019-10-18,722,0,722,72,794,0,794,0
39094,2019-10-18,2651,0,2651,212,2863,2863,0,0
39095,2019-10-18,1996,0,1996,199,2195,2195,0,0
39096,2019-10-18,538,0,538,43,581,581,0,0
39097,2019-10-18,983,0,983,78,1061,1061,0,0
39098,2019-10-18,1546,0,1546,154,1700,1700,0,0
39099,2019-10-18,1546,0,1546,154,1700,1700,0,0
39100,2019-10-18,1546,0,1546,154,1700,1700,0,0
39101,2019-10-18,482,0,482,48,530,530,0,0
39102,2019-10-18,1484,-148,1336,106,1442,1442,0,0
39103,2019-10-18,972,0,972,97,1069,1069,0,0
39104,2019-10-18,1546,0,1546,154,1700,1700,0,0
39105,2019-10-18,983,0,983,98,1081,1081,0,0
39106,2019-10-18,964,0,964,77,1041,0,1041,0
39107,2019-10-18,538,0,538,53,591,0,591,0
39108,2019-10-18,1546,0,1546,154,1700,1700,0,0
39109,2019-10-18,773,0,773,77,850,850,0,0
39110,2019-10-18,2236,0,2236,178,2414,2414,0,0
39111,2019-10-18,773,0,773,77,850,850,0,0
39112,2019-10-18,668,0,668,53,721,0,721,0
39113,2019-10-18,371,0,371,29,400,400,0,0
39114,2019-10-18,612,0,612,48,660,660,0,0
39115,2019-10-18,566,0,566,45,611,0,611,0
39116,2019-10-18,624,0,624,49,673,673,0,0
39117,2019-10-18,538,0,538,43,581,581,0,0
39118,2019-10-18,473,0,473,37,510,510,0,0
39119,2019-10-18,773,0,773,77,850,850,0,0
39120,2019-10-19,260,0,260,26,286,286,0,0
39121,2019-10-19,362,0,362,36,398,0,0,398
39122,2019-10-19,445,0,445,44,489,489,0,0
39123,2019-10-19,464,0,464,46,510,510,0,0
39124,2019-10-19,2328,0,2328,232,2560,0,2560,0
39125,2019-10-19,139,0,139,13,152,152,0,0
39126,2019-10-19,1017,0,1017,101,1118,1118,0,0
39127,2019-10-19,566,0,566,56,622,622,0,0
39128,2019-10-19,316,0,316,25,341,341,0,0
39129,2019-10-19,835,0,835,66,901,901,0,0
39130,2019-10-19,112,0,112,11,123,123,0,0
39131,2019-10-19,891,0,891,89,980,980,0,0
39132,2019-10-19,863,0,863,69,932,932,0,0
39133,2019-10-19,891,0,891,89,980,980,0,0
39134,2019-10-19,2492,-249,2243,224,2467,2467,0,0
39135,2019-10-19,261,0,261,20,281,281,0,0
39136,2019-10-19,3035,0,3035,303,3338,0,3338,0
39137,2019-10-19,770,0,770,61,831,831,0,0
39138,2019-10-19,232,0,232,18,250,250,0,0
39139,2019-10-19,436,0,436,34,470,470,0,0
39140,2019-10-19,946,0,946,75,1021,0,0,1021
39141,2019-10-19,389,0,389,31,420,420,0,0
39142,2019-10-19,520,0,520,41,561,561,0,0
39143,2019-10-19,682,0,682,54,736,736,0,0
39144,2019-10-19,3564,0,3564,356,3920,0,3920,0
39145,2019-10-19,1030,0,1030,82,1112,1112,0,0
39146,2019-10-19,306,0,306,24,330,330,0,0
39147,2019-10-19,945,0,945,94,1039,1039,0,0
39148,2019-10-19,1782,0,1782,178,1960,1960,0,0
39149,2019-10-19,1032,0,1032,103,1135,0,1135,0
39150,2019-10-19,1429,0,1429,114,1543,0,1543,0
39151,2019-10-19,863,0,863,69,932,932,0,0
39152,2019-10-19,585,0,585,46,631,631,0,0
39153,2019-10-19,649,0,649,51,700,700,0,0
39154,2019-10-19,780,0,780,62,842,842,0,0
39155,2019-10-19,724,0,724,57,781,781,0,0
39156,2019-10-19,1593,0,1593,159,1752,0,0,1752
39157,2019-10-19,612,0,612,48,660,660,0,0
39158,2019-10-19,390,0,390,31,421,421,0,0
39159,2019-10-19,891,0,891,89,980,980,0,0
39160,2019-10-19,602,0,602,60,662,662,0,0
39161,2019-10-19,1557,0,1557,155,1712,0,1712,0
39162,2019-10-19,548,0,548,43,591,591,0,0
39163,2019-10-19,936,0,936,93,1029,1029,0,0
39164,2019-10-19,1077,-215,862,68,930,930,0,0
39165,2019-10-19,399,0,399,31,430,430,0,0
39166,2019-10-19,621,0,621,62,683,683,0,0
39167,2019-10-19,529,0,529,42,571,0,0,571
39168,2019-10-19,1037,0,1037,103,1140,1140,0,0
39169,2019-10-19,1782,0,1782,178,1960,1960,0,0
39170,2019-10-19,631,0,631,50,681,681,0,0
39171,2019-10-19,872,0,872,69,941,941,0,0
39172,2019-10-19,641,0,641,51,692,692,0,0
39173,2019-10-19,334,0,334,26,360,360,0,0
39174,2019-10-19,687,0,687,54,741,741,0,0
39175,2019-10-19,916,0,916,91,1007,1007,0,0
39176,2019-10-19,307,0,307,24,331,331,0,0
39177,2019-10-19,325,0,325,26,351,351,0,0
39178,2019-10-19,1095,0,1095,87,1182,1182,0,0
39179,2019-10-19,390,0,390,31,421,421,0,0
39180,2019-10-19,-390,0,-390,-31,-421,-421,0,0
39181,2019-10-19,769,0,769,76,845,845,0,0
39182,2019-10-19,1782,0,1782,178,1960,1960,0,0
39183,2019-10-19,835,0,835,66,901,901,0,0
39184,2019-10-19,891,0,891,89,980,980,0,0
39185,2019-10-19,891,0,891,89,980,980,0,0
39186,2019-10-19,-891,0,-891,-89,-980,-980,0,0
39187,2019-10-19,455,0,455,36,491,491,0,0
39188,2019-10-19,715,0,715,57,772,772,0,0
39189,2019-10-19,724,0,724,57,781,781,0,0
39190,2019-10-19,288,0,288,23,311,311,0,0
39191,2019-10-19,94,0,94,7,101,101,0,0
39192,2019-10-19,677,0,677,54,731,731,0,0
39193,2019-10-19,957,0,957,76,1033,0,1033,0
39194,2019-10-19,232,0,232,18,250,250,0,0
39195,2019-10-19,1782,0,1782,178,1960,1960,0,0
39196,2019-10-19,1782,0,1782,178,1960,1960,0,0
39197,2019-10-19,807,0,807,64,871,871,0,0
39198,2019-10-19,742,0,742,59,801,801,0,0
39199,2019-10-19,1421,0,1421,113,1534,1534,0,0
39200,2019-10-19,512,0,512,40,552,0,552,0
39201,2019-10-19,100,0,100,8,108,108,0,0
39202,2019-10-19,186,0,186,14,200,0,0,200
39203,2019-10-19,828,0,828,66,894,894,0,0
39204,2019-10-19,622,0,622,49,671,671,0,0
39205,2019-10-19,112,0,112,8,120,120,0,0
39206,2019-10-19,455,0,455,36,491,0,0,491
39207,2019-10-19,371,0,371,29,400,400,0,0
39208,2019-10-19,306,0,306,24,330,330,0,0
39209,2019-10-19,1256,-251,1005,80,1085,1085,0,0
39210,2019-10-19,773,0,773,77,850,850,0,0
39211,2019-10-19,2319,0,2319,231,2550,2550,0,0
39212,2019-10-19,2319,0,2319,231,2550,0,2550,0
39213,2019-10-19,1546,0,1546,154,1700,0,0,1700
39214,2019-10-19,1354,0,1354,108,1462,1462,0,0
39215,2019-10-19,1546,0,1546,154,1700,1700,0,0
39216,2019-10-19,-1256,0,-1256,-100,-1356,-1356,0,0
39217,2019-10-19,400,-40,360,28,388,0,388,0
39218,2019-10-19,390,0,390,31,421,421,0,0
39219,2019-10-19,1123,0,1123,112,1235,1235,0,0
39220,2019-10-19,2628,0,2628,210,2838,2838,0,0
39221,2019-10-19,2673,0,2673,267,2940,0,2940,0
39222,2019-10-19,288,0,288,23,311,311,0,0
39223,2019-10-19,584,0,584,46,630,630,0,0
39224,2019-10-19,1782,0,1782,178,1960,1960,0,0
39225,2019-10-19,188,0,188,15,203,203,0,0
39226,2019-10-19,1002,0,1002,100,1102,1102,0,0
39227,2019-10-19,242,0,242,19,261,261,0,0
39228,2019-10-19,789,0,789,78,867,0,867,0
39229,2019-10-19,167,0,167,13,180,180,0,0
39230,2019-10-19,861,0,861,86,947,947,0,0
39231,2019-10-19,845,0,845,67,912,0,912,0
39232,2019-10-19,260,0,260,20,280,280,0,0
39233,2019-10-19,299,0,299,23,322,0,322,0
39234,2019-10-19,167,0,167,13,180,180,0,0
39235,2019-10-19,353,0,353,28,381,381,0,0
39236,2019-10-19,769,0,769,76,845,845,0,0
39237,2019-10-19,273,0,273,27,300,300,0,0
39238,2019-10-19,982,0,982,98,1080,1080,0,0
39239,2019-10-19,530,0,530,42,572,572,0,0
39240,2019-10-19,437,0,437,34,471,471,0,0
39241,2019-10-19,773,-77,696,69,765,765,0,0
39242,2019-10-19,269,0,269,21,290,290,0,0
39243,2019-10-19,1546,0,1546,154,1700,1700,0,0
39244,2019-10-19,1437,0,1437,114,1551,1551,0,0
39245,2019-10-19,1547,0,1547,154,1701,1701,0,0
39246,2019-10-19,1465,0,1465,146,1611,1611,0,0
39247,2019-10-19,167,0,167,13,180,180,0,0
39248,2019-10-19,1546,0,1546,154,1700,1700,0,0
39249,2019-10-19,186,0,186,14,200,200,0,0
39250,2019-10-19,1430,0,1430,114,1544,0,1544,0
39251,2019-10-19,269,0,269,21,290,290,0,0
39252,2019-10-19,957,0,957,76,1033,1033,0,0
39253,2019-10-19,501,0,501,40,541,541,0,0
39254,2019-10-19,1546,-154,1392,139,1531,0,1531,0
39255,2019-10-19,724,0,724,57,781,781,0,0
39256,2019-10-19,299,0,299,23,322,322,0,0
39257,2019-10-19,973,0,973,97,1070,1070,0,0
39258,2019-10-19,762,0,762,60,822,822,0,0
39259,2019-10-19,926,0,926,92,1018,0,0,1018
39260,2019-10-19,1546,0,1546,154,1700,1700,0,0
39261,2019-10-19,557,0,557,44,601,601,0,0
39262,2019-10-19,1306,0,1306,130,1436,0,0,1436
39263,2019-10-19,181,0,181,14,195,195,0,0
39264,2019-10-19,2092,0,2092,209,2301,0,2301,0
39265,2019-10-19,385,0,385,30,415,415,0,0
39266,2019-10-19,520,0,520,41,561,561,0,0
39267,2019-10-19,593,0,593,47,640,0,0,640
39268,2019-10-19,1038,0,1038,103,1141,1141,0,0
39269,2019-10-19,1096,0,1096,109,1205,0,1205,0
39270,2019-10-19,773,0,773,77,850,0,850,0
39271,2019-10-19,3601,0,3601,288,3889,3889,0,0
39272,2019-10-19,773,0,773,77,850,850,0,0
39273,2019-10-19,2486,0,2486,198,2684,0,2684,0
39274,2019-10-19,1030,0,1030,103,1133,1133,0,0
39275,2019-10-19,279,0,279,22,301,301,0,0
39276,2019-10-19,807,0,807,80,887,0,0,887
39277,2019-10-19,1546,0,1546,154,1700,1700,0,0
39278,2019-10-20,715,0,715,57,772,772,0,0
39279,2019-10-20,2527,0,2527,202,2729,2729,0,0
39280,2019-10-20,510,-51,459,36,495,495,0,0
39281,2019-10-20,891,0,891,89,980,980,0,0
39282,2019-10-20,400,0,400,40,440,0,440,0
39283,2019-10-20,891,0,891,89,980,980,0,0
39284,2019-10-20,603,0,603,48,651,651,0,0
39285,2019-10-20,306,0,306,24,330,330,0,0
39286,2019-10-20,974,0,974,77,1051,1051,0,0
39287,2019-10-20,1224,0,1224,97,1321,1321,0,0
39288,2019-10-20,622,0,622,49,671,671,0,0
39289,2019-10-20,891,0,891,89,980,0,0,980
39290,2019-10-20,1095,0,1095,87,1182,1182,0,0
39291,2019-10-20,334,0,334,33,367,367,0,0
39292,2019-10-20,251,0,251,20,271,0,271,0
39293,2019-10-20,436,0,436,34,470,470,0,0
39294,2019-10-20,890,0,890,89,979,0,979,0
39295,2019-10-20,781,0,781,62,843,843,0,0
39296,2019-10-20,890,0,890,89,979,979,0,0
39297,2019-10-20,1346,0,1346,134,1480,1480,0,0
39298,2019-10-20,751,0,751,75,826,826,0,0
39299,2019-10-20,891,0,891,89,980,980,0,0
39300,2019-10-20,780,0,780,62,842,842,0,0
39301,2019-10-20,370,0,370,37,407,407,0,0
39302,2019-10-20,260,-26,234,18,252,0,252,0
39303,2019-10-20,279,0,279,22,301,301,0,0
39304,2019-10-20,325,0,325,26,351,351,0,0
39305,2019-10-20,622,0,622,49,671,671,0,0
39306,2019-10-20,1260,0,1260,126,1386,1386,0,0
39307,2019-10-20,1427,0,1427,142,1569,1569,0,0
39308,2019-10-20,834,0,834,66,900,900,0,0
39309,2019-10-20,614,0,614,49,663,663,0,0
39310,2019-10-20,779,0,779,62,841,841,0,0
39311,2019-10-20,556,0,556,44,600,600,0,0
39312,2019-10-20,1373,0,1373,109,1482,0,0,1482
39313,2019-10-20,381,0,381,30,411,0,0,411
39314,2019-10-20,1226,0,1226,98,1324,1324,0,0
39315,2019-10-20,686,0,686,68,754,754,0,0
39316,2019-10-20,3111,0,3111,311,3422,3422,0,0
39317,2019-10-20,623,0,623,62,685,685,0,0
39318,2019-10-20,139,0,139,11,150,150,0,0
39319,2019-10-20,382,0,382,38,420,420,0,0
39320,2019-10-20,537,0,537,53,590,590,0,0
39321,2019-10-20,428,0,428,42,470,470,0,0
39322,2019-10-20,520,0,520,52,572,572,0,0
39323,2019-10-20,334,0,334,26,360,360,0,0
39324,2019-10-20,1744,0,1744,139,1883,1883,0,0
39325,2019-10-20,455,0,455,36,491,491,0,0
39326,2019-10-20,370,0,370,37,407,407,0,0
39327,2019-10-20,436,0,436,34,470,470,0,0
39328,2019-10-20,835,0,835,66,901,901,0,0
39329,2019-10-20,798,0,798,63,861,0,0,861
39330,2019-10-20,975,0,975,78,1053,1053,0,0
39331,2019-10-20,881,0,881,88,969,969,0,0
39332,2019-10-20,186,0,186,18,204,204,0,0
39333,2019-10-20,705,0,705,70,775,0,775,0
39334,2019-10-20,641,0,641,51,692,692,0,0
39335,2019-10-20,847,0,847,67,914,914,0,0
39336,2019-10-20,297,0,297,23,320,320,0,0
39337,2019-10-20,704,0,704,70,774,774,0,0
39338,2019-10-20,307,0,307,24,331,0,0,331
39339,2019-10-20,370,0,370,37,407,407,0,0
39340,2019-10-20,652,0,652,52,704,704,0,0
39341,2019-10-20,651,0,651,52,703,703,0,0
39342,2019-10-20,1394,0,1394,111,1505,1505,0,0
39343,2019-10-20,595,0,595,47,642,642,0,0
39344,2019-10-20,260,0,260,20,280,280,0,0
39345,2019-10-20,509,0,509,50,559,559,0,0
39346,2019-10-20,392,0,392,31,423,423,0,0
39347,2019-10-20,493,0,493,39,532,532,0,0
39348,2019-10-20,650,0,650,52,702,702,0,0
39349,2019-10-20,537,0,537,53,590,590,0,0
39350,2019-10-20,891,-89,802,80,882,882,0,0
39351,2019-10-20,788,0,788,78,866,866,0,0
39352,2019-10-20,1529,0,1529,152,1681,1681,0,0
39353,2019-10-20,585,0,585,46,631,631,0,0
39354,2019-10-20,649,0,649,51,700,700,0,0
39355,2019-10-20,269,0,269,21,290,290,0,0
39356,2019-10-20,306,0,306,24,330,330,0,0
39357,2019-10-20,834,0,834,83,917,917,0,0
39358,2019-10-20,891,0,891,89,980,0,980,0
39359,2019-10-20,891,0,891,89,980,0,980,0
39360,2019-10-20,649,0,649,64,713,713,0,0
39361,2019-10-20,520,0,520,41,561,561,0,0
39362,2019-10-20,399,0,399,31,430,430,0,0
39363,2019-10-20,899,0,899,89,988,988,0,0
39364,2019-10-20,558,0,558,44,602,602,0,0
39365,2019-10-20,112,0,112,8,120,0,0,120
39366,2019-10-20,1782,0,1782,178,1960,1960,0,0
39367,2019-10-20,492,0,492,39,531,531,0,0
39368,2019-10-20,520,0,520,41,561,561,0,0
39369,2019-10-20,891,0,891,89,980,980,0,0
39370,2019-10-20,891,0,891,89,980,980,0,0
39371,2019-10-20,181,0,181,14,195,195,0,0
39372,2019-10-20,1782,0,1782,178,1960,1960,0,0
39373,2019-10-20,167,0,167,16,183,183,0,0
39374,2019-10-20,706,0,706,56,762,762,0,0
39375,2019-10-20,139,0,139,11,150,150,0,0
39376,2019-10-20,705,0,705,70,775,775,0,0
39377,2019-10-20,732,0,732,73,805,805,0,0
39378,2019-10-20,984,0,984,78,1062,1062,0,0
39379,2019-10-20,1049,0,1049,83,1132,0,1132,0
39380,2019-10-20,1049,0,1049,83,1132,1132,0,0
39381,2019-10-20,511,0,511,40,551,551,0,0
39382,2019-10-20,593,0,593,47,640,640,0,0
39383,2019-10-20,1160,0,1160,92,1252,1252,0,0
39384,2019-10-20,502,0,502,40,542,542,0,0
39385,2019-10-20,399,0,399,31,430,430,0,0
39386,2019-10-20,965,0,965,77,1042,1042,0,0
39387,2019-10-20,1641,0,1641,164,1805,1805,0,0
39388,2019-10-20,584,0,584,46,630,630,0,0
39389,2019-10-20,781,0,781,62,843,843,0,0
39390,2019-10-20,168,0,168,13,181,181,0,0
39391,2019-10-20,362,0,362,28,390,0,390,0
39392,2019-10-20,232,0,232,18,250,250,0,0
39393,2019-10-20,902,0,902,72,974,974,0,0
39394,2019-10-20,455,-45,410,32,442,442,0,0
39395,2019-10-20,195,0,195,15,210,210,0,0
39396,2019-10-20,260,-26,234,18,252,252,0,0
39397,2019-10-20,47,0,47,3,50,50,0,0
39398,2019-10-20,446,0,446,35,481,0,481,0
39399,2019-10-20,825,0,825,66,891,891,0,0
39400,2019-10-20,334,-33,301,24,325,325,0,0
39401,2019-10-20,569,0,569,45,614,614,0,0
39402,2019-10-20,491,0,491,49,540,540,0,0
39403,2019-10-20,891,0,891,89,980,980,0,0
39404,2019-10-20,428,0,428,34,462,462,0,0
39405,2019-10-20,891,0,891,89,980,980,0,0
39406,2019-10-20,891,0,891,89,980,980,0,0
39407,2019-10-20,531,0,531,42,573,0,573,0
39408,2019-10-20,214,0,214,17,231,231,0,0
39409,2019-10-20,469,0,469,37,506,0,506,0
39410,2019-10-20,628,0,628,62,690,0,0,690
39411,2019-10-20,1129,0,1129,112,1241,1241,0,0
39412,2019-10-20,224,0,224,22,246,246,0,0
39413,2019-10-20,723,0,723,72,795,0,0,795
39414,2019-10-20,722,0,722,72,794,794,0,0
39415,2019-10-20,1002,0,1002,80,1082,1082,0,0
39416,2019-10-20,1651,0,1651,165,1816,1816,0,0
39417,2019-10-20,3128,0,3128,250,3378,3378,0,0
39418,2019-10-20,325,0,325,26,351,351,0,0
39419,2019-10-20,491,0,491,49,540,540,0,0
39420,2019-10-20,491,0,491,49,540,540,0,0
39421,2019-10-20,389,0,389,38,427,427,0,0
39422,2019-10-20,389,0,389,38,427,427,0,0
39423,2019-10-20,370,0,370,37,407,407,0,0
39424,2019-10-20,1943,0,1943,194,2137,2137,0,0
39425,2019-10-20,130,0,130,13,143,0,143,0
39426,2019-10-20,687,0,687,54,741,741,0,0
39427,2019-10-20,436,0,436,43,479,479,0,0
39428,2019-10-20,2335,0,2335,233,2568,2568,0,0
39429,2019-10-20,149,0,149,11,160,160,0,0
39430,2019-10-20,715,0,715,57,772,772,0,0
39431,2019-10-20,288,0,288,28,316,316,0,0
39432,2019-10-20,773,0,773,77,850,850,0,0
39433,2019-10-20,742,0,742,59,801,801,0,0
39434,2019-10-20,1186,0,1186,94,1280,1280,0,0
39435,2019-10-20,918,0,918,73,991,991,0,0
39436,2019-10-20,872,0,872,69,941,0,941,0
39437,2019-10-20,334,0,334,26,360,360,0,0
39438,2019-10-20,519,0,519,51,570,570,0,0
39439,2019-10-20,1195,0,1195,119,1314,1314,0,0
39440,2019-10-20,1067,0,1067,85,1152,1152,0,0
39441,2019-10-20,1290,0,1290,129,1419,1419,0,0
39442,2019-10-20,448,0,448,35,483,483,0,0
39443,2019-10-20,334,0,334,26,360,360,0,0
39444,2019-10-20,306,0,306,24,330,330,0,0
39445,2019-10-20,546,0,546,54,600,600,0,0
39446,2019-10-20,529,0,529,42,571,571,0,0
39447,2019-10-20,371,0,371,37,408,408,0,0
39448,2019-10-20,232,0,232,18,250,250,0,0
39449,2019-10-20,588,0,588,47,635,635,0,0
39450,2019-10-20,843,0,843,67,910,910,0,0
39451,2019-10-20,232,0,232,18,250,250,0,0
39452,2019-10-20,167,0,167,16,183,183,0,0
39453,2019-10-20,1547,0,1547,154,1701,1701,0,0
39454,2019-10-20,409,0,409,32,441,0,0,441
39455,2019-10-20,1819,0,1819,181,2000,0,0,2000
39456,2019-10-20,1546,0,1546,154,1700,1700,0,0
39457,2019-10-20,408,0,408,32,440,440,0,0
39458,2019-10-20,773,0,773,77,850,850,0,0
39459,2019-10-20,531,0,531,42,573,0,573,0
39460,2019-10-20,773,0,773,77,850,0,850,0
39461,2019-10-20,1686,0,1686,168,1854,0,1854,0
39462,2019-10-20,1546,0,1546,154,1700,0,0,1700
39463,2019-10-20,2296,0,2296,194,2490,2490,0,0
39464,2019-10-20,334,0,334,26,360,360,0,0
39465,2019-10-20,491,0,491,49,540,540,0,0
39466,2019-10-20,1557,0,1557,155,1712,1712,0,0
39467,2019-10-20,1778,0,1778,177,1955,0,1955,0
39468,2019-10-20,1546,0,1546,154,1700,0,1700,0
39469,2019-10-20,1084,0,1084,108,1192,0,1192,0
39470,2019-10-20,362,0,362,28,390,390,0,0
39471,2019-10-20,1046,0,1046,104,1150,0,1150,0
39472,2019-10-20,1640,0,1640,164,1804,1804,0,0
39473,2019-10-20,2656,0,2656,222,2878,0,0,2878
39474,2019-10-20,1546,0,1546,154,1700,1700,0,0
39475,2019-10-21,1174,0,1174,117,1291,1291,0,0
39476,2019-10-21,389,0,389,31,420,420,0,0
39477,2019-10-21,325,0,325,26,351,0,0,351
39478,2019-10-21,806,0,806,64,870,870,0,0
39479,2019-10-21,260,0,260,26,286,286,0,0
39480,2019-10-21,334,0,334,33,367,367,0,0
39481,2019-10-21,603,0,603,48,651,651,0,0
39482,2019-10-21,334,0,334,26,360,360,0,0
39483,2019-10-21,891,0,891,89,980,980,0,0
39484,2019-10-21,763,0,763,61,824,824,0,0
39485,2019-10-21,727,0,727,58,785,785,0,0
39486,2019-10-21,937,0,937,74,1011,1011,0,0
39487,2019-10-21,1158,0,1158,92,1250,1250,0,0
39488,2019-10-21,1040,0,1040,104,1144,1144,0,0
39489,2019-10-21,603,0,603,48,651,651,0,0
39490,2019-10-21,298,0,298,23,321,321,0,0
39491,2019-10-21,1931,0,1931,193,2124,2124,0,0
39492,2019-10-21,1782,0,1782,178,1960,1960,0,0
39493,2019-10-21,2673,0,2673,267,2940,2940,0,0
39494,2019-10-21,2673,0,2673,267,2940,2940,0,0
39495,2019-10-21,1058,0,1058,84,1142,1142,0,0
39496,2019-10-21,882,0,882,70,952,952,0,0
39497,2019-10-21,733,0,733,58,791,791,0,0
39498,2019-10-21,900,0,900,72,972,972,0,0
39499,2019-10-21,1040,0,1040,83,1123,1123,0,0
39500,2019-10-21,492,0,492,39,531,531,0,0
39501,2019-10-21,891,0,891,89,980,980,0,0
39502,2019-10-21,1782,0,1782,178,1960,0,1960,0
39503,2019-10-21,956,0,956,76,1032,1032,0,0
39504,2019-10-21,835,0,835,66,901,901,0,0
39505,2019-10-21,1504,0,1504,120,1624,0,1624,0
39506,2019-10-21,2068,0,2068,206,2274,2274,0,0
39507,2019-10-21,1782,0,1782,178,1960,1960,0,0
39508,2019-10-21,1782,0,1782,178,1960,1960,0,0
39509,2019-10-21,1782,0,1782,178,1960,1960,0,0
39510,2019-10-21,557,0,557,44,601,0,601,0
39511,2019-10-21,288,0,288,23,311,311,0,0
39512,2019-10-21,232,0,232,18,250,250,0,0
39513,2019-10-21,464,0,464,37,501,501,0,0
39514,2019-10-21,628,0,628,62,690,690,0,0
39515,2019-10-21,1112,0,1112,111,1223,1223,0,0
39516,2019-10-21,919,0,919,73,992,992,0,0
39517,2019-10-21,1426,0,1426,142,1568,0,1568,0
39518,2019-10-21,260,0,260,20,280,280,0,0
39519,2019-10-21,613,0,613,49,662,662,0,0
39520,2019-10-21,1017,0,1017,101,1118,1118,0,0
39521,2019-10-21,928,0,928,74,1002,1002,0,0
39522,2019-10-21,1038,0,1038,103,1141,0,0,1141
39523,2019-10-21,548,0,548,43,591,591,0,0
39524,2019-10-21,978,0,978,78,1056,1056,0,0
39525,2019-10-21,974,0,974,77,1051,1051,0,0
39526,2019-10-21,1232,0,1232,123,1355,1355,0,0
39527,2019-10-21,798,0,798,63,861,861,0,0
39528,2019-10-21,743,0,743,59,802,802,0,0
39529,2019-10-21,1782,0,1782,178,1960,1960,0,0
39530,2019-10-21,1344,0,1344,107,1451,1451,0,0
39531,2019-10-21,891,0,891,89,980,980,0,0
39532,2019-10-21,1782,0,1782,178,1960,1960,0,0
39533,2019-10-21,546,0,546,54,600,600,0,0
39534,2019-10-21,1782,0,1782,178,1960,1960,0,0
39535,2019-10-21,1086,0,1086,86,1172,1172,0,0
39536,2019-10-21,409,0,409,32,441,441,0,0
39537,2019-10-21,891,0,891,89,980,980,0,0
39538,2019-10-21,408,0,408,32,440,440,0,0
39539,2019-10-21,279,0,279,22,301,301,0,0
39540,2019-10-21,167,0,167,13,180,180,0,0
39541,2019-10-21,1152,-115,1037,82,1119,0,0,1119
39542,2019-10-21,232,-46,186,14,200,200,0,0
39543,2019-10-21,556,-55,501,40,541,0,541,0
39544,2019-10-21,501,0,501,40,541,541,0,0
39545,2019-10-21,1263,0,1263,126,1389,0,1389,0
39546,2019-10-21,909,0,909,72,981,981,0,0
39547,2019-10-21,1782,0,1782,178,1960,1960,0,0
39548,2019-10-21,260,0,260,20,280,280,0,0
39549,2019-10-21,594,0,594,47,641,641,0,0
39550,2019-10-21,251,0,251,20,271,0,271,0
39551,2019-10-21,1394,0,1394,111,1505,1505,0,0
39552,2019-10-21,510,0,510,51,561,561,0,0
39553,2019-10-21,510,0,510,51,561,561,0,0
39554,2019-10-21,409,0,409,32,441,441,0,0
39555,2019-10-21,47,0,47,3,50,50,0,0
39556,2019-10-21,269,0,269,21,290,290,0,0
39557,2019-10-21,320,0,320,25,345,345,0,0
39558,2019-10-21,232,0,232,18,250,0,250,0
39559,2019-10-21,389,0,389,31,420,420,0,0
39560,2019-10-21,428,0,428,34,462,462,0,0
39561,2019-10-21,298,0,298,23,321,321,0,0
39562,2019-10-21,102,0,102,8,110,110,0,0
39563,2019-10-21,362,0,362,28,390,0,0,390
39564,2019-10-21,576,0,576,46,622,0,0,622
39565,2019-10-21,130,0,130,10,140,140,0,0
39566,2019-10-21,773,0,773,77,850,850,0,0
39567,2019-10-21,593,0,593,59,652,652,0,0
39568,2019-10-21,501,0,501,40,541,541,0,0
39569,2019-10-21,483,0,483,38,521,521,0,0
39570,2019-10-21,260,0,260,20,280,280,0,0
39571,2019-10-21,595,0,595,47,642,642,0,0
39572,2019-10-21,1112,0,1112,111,1223,1223,0,0
39573,2019-10-21,842,0,842,84,926,926,0,0
39574,2019-10-21,743,-74,669,53,722,722,0,0
39575,2019-10-21,353,0,353,28,381,381,0,0
39576,2019-10-21,269,0,269,21,290,290,0,0
39577,2019-10-21,1899,-189,1710,171,1881,1881,0,0
39578,2019-10-21,773,0,773,77,850,850,0,0
39579,2019-10-21,1298,0,1298,129,1427,0,0,1427
39580,2019-10-21,1354,0,1354,135,1489,1489,0,0
39581,2019-10-21,595,0,595,47,642,642,0,0
39582,2019-10-21,334,0,334,26,360,360,0,0
39583,2019-10-21,783,0,783,62,845,845,0,0
39584,2019-10-21,422,0,422,33,455,0,0,455
39585,2019-10-21,1601,0,1601,160,1761,1761,0,0
39586,2019-10-21,751,0,751,60,811,811,0,0
39587,2019-10-21,344,0,344,27,371,371,0,0
39588,2019-10-21,2592,0,2592,252,2844,2844,0,0
39589,2019-10-21,307,0,307,24,331,331,0,0
39590,2019-10-21,491,0,491,49,540,540,0,0
39591,2019-10-21,940,0,940,94,1034,1034,0,0
39592,2019-10-21,417,0,417,33,450,450,0,0
39593,2019-10-21,912,0,912,91,1003,1003,0,0
39594,2019-10-21,473,0,473,37,510,510,0,0
39595,2019-10-21,539,0,539,43,582,582,0,0
39596,2019-10-21,760,0,760,60,820,820,0,0
39597,2019-10-21,380,0,380,30,410,410,0,0
39598,2019-10-21,1819,0,1819,181,2000,0,0,2000
39599,2019-10-21,1503,0,1503,120,1623,0,1623,0
39600,2019-10-21,742,0,742,59,801,801,0,0
39601,2019-10-21,547,0,547,43,590,590,0,0
39602,2019-10-21,705,0,705,56,761,0,761,0
39603,2019-10-21,2319,0,2319,231,2550,2550,0,0
39604,2019-10-21,622,0,622,49,671,671,0,0
39605,2019-10-21,983,0,983,78,1061,1061,0,0
39606,2019-10-21,446,0,446,35,481,481,0,0
39607,2019-10-21,251,0,251,20,271,271,0,0
39608,2019-10-21,381,0,381,30,411,0,411,0
39609,2019-10-21,937,0,937,74,1011,0,1011,0
39610,2019-10-21,734,0,734,58,792,792,0,0
39611,2019-10-21,363,-36,327,26,353,353,0,0
39612,2019-10-21,103,-10,93,7,100,100,0,0
39613,2019-10-21,658,0,658,65,723,723,0,0
39614,2019-10-21,773,0,773,77,850,850,0,0
39615,2019-10-21,1546,0,1546,154,1700,1700,0,0
39616,2019-10-21,251,0,251,20,271,271,0,0
39617,2019-10-21,1046,0,1046,104,1150,0,1150,0
39618,2019-10-21,1046,0,1046,104,1150,0,1150,0
39619,2019-10-21,1280,0,1280,102,1382,1382,0,0
39620,2019-10-21,1589,0,1589,158,1747,1747,0,0
39621,2019-10-21,1546,0,1546,154,1700,1700,0,0
39622,2019-10-21,139,0,139,11,150,150,0,0
39623,2019-10-21,1271,-127,1144,91,1235,1235,0,0
39624,2019-10-21,593,0,593,47,640,640,0,0
39625,2019-10-21,1326,0,1326,106,1432,0,1432,0
39626,2019-10-21,1260,0,1260,126,1386,0,1386,0
39627,2019-10-22,2454,0,2454,245,2699,2699,0,0
39628,2019-10-22,232,0,232,18,250,0,0,250
39629,2019-10-22,-491,0,-491,-39,-530,-530,0,0
39630,2019-10-22,491,0,491,39,530,530,0,0
39631,2019-10-22,1168,0,1168,116,1284,1284,0,0
39632,2019-10-22,613,0,613,49,662,662,0,0
39633,2019-10-22,371,0,371,29,400,400,0,0
39634,2019-10-22,628,0,628,62,690,690,0,0
39635,2019-10-22,658,0,658,65,723,723,0,0
39636,2019-10-22,519,0,519,51,570,570,0,0
39637,2019-10-22,973,0,973,97,1070,1070,0,0
39638,2019-10-22,1067,0,1067,106,1173,1173,0,0
39639,2019-10-22,890,0,890,89,979,979,0,0
39640,2019-10-22,1027,0,1027,102,1129,1129,0,0
39641,2019-10-22,714,0,714,57,771,771,0,0
39642,2019-10-22,1233,0,1233,123,1356,1356,0,0
39643,2019-10-22,463,0,463,46,509,509,0,0
39644,2019-10-22,352,0,352,28,380,380,0,0
39645,2019-10-22,370,0,370,37,407,407,0,0
39646,2019-10-22,370,0,370,29,399,399,0,0
39647,2019-10-22,491,0,491,49,540,540,0,0
39648,2019-10-22,780,0,780,62,842,842,0,0
39649,2019-10-22,370,0,370,37,407,407,0,0
39650,2019-10-22,491,0,491,49,540,540,0,0
39651,2019-10-22,475,0,475,38,513,513,0,0
39652,2019-10-22,167,0,167,13,180,0,180,0
39653,2019-10-22,232,0,232,18,250,250,0,0
39654,2019-10-22,1324,0,1324,132,1456,0,1456,0
39655,2019-10-22,778,0,778,77,855,855,0,0
39656,2019-10-22,2408,0,2408,240,2648,2648,0,0
39657,2019-10-22,621,0,621,62,683,683,0,0
39658,2019-10-22,740,0,740,74,814,814,0,0
39659,2019-10-22,740,0,740,74,814,814,0,0
39660,2019-10-22,428,0,428,34,462,462,0,0
39661,2019-10-22,1009,0,1009,100,1109,1109,0,0
39662,2019-10-22,429,0,429,34,463,0,463,0
39663,2019-10-22,520,0,520,41,561,561,0,0
39664,2019-10-22,566,0,566,45,611,611,0,0
39665,2019-10-22,1520,0,1520,152,1672,0,0,1672
39666,2019-10-22,604,0,604,48,652,652,0,0
39667,2019-10-22,510,0,510,40,550,550,0,0
39668,2019-10-22,260,0,260,20,280,280,0,0
39669,2019-10-22,316,0,316,25,341,341,0,0
39670,2019-10-22,491,0,491,49,540,540,0,0
39671,2019-10-22,186,0,186,14,200,200,0,0
39672,2019-10-22,740,0,740,74,814,0,0,814
39673,2019-10-22,334,0,334,26,360,360,0,0
39674,2019-10-22,621,0,621,62,683,683,0,0
39675,2019-10-22,472,0,472,37,509,509,0,0
39676,2019-10-22,937,0,937,74,1011,1011,0,0
39677,2019-10-22,2203,0,2203,220,2423,0,2423,0
39678,2019-10-22,843,0,843,67,910,910,0,0
39679,2019-10-22,880,0,880,88,968,968,0,0
39680,2019-10-22,232,0,232,18,250,250,0,0
39681,2019-10-22,334,0,334,26,360,360,0,0
39682,2019-10-22,658,0,658,65,723,723,0,0
39683,2019-10-22,1288,0,1288,128,1416,0,1416,0
39684,2019-10-22,418,0,418,33,451,451,0,0
39685,2019-10-22,260,0,260,20,280,280,0,0
39686,2019-10-22,740,0,740,74,814,814,0,0
39687,2019-10-22,696,0,696,69,765,765,0,0
39688,2019-10-23,751,0,751,75,826,826,0,0
39689,2019-10-23,1706,0,1706,136,1842,1842,0,0
39690,2019-10-23,492,0,492,39,531,531,0,0
39691,2019-10-23,370,0,370,37,407,407,0,0
39692,2019-10-23,1151,0,1151,92,1243,1243,0,0
39693,2019-10-23,936,0,936,93,1029,1029,0,0
39694,2019-10-23,845,0,845,67,912,912,0,0
39695,2019-10-23,520,0,520,41,561,561,0,0
39696,2019-10-23,891,0,891,89,980,980,0,0
39697,2019-10-23,418,0,418,33,451,451,0,0
39698,2019-10-23,1782,0,1782,178,1960,1960,0,0
39699,2019-10-23,834,-83,751,60,811,811,0,0
39700,2019-10-23,463,0,463,37,500,500,0,0
39701,2019-10-23,632,0,632,50,682,682,0,0
39702,2019-10-23,1122,0,1122,112,1234,1234,0,0
39703,2019-10-23,779,-77,702,56,758,758,0,0
39704,2019-10-23,1603,0,1603,160,1763,1763,0,0
39705,2019-10-23,1697,-169,1528,122,1650,0,1650,0
39706,2019-10-23,723,-72,651,52,703,0,703,0
39707,2019-10-23,2687,0,2687,268,2955,2955,0,0
39708,2019-10-23,325,0,325,26,351,351,0,0
39709,2019-10-23,445,0,445,35,480,480,0,0
39710,2019-10-23,1205,0,1205,120,1325,1325,0,0
39711,2019-10-23,668,0,668,53,721,721,0,0
39712,2019-10-23,159,0,159,12,171,171,0,0
39713,2019-10-23,1512,0,1512,120,1632,1632,0,0
39714,2019-10-23,417,0,417,33,450,450,0,0
39715,2019-10-23,706,0,706,56,762,762,0,0
39716,2019-10-23,557,0,557,44,601,601,0,0
39717,2019-10-23,918,0,918,91,1009,1009,0,0
39718,2019-10-23,983,0,983,78,1061,1061,0,0
39719,2019-10-23,946,0,946,75,1021,1021,0,0
39720,2019-10-23,631,0,631,50,681,681,0,0
39721,2019-10-23,297,0,297,23,320,0,0,320
39722,2019-10-23,743,0,743,59,802,802,0,0
39723,2019-10-23,399,0,399,31,430,430,0,0
39724,2019-10-23,141,0,141,11,152,152,0,0
39725,2019-10-23,1307,0,1307,130,1437,1437,0,0
39726,2019-10-23,891,0,891,89,980,980,0,0
39727,2019-10-23,676,0,676,67,743,743,0,0
39728,2019-10-23,882,0,882,70,952,952,0,0
39729,2019-10-23,399,-39,360,28,388,388,0,0
39730,2019-10-23,891,0,891,89,980,980,0,0
39731,2019-10-23,473,0,473,37,510,510,0,0
39732,2019-10-23,891,0,891,89,980,980,0,0
39733,2019-10-23,911,0,911,72,983,983,0,0
39734,2019-10-23,1546,0,1546,154,1700,1700,0,0
39735,2019-10-23,538,0,538,43,581,581,0,0
39736,2019-10-23,511,0,511,51,562,562,0,0
39737,2019-10-23,334,0,334,26,360,360,0,0
39738,2019-10-23,1167,0,1167,116,1283,1283,0,0
39739,2019-10-23,724,0,724,57,781,781,0,0
39740,2019-10-23,306,0,306,24,330,330,0,0
39741,2019-10-23,548,0,548,43,591,591,0,0
39742,2019-10-23,550,0,550,44,594,0,594,0
39743,2019-10-23,773,0,773,77,850,0,850,0
39744,2019-10-23,465,0,465,37,502,502,0,0
39745,2019-10-23,491,0,491,49,540,540,0,0
39746,2019-10-23,538,0,538,43,581,581,0,0
39747,2019-10-23,1046,0,1046,104,1150,0,1150,0
39748,2019-10-23,1148,0,1148,114,1262,1262,0,0
39749,2019-10-23,773,0,773,77,850,850,0,0
39750,2019-10-23,278,0,278,22,300,300,0,0
39751,2019-10-23,891,0,891,89,980,980,0,0
39752,2019-10-23,1125,0,1125,112,1237,1237,0,0
39753,2019-10-23,773,0,773,77,850,850,0,0
39754,2019-10-23,778,0,778,77,855,855,0,0
39755,2019-10-23,1067,0,1067,85,1152,1152,0,0
39756,2019-10-23,1782,0,1782,178,1960,1960,0,0
39757,2019-10-23,390,0,390,31,421,421,0,0
39758,2019-10-23,1782,0,1782,178,1960,1960,0,0
39759,2019-10-23,510,0,510,40,550,550,0,0
39760,2019-10-23,798,0,798,63,861,861,0,0
39761,2019-10-23,1195,0,1195,119,1314,1314,0,0
39762,2019-10-23,-687,0,-687,-54,-741,-741,0,0
39763,2019-10-23,687,0,687,54,741,741,0,0
39764,2019-10-23,1205,0,1205,96,1301,1301,0,0
39765,2019-10-23,1630,0,1630,163,1793,0,1793,0
39766,2019-10-23,687,0,687,54,741,741,0,0
39767,2019-10-23,464,0,464,37,501,501,0,0
39768,2019-10-23,399,0,399,39,438,438,0,0
39769,2019-10-23,427,0,427,34,461,461,0,0
39770,2019-10-23,861,0,861,86,947,947,0,0
39771,2019-10-23,306,0,306,24,330,330,0,0
39772,2019-10-23,982,0,982,98,1080,0,1080,0
39773,2019-10-23,1403,0,1403,140,1543,1543,0,0
39774,2019-10-23,642,0,642,51,693,693,0,0
39775,2019-10-23,817,0,817,65,882,882,0,0
39776,2019-10-23,2092,0,2092,209,2301,2301,0,0
39777,2019-10-24,149,0,149,11,160,160,0,0
39778,2019-10-24,871,0,871,87,958,958,0,0
39779,2019-10-24,519,0,519,51,570,570,0,0
39780,2019-10-24,1074,0,1074,107,1181,1181,0,0
39781,2019-10-24,167,0,167,13,180,180,0,0
39782,2019-10-24,2217,0,2217,177,2394,2394,0,0
39783,2019-10-24,927,0,927,74,1001,1001,0,0
39784,2019-10-24,511,0,511,40,551,0,551,0
39785,2019-10-24,1391,0,1391,111,1502,1502,0,0
39786,2019-10-24,445,0,445,35,480,480,0,0
39787,2019-10-24,251,0,251,25,276,276,0,0
39788,2019-10-24,817,0,817,81,898,898,0,0
39789,2019-10-24,585,0,585,58,643,0,643,0
39790,2019-10-24,399,-39,360,36,396,396,0,0
39791,2019-10-24,891,0,891,89,980,980,0,0
39792,2019-10-24,733,0,733,73,806,806,0,0
39793,2019-10-24,353,0,353,28,381,381,0,0
39794,2019-10-24,557,0,557,44,601,601,0,0
39795,2019-10-24,1782,0,1782,178,1960,0,0,1960
39796,2019-10-24,297,0,297,29,326,0,326,0
39797,2019-10-24,269,0,269,21,290,290,0,0
39798,2019-10-24,2601,0,2601,260,2861,2861,0,0
39799,2019-10-24,1091,0,1091,109,1200,1200,0,0
39800,2019-10-24,75,0,75,6,81,81,0,0
39801,2019-10-24,835,0,835,66,901,0,0,901
39802,2019-10-24,796,0,796,63,859,859,0,0
39803,2019-10-24,982,0,982,98,1080,1080,0,0
39804,2019-10-24,390,0,390,31,421,0,421,0
39805,2019-10-24,982,0,982,78,1060,1060,0,0
39806,2019-10-24,456,0,456,36,492,492,0,0
39807,2019-10-24,1256,0,1256,125,1381,1381,0,0
39808,2019-10-24,538,0,538,43,581,581,0,0
39809,2019-10-24,1744,0,1744,174,1918,1918,0,0
39810,2019-10-24,250,0,250,25,275,275,0,0
39811,2019-10-24,955,0,955,95,1050,1050,0,0
39812,2019-10-24,1056,0,1056,105,1161,1161,0,0
39813,2019-10-24,891,0,891,89,980,980,0,0
39814,2019-10-24,1076,0,1076,86,1162,0,0,1162
39815,2019-10-24,566,0,566,45,611,611,0,0
39816,2019-10-24,195,0,195,19,214,214,0,0
39817,2019-10-24,808,-80,728,58,786,786,0,0
39818,2019-10-24,315,0,315,31,346,346,0,0
39819,2019-10-24,740,0,740,74,814,814,0,0
39820,2019-10-24,1427,0,1427,142,1569,1569,0,0
39821,2019-10-24,417,0,417,33,450,450,0,0
39822,2019-10-24,334,0,334,33,367,367,0,0
39823,2019-10-24,1343,0,1343,134,1477,1477,0,0
39824,2019-10-24,668,0,668,53,721,721,0,0
39825,2019-10-24,798,0,798,63,861,861,0,0
39826,2019-10-24,409,0,409,32,441,441,0,0
39827,2019-10-24,631,0,631,50,681,681,0,0
39828,2019-10-24,362,0,362,28,390,390,0,0
39829,2019-10-24,204,0,204,20,224,224,0,0
39830,2019-10-24,204,0,204,16,220,220,0,0
39831,2019-10-24,288,0,288,28,316,316,0,0
39832,2019-10-24,528,0,528,52,580,580,0,0
39833,2019-10-24,464,0,464,37,501,501,0,0
39834,2019-10-24,408,0,408,32,440,440,0,0
39835,2019-10-24,779,0,779,62,841,841,0,0
39836,2019-10-24,902,0,902,72,974,0,974,0
39837,2019-10-24,500,0,500,40,540,540,0,0
39838,2019-10-24,761,0,761,60,821,821,0,0
39839,2019-10-24,417,0,417,33,450,450,0,0
39840,2019-10-24,856,0,856,68,924,0,924,0
39841,2019-10-24,362,0,362,28,390,390,0,0
39842,2019-10-24,251,0,251,20,271,271,0,0
39843,2019-10-24,195,0,195,15,210,210,0,0
39844,2019-10-24,1664,0,1664,166,1830,1830,0,0
39845,2019-10-24,740,0,740,74,814,814,0,0
39846,2019-10-24,318,0,318,25,343,343,0,0
39847,2019-10-24,437,0,437,34,471,471,0,0
39848,2019-10-24,1076,0,1076,86,1162,1162,0,0
39849,2019-10-24,669,0,669,53,722,722,0,0
39850,2019-10-24,269,0,269,21,290,290,0,0
39851,2019-10-24,428,0,428,34,462,462,0,0
39852,2019-10-24,773,0,773,77,850,850,0,0
39853,2019-10-24,139,0,139,11,150,150,0,0
39854,2019-10-24,778,0,778,77,855,855,0,0
39855,2019-10-24,1162,0,1162,116,1278,1278,0,0
39856,2019-10-24,773,0,773,77,850,850,0,0
39857,2019-10-24,773,0,773,77,850,850,0,0
39858,2019-10-24,807,0,807,64,871,871,0,0
39859,2019-10-24,650,0,650,52,702,0,702,0
39860,2019-10-24,658,0,658,52,710,710,0,0
39861,2019-10-24,102,0,102,8,110,0,0,110
39862,2019-10-24,1546,0,1546,154,1700,1700,0,0
39863,2019-10-24,-102,0,-102,-8,-110,0,0,-110
39864,2019-10-24,390,0,390,31,421,421,0,0
39865,2019-10-24,538,0,538,43,581,581,0,0
39866,2019-10-24,1334,0,1334,133,1467,1467,0,0
39867,2019-10-24,773,0,773,77,850,0,850,0
39868,2019-10-24,863,0,863,69,932,932,0,0
39869,2019-10-24,1265,0,1265,126,1391,1391,0,0
39870,2019-10-24,1810,0,1810,181,1991,1991,0,0
39871,2019-10-25,214,0,214,21,235,235,0,0
39872,2019-10-25,911,0,911,72,983,0,983,0
39873,2019-10-25,872,0,872,69,941,941,0,0
39874,2019-10-25,1131,0,1131,113,1244,1244,0,0
39875,2019-10-25,325,0,325,26,351,0,0,351
39876,2019-10-25,1782,0,1782,178,1960,0,1960,0
39877,2019-10-25,1114,0,1114,89,1203,1203,0,0
39878,2019-10-25,557,0,557,44,601,601,0,0
39879,2019-10-25,232,0,232,18,250,250,0,0
39880,2019-10-25,232,0,232,18,250,250,0,0
39881,2019-10-25,1224,0,1224,97,1321,0,0,1321
39882,2019-10-25,484,0,484,38,522,0,0,522
39883,2019-10-25,882,0,882,70,952,952,0,0
39884,2019-10-25,548,0,548,43,591,591,0,0
39885,2019-10-25,604,0,604,48,652,652,0,0
39886,2019-10-25,446,0,446,44,490,490,0,0
39887,2019-10-25,446,0,446,35,481,481,0,0
39888,2019-10-25,1383,0,1383,110,1493,0,1493,0
39889,2019-10-25,687,0,687,54,741,741,0,0
39890,2019-10-25,1782,0,1782,178,1960,1960,0,0
39891,2019-10-25,1104,0,1104,88,1192,1192,0,0
39892,2019-10-25,576,0,576,46,622,622,0,0
39893,2019-10-25,732,0,732,73,805,805,0,0
39894,2019-10-25,834,0,834,83,917,917,0,0
39895,2019-10-25,334,0,334,26,360,360,0,0
39896,2019-10-25,788,0,788,63,851,851,0,0
39897,2019-10-25,1141,0,1141,91,1232,1232,0,0
39898,2019-10-25,343,0,343,27,370,370,0,0
39899,2019-10-25,715,0,715,57,772,772,0,0
39900,2019-10-25,510,0,510,40,550,550,0,0
39901,2019-10-25,659,0,659,52,711,711,0,0
39902,2019-10-25,438,0,438,35,473,473,0,0
39903,2019-10-25,761,0,761,60,821,821,0,0
39904,2019-10-25,121,0,121,9,130,130,0,0
39905,2019-10-25,742,0,742,74,816,816,0,0
39906,2019-10-25,223,0,223,17,240,240,0,0
39907,2019-10-25,891,0,891,89,980,980,0,0
39908,2019-10-25,1782,0,1782,178,1960,0,0,1960
39909,2019-10-25,269,0,269,21,290,290,0,0
39910,2019-10-25,585,0,585,46,631,631,0,0
39911,2019-10-25,1244,0,1244,99,1343,1343,0,0
39912,2019-10-25,628,0,628,62,690,690,0,0
39913,2019-10-25,1288,0,1288,103,1391,1391,0,0
39914,2019-10-25,998,0,998,99,1097,1097,0,0
39915,2019-10-25,998,0,998,99,1097,1097,0,0
39916,2019-10-25,871,0,871,87,958,958,0,0
39917,2019-10-25,916,0,916,91,1007,1007,0,0
39918,2019-10-25,1066,0,1066,106,1172,1172,0,0
39919,2019-10-25,936,0,936,93,1029,1029,0,0
39920,2019-10-25,752,0,752,75,827,827,0,0
39921,2019-10-25,797,0,797,79,876,876,0,0
39922,2019-10-25,1021,0,1021,81,1102,1102,0,0
39923,2019-10-25,1078,0,1078,86,1164,1164,0,0
39924,2019-10-25,223,0,223,17,240,240,0,0
39925,2019-10-25,251,0,251,20,271,271,0,0
39926,2019-10-25,3564,0,3564,356,3920,3920,0,0
39927,2019-10-25,650,0,650,52,702,702,0,0
39928,2019-10-25,982,0,982,98,1080,0,0,1080
39929,2019-10-25,569,0,569,45,614,0,0,614
39930,2019-10-25,946,0,946,75,1021,1021,0,0
39931,2019-10-25,1920,0,1920,153,2073,2073,0,0
39932,2019-10-25,678,0,678,54,732,732,0,0
39933,2019-10-25,437,0,437,34,471,471,0,0
39934,2019-10-25,628,0,628,62,690,690,0,0
39935,2019-10-25,640,0,640,51,691,691,0,0
39936,2019-10-25,714,0,714,71,785,785,0,0
39937,2019-10-25,891,-89,802,80,882,882,0,0
39938,2019-10-25,1256,0,1256,125,1381,1381,0,0
39939,2019-10-25,705,0,705,56,761,761,0,0
39940,2019-10-25,382,0,382,38,420,420,0,0
39941,2019-10-25,510,0,510,40,550,0,0,550
39942,2019-10-25,1782,0,1782,178,1960,1960,0,0
39943,2019-10-25,408,0,408,32,440,0,0,440
39944,2019-10-25,628,0,628,62,690,690,0,0
39945,2019-10-25,668,0,668,53,721,721,0,0
39946,2019-10-25,278,0,278,22,300,300,0,0
39947,2019-10-25,1745,0,1745,139,1884,1884,0,0
39948,2019-10-25,890,0,890,71,961,0,0,961
39949,2019-10-25,826,0,826,66,892,892,0,0
39950,2019-10-25,223,0,223,17,240,240,0,0
39951,2019-10-25,1824,0,1824,182,2006,2006,0,0
39952,2019-10-25,167,0,167,13,180,180,0,0
39953,2019-10-25,659,0,659,52,711,711,0,0
39954,2019-10-25,649,0,649,51,700,700,0,0
39955,2019-10-25,788,0,788,78,866,0,0,866
39956,2019-10-25,2319,0,2319,231,2550,2550,0,0
39957,2019-10-25,389,0,389,38,427,427,0,0
39958,2019-10-25,621,0,621,62,683,0,683,0
39959,2019-10-25,242,0,242,19,261,261,0,0
39960,2019-10-25,428,0,428,34,462,0,462,0
39961,2019-10-25,844,0,844,84,928,928,0,0
39962,2019-10-25,1438,-1000,438,35,473,473,0,0
39963,2019-10-25,408,0,408,32,440,440,0,0
39964,2019-10-25,167,0,167,13,180,180,0,0
39965,2019-10-25,1188,0,1188,95,1283,1283,0,0
39966,2019-10-25,408,0,408,32,440,440,0,0
39967,2019-10-25,1160,0,1160,116,1276,1276,0,0
39968,2019-10-25,112,0,112,11,123,123,0,0
39969,2019-10-25,141,0,141,11,152,152,0,0
39970,2019-10-25,607,0,607,48,655,655,0,0
39971,2019-10-25,1094,0,1094,87,1181,0,1181,0
39972,2019-10-25,409,0,409,32,441,0,0,441
39973,2019-10-25,503,-50,453,36,489,489,0,0
39974,2019-10-25,909,0,909,72,981,0,981,0
39975,2019-10-25,334,0,334,26,360,0,0,360
39976,2019-10-25,1047,0,1047,104,1151,0,0,1151
39977,2019-10-25,973,0,973,97,1070,1070,0,0
39978,2019-10-25,2860,0,2860,228,3088,3088,0,0
39979,2019-10-25,370,0,370,37,407,407,0,0
39980,2019-10-25,446,0,446,35,481,481,0,0
39981,2019-10-25,362,0,362,28,390,390,0,0
39982,2019-10-25,300,0,300,24,324,324,0,0
39983,2019-10-25,-362,0,-362,-28,-390,-390,0,0
39984,2019-10-25,334,0,334,26,360,360,0,0
39985,2019-10-25,167,0,167,13,180,180,0,0
39986,2019-10-25,1010,0,1010,101,1111,1111,0,0
39987,2019-10-25,464,0,464,37,501,501,0,0
39988,2019-10-25,260,0,260,20,280,0,280,0
39989,2019-10-25,704,0,704,70,774,774,0,0
39990,2019-10-25,676,0,676,67,743,743,0,0
39991,2019-10-25,1208,0,1208,96,1304,1304,0,0
39992,2019-10-25,1541,0,1541,123,1664,1664,0,0
39993,2019-10-25,519,0,519,51,570,570,0,0
39994,2019-10-25,825,0,825,82,907,907,0,0
39995,2019-10-25,371,0,371,29,400,400,0,0
39996,2019-10-25,1411,0,1411,141,1552,1552,0,0
39997,2019-10-25,370,0,370,37,407,0,407,0
39998,2019-10-25,593,0,593,47,640,640,0,0
39999,2019-10-25,167,0,167,13,180,180,0,0
40000,2019-10-25,1242,0,1242,99,1341,1341,0,0
40001,2019-10-25,445,0,445,35,480,480,0,0
40002,2019-10-25,1000,0,1000,100,1100,1100,0,0
40003,2019-10-25,232,0,232,18,250,250,0,0
40004,2019-10-25,649,0,649,51,700,700,0,0
40005,2019-10-25,1319,0,1319,131,1450,0,1450,0
40006,2019-10-25,1546,0,1546,154,1700,1700,0,0
40007,2019-10-25,1546,0,1546,154,1700,0,0,1700
40008,2019-10-25,520,0,520,41,561,0,561,0
40009,2019-10-25,1231,0,1231,123,1354,1354,0,0
40010,2019-10-25,1242,-124,1118,89,1207,1207,0,0
40011,2019-10-25,167,0,167,13,180,180,0,0
40012,2019-10-25,1546,0,1546,154,1700,0,0,1700
40013,2019-10-25,1546,0,1546,154,1700,1700,0,0
40014,2019-10-25,484,0,484,38,522,522,0,0
40015,2019-10-25,428,0,428,34,462,462,0,0
40016,2019-10-25,482,0,482,38,520,520,0,0
40017,2019-10-25,1333,0,1333,133,1466,1466,0,0
40018,2019-10-25,362,0,362,28,390,390,0,0
40019,2019-10-25,370,0,370,37,407,407,0,0
40020,2019-10-25,176,0,176,17,193,193,0,0
40021,2019-10-25,966,0,966,77,1043,1043,0,0
40022,2019-10-25,473,0,473,37,510,510,0,0
40023,2019-10-25,659,0,659,52,711,711,0,0
40024,2019-10-25,2319,0,2319,231,2550,2550,0,0
40025,2019-10-25,705,0,705,56,761,0,761,0
40026,2019-10-25,916,0,916,91,1007,1007,0,0
40027,2019-10-25,195,0,195,15,210,210,0,0
40028,2019-10-25,1546,0,1546,154,1700,1700,0,0
40029,2019-10-25,593,0,593,47,640,0,0,640
40030,2019-10-25,773,0,773,77,850,850,0,0
40031,2019-10-25,273,0,273,27,300,300,0,0
40032,2019-10-25,1464,0,1464,146,1610,1610,0,0
40033,2019-10-25,773,0,773,77,850,850,0,0
40034,2019-10-25,1347,0,1347,134,1481,1481,0,0
40035,2019-10-25,306,0,306,24,330,330,0,0
40036,2019-10-25,585,0,585,46,631,631,0,0
40037,2019-10-25,566,0,566,45,611,611,0,0
40038,2019-10-25,1039,0,1039,83,1122,1122,0,0
40039,2019-10-25,1009,0,1009,100,1109,1109,0,0
40040,2019-10-25,1260,0,1260,126,1386,1386,0,0
40041,2019-10-25,773,0,773,77,850,850,0,0
40042,2019-10-26,464,0,464,37,501,0,501,0
40043,2019-10-26,891,0,891,89,980,980,0,0
40044,2019-10-26,891,0,891,89,980,980,0,0
40045,2019-10-26,47,0,47,4,51,51,0,0
40046,2019-10-26,1179,0,1179,94,1273,1273,0,0
40047,2019-10-26,722,0,722,72,794,794,0,0
40048,2019-10-26,1546,0,1546,154,1700,1700,0,0
40049,2019-10-26,1447,0,1447,115,1562,1562,0,0
40050,2019-10-26,1448,0,1448,115,1563,1563,0,0
40051,2019-10-26,348,0,348,27,375,375,0,0
40052,2019-10-26,946,0,946,75,1021,1021,0,0
40053,2019-10-26,483,0,483,38,521,521,0,0
40054,2019-10-26,1354,0,1354,108,1462,1462,0,0
40055,2019-10-26,844,0,844,67,911,911,0,0
40056,2019-10-26,450,0,450,36,486,486,0,0
40057,2019-10-26,418,0,418,33,451,0,451,0
40058,2019-10-26,983,0,983,78,1061,1061,0,0
40059,2019-10-26,306,0,306,24,330,330,0,0
40060,2019-10-26,1157,0,1157,115,1272,1272,0,0
40061,2019-10-26,1631,0,1631,130,1761,1761,0,0
40062,2019-10-26,2459,0,2459,245,2704,0,2704,0
40063,2019-10-26,1048,0,1048,83,1131,1131,0,0
40064,2019-10-26,232,0,232,18,250,250,0,0
40065,2019-10-26,3051,0,3051,305,3356,3356,0,0
40066,2019-10-26,1207,0,1207,96,1303,0,0,1303
40067,2019-10-26,1429,0,1429,114,1543,1543,0,0
40068,2019-10-26,874,0,874,69,943,943,0,0
40069,2019-10-26,1782,0,1782,178,1960,1960,0,0
40070,2019-10-26,260,0,260,20,280,280,0,0
40071,2019-10-26,945,0,945,94,1039,1039,0,0
40072,2019-10-26,418,0,418,41,459,459,0,0
40073,2019-10-26,1546,0,1546,154,1700,1700,0,0
40074,2019-10-26,1546,0,1546,154,1700,0,1700,0
40075,2019-10-26,390,0,390,31,421,421,0,0
40076,2019-10-26,1253,0,1253,100,1353,1353,0,0
40077,2019-10-26,817,0,817,65,882,882,0,0
40078,2019-10-26,546,0,546,54,600,600,0,0
40079,2019-10-26,1078,0,1078,86,1164,1164,0,0
40080,2019-10-26,705,0,705,56,761,0,761,0
40081,2019-10-26,1119,0,1119,111,1230,1230,0,0
40082,2019-10-26,1546,0,1546,154,1700,1700,0,0
40083,2019-10-26,1165,0,1165,116,1281,1281,0,0
40084,2019-10-26,139,0,139,11,150,150,0,0
40085,2019-10-26,926,0,926,92,1018,1018,0,0
40086,2019-10-26,408,0,408,32,440,0,440,0
40087,2019-10-26,816,0,816,65,881,881,0,0
40088,2019-10-26,186,0,186,14,200,200,0,0
40089,2019-10-26,1187,0,1187,94,1281,1281,0,0
40090,2019-10-26,826,0,826,66,892,0,892,0
40091,2019-10-26,1049,0,1049,83,1132,0,1132,0
40092,2019-10-26,1075,0,1075,107,1182,1182,0,0
40093,2019-10-26,1410,-141,1269,126,1395,1395,0,0
40094,2019-10-26,2673,0,2673,267,2940,2940,0,0
40095,2019-10-26,520,0,520,41,561,561,0,0
40096,2019-10-26,-1058,1000,-58,-4,-62,-62,0,0
40097,2019-10-26,316,0,316,25,341,341,0,0
40098,2019-10-26,743,0,743,59,802,802,0,0
40099,2019-10-26,891,-500,391,39,430,430,0,0
40100,2019-10-26,1375,0,1375,137,1512,1512,0,0
40101,2019-10-26,306,0,306,24,330,330,0,0
40102,2019-10-26,891,0,891,89,980,980,0,0
40103,2019-10-26,491,0,491,49,540,540,0,0
40104,2019-10-26,2673,0,2673,267,2940,2940,0,0
40105,2019-10-26,465,0,465,37,502,502,0,0
40106,2019-10-26,1271,0,1271,127,1398,1398,0,0
40107,2019-10-26,586,0,586,46,632,0,632,0
40108,2019-10-26,740,0,740,74,814,814,0,0
40109,2019-10-26,1782,0,1782,178,1960,1960,0,0
40110,2019-10-26,112,0,112,8,120,120,0,0
40111,2019-10-26,251,0,251,20,271,271,0,0
40112,2019-10-26,696,-69,627,50,677,0,677,0
40113,2019-10-26,475,0,475,38,513,513,0,0
40114,2019-10-26,1252,0,1252,100,1352,0,1352,0
40115,2019-10-26,1278,0,1278,127,1405,1405,0,0
40116,2019-10-26,546,0,546,54,600,600,0,0
40117,2019-10-26,715,0,715,57,772,0,772,0
40118,2019-10-26,1676,0,1676,167,1843,0,1843,0
40119,2019-10-26,1058,-1000,58,5,63,63,0,0
40120,2019-10-26,1058,-1000,58,4,62,62,0,0
40121,2019-10-26,815,0,815,81,896,896,0,0
40122,2019-10-26,566,0,566,45,611,611,0,0
40123,2019-10-26,937,0,937,74,1011,1011,0,0
40124,2019-10-26,1493,0,1493,149,1642,1642,0,0
40125,2019-10-26,1625,0,1625,130,1755,1755,0,0
40126,2019-10-26,371,0,371,29,400,400,0,0
40127,2019-10-26,417,0,417,33,450,450,0,0
40128,2019-10-26,1383,-1383,0,0,0,0,0,0
40129,2019-10-26,593,0,593,47,640,0,0,640
40130,2019-10-26,427,0,427,34,461,461,0,0
40131,2019-10-26,371,0,371,29,400,400,0,0
40132,2019-10-26,678,0,678,54,732,732,0,0
40133,2019-10-26,891,0,891,89,980,980,0,0
40134,2019-10-26,1864,0,1864,186,2050,2050,0,0
40135,2019-10-26,836,0,836,83,919,0,0,919
40136,2019-10-26,306,0,306,24,330,0,330,0
40137,2019-10-26,1065,0,1065,106,1171,1171,0,0
40138,2019-10-26,797,0,797,79,876,876,0,0
40139,2019-10-26,260,0,260,20,280,280,0,0
40140,2019-10-26,1017,0,1017,101,1118,0,0,1118
40141,2019-10-26,1836,0,1836,183,2019,2019,0,0
40142,2019-10-26,584,0,584,46,630,630,0,0
40143,2019-10-26,1724,0,1724,172,1896,0,1896,0
40144,2019-10-26,3051,-610,2441,244,2685,2685,0,0
40145,2019-10-26,622,0,622,49,671,671,0,0
40146,2019-10-26,837,0,837,66,903,903,0,0
40147,2019-10-26,1671,0,1671,133,1804,1804,0,0
40148,2019-10-26,1546,0,1546,154,1700,1700,0,0
40149,2019-10-26,232,0,232,18,250,250,0,0
40150,2019-10-26,567,0,567,45,612,612,0,0
40151,2019-10-26,47,0,47,3,50,0,0,50
40152,2019-10-26,370,0,370,37,407,407,0,0
40153,2019-10-26,687,0,687,54,741,741,0,0
40154,2019-10-26,389,0,389,38,427,427,0,0
40155,2019-10-26,853,0,853,85,938,938,0,0
40156,2019-10-26,492,0,492,39,531,531,0,0
40157,2019-10-26,260,0,260,20,280,280,0,0
40158,2019-10-26,501,0,501,50,551,0,0,551
40159,2019-10-26,548,0,548,43,591,591,0,0
40160,2019-10-26,1056,0,1056,105,1161,1161,0,0
40161,2019-10-26,1288,0,1288,128,1416,1416,0,0
40162,2019-10-26,778,0,778,62,840,840,0,0
40163,2019-10-26,279,0,279,22,301,301,0,0
40164,2019-10-26,370,0,370,29,399,399,0,0
40165,2019-10-26,825,0,825,66,891,891,0,0
40166,2019-10-26,1298,0,1298,103,1401,0,1401,0
40167,2019-10-26,937,0,937,74,1011,1011,0,0
40168,2019-10-26,232,0,232,18,250,250,0,0
40169,2019-10-26,993,0,993,79,1072,0,1072,0
40170,2019-10-26,327,0,327,26,353,0,353,0
40171,2019-10-26,306,-61,245,19,264,264,0,0
40172,2019-10-26,893,0,893,71,964,964,0,0
40173,2019-10-26,389,0,389,38,427,427,0,0
40174,2019-10-26,565,0,565,56,621,0,0,621
40175,2019-10-26,679,0,679,54,733,733,0,0
40176,2019-10-26,650,0,650,52,702,0,0,702
40177,2019-10-26,501,0,501,40,541,541,0,0
40178,2019-10-26,1814,0,1814,181,1995,1995,0,0
40179,2019-10-26,474,0,474,37,511,511,0,0
40180,2019-10-26,260,0,260,20,280,280,0,0
40181,2019-10-26,891,0,891,89,980,980,0,0
40182,2019-10-26,167,0,167,13,180,180,0,0
40183,2019-10-26,668,0,668,53,721,0,721,0
40184,2019-10-26,260,-26,234,18,252,252,0,0
40185,2019-10-26,2673,0,2673,267,2940,2940,0,0
40186,2019-10-26,530,0,530,42,572,572,0,0
40187,2019-10-26,363,0,363,29,392,392,0,0
40188,2019-10-26,456,0,456,36,492,492,0,0
40189,2019-10-26,1306,0,1306,130,1436,0,1436,0
40190,2019-10-26,567,-56,511,40,551,551,0,0
40191,2019-10-26,260,0,260,20,280,280,0,0
40192,2019-10-26,306,0,306,24,330,330,0,0
40193,2019-10-26,1038,0,1038,103,1141,1141,0,0
40194,2019-10-26,612,0,612,48,660,660,0,0
40195,2019-10-26,806,0,806,64,870,870,0,0
40196,2019-10-26,410,0,410,32,442,442,0,0
40197,2019-10-26,673,0,673,53,726,726,0,0
40198,2019-10-26,930,0,930,74,1004,0,1004,0
40199,2019-10-26,446,0,446,35,481,481,0,0
40200,2019-10-26,501,0,501,40,541,541,0,0
40201,2019-10-26,457,0,457,36,493,493,0,0
40202,2019-10-26,417,0,417,33,450,450,0,0
40203,2019-10-26,566,0,566,45,611,611,0,0
40204,2019-10-26,167,0,167,16,183,183,0,0
40205,2019-10-26,473,0,473,37,510,0,510,0
40206,2019-10-26,1150,0,1150,92,1242,0,1242,0
40207,2019-10-26,343,0,343,27,370,370,0,0
40208,2019-10-26,251,0,251,20,271,271,0,0
40209,2019-10-26,1577,0,1577,126,1703,1703,0,0
40210,2019-10-26,1172,0,1172,117,1289,1289,0,0
40211,2019-10-26,1546,0,1546,154,1700,0,1700,0
40212,2019-10-26,743,0,743,59,802,802,0,0
40213,2019-10-26,334,0,334,26,360,360,0,0
40214,2019-10-26,279,0,279,22,301,301,0,0
40215,2019-10-26,640,0,640,51,691,691,0,0
40216,2019-10-26,1579,0,1579,157,1736,1736,0,0
40217,2019-10-26,1477,0,1477,147,1624,1624,0,0
40218,2019-10-26,658,0,658,65,723,0,723,0
40219,2019-10-26,649,0,649,64,713,713,0,0
40220,2019-10-26,446,0,446,44,490,0,490,0
40221,2019-10-26,181,0,181,14,195,195,0,0
40222,2019-10-26,390,0,390,31,421,421,0,0
40223,2019-10-26,628,0,628,62,690,690,0,0
40224,2019-10-26,1546,0,1546,154,1700,1700,0,0
40225,2019-10-26,707,0,707,56,763,0,763,0
40226,2019-10-26,974,0,974,77,1051,1051,0,0
40227,2019-10-26,242,0,242,19,261,0,0,261
40228,2019-10-26,501,0,501,40,541,541,0,0
40229,2019-10-26,585,0,585,46,631,0,631,0
40230,2019-10-26,2319,0,2319,231,2550,2550,0,0
40231,2019-10-26,715,0,715,57,772,0,772,0
40232,2019-10-26,520,0,520,41,561,561,0,0
40233,2019-10-26,623,0,623,49,672,0,672,0
40234,2019-10-26,306,0,306,24,330,330,0,0
40235,2019-10-26,362,-36,326,26,352,352,0,0
40236,2019-10-26,269,-26,243,19,262,262,0,0
40237,2019-10-26,436,0,436,34,470,470,0,0
40238,2019-10-26,1546,0,1546,154,1700,1700,0,0
40239,2019-10-26,1546,0,1546,154,1700,1700,0,0
40240,2019-10-26,1176,0,1176,117,1293,1293,0,0
40241,2019-10-26,112,0,112,11,123,123,0,0
40242,2019-10-26,1401,0,1401,140,1541,1541,0,0
40243,2019-10-26,883,0,883,70,953,0,953,0
40244,2019-10-26,389,0,389,38,427,427,0,0
40245,2019-10-26,644,0,644,51,695,695,0,0
40246,2019-10-26,1546,0,1546,154,1700,1700,0,0
40247,2019-10-26,1546,0,1546,154,1700,1700,0,0
40248,2019-10-26,863,0,863,69,932,932,0,0
40249,2019-10-26,1796,0,1796,179,1975,1975,0,0
40250,2019-10-26,273,0,273,27,300,300,0,0
40251,2019-10-26,2319,0,2319,231,2550,2550,0,0
40252,2019-10-26,2092,0,2092,209,2301,0,2301,0
40253,2019-10-26,773,0,773,77,850,850,0,0
40254,2019-10-26,1546,0,1546,154,1700,1700,0,0
40255,2019-10-26,2187,0,2187,218,2405,2405,0,0
40256,2019-10-26,773,0,773,77,850,0,850,0
40257,2019-10-26,650,0,650,52,702,702,0,0
40258,2019-10-27,455,0,455,36,491,491,0,0
40259,2019-10-27,483,0,483,38,521,521,0,0
40260,2019-10-27,445,0,445,35,480,480,0,0
40261,2019-10-27,149,0,149,11,160,160,0,0
40262,2019-10-27,2673,0,2673,267,2940,2940,0,0
40263,2019-10-27,1458,0,1458,116,1574,0,1574,0
40264,2019-10-27,704,0,704,70,774,774,0,0
40265,2019-10-27,353,-35,318,25,343,343,0,0
40266,2019-10-27,567,0,567,45,612,0,0,612
40267,2019-10-27,167,0,167,13,180,180,0,0
40268,2019-10-27,501,0,501,40,541,0,541,0
40269,2019-10-27,482,0,482,38,520,0,520,0
40270,2019-10-27,1139,0,1139,113,1252,1252,0,0
40271,2019-10-27,1321,0,1321,105,1426,0,0,1426
40272,2019-10-27,2102,0,2102,168,2270,0,0,2270
40273,2019-10-27,1222,0,1222,122,1344,1344,0,0
40274,2019-10-27,789,0,789,63,852,852,0,0
40275,2019-10-27,1782,0,1782,178,1960,1960,0,0
40276,2019-10-27,548,0,548,43,591,591,0,0
40277,2019-10-27,938,0,938,75,1013,1013,0,0
40278,2019-10-27,455,0,455,36,491,491,0,0
40279,2019-10-27,558,0,558,44,602,602,0,0
40280,2019-10-27,956,0,956,76,1032,1032,0,0
40281,2019-10-27,2482,0,2482,248,2730,2730,0,0
40282,2019-10-27,773,0,773,77,850,850,0,0
40283,2019-10-27,891,0,891,89,980,980,0,0
40284,2019-10-27,891,0,891,89,980,980,0,0
40285,2019-10-27,464,0,464,37,501,501,0,0
40286,2019-10-27,732,0,732,73,805,805,0,0
40287,2019-10-27,446,0,446,35,481,481,0,0
40288,2019-10-27,1782,0,1782,178,1960,1960,0,0
40289,2019-10-27,510,0,510,40,550,550,0,0
40290,2019-10-27,2270,0,2270,227,2497,2497,0,0
40291,2019-10-27,1143,0,1143,91,1234,1234,0,0
40292,2019-10-27,298,0,298,23,321,0,0,321
40293,2019-10-27,9801,0,9801,980,10781,10781,0,0
40294,2019-10-27,916,0,916,91,1007,0,1007,0
40295,2019-10-27,863,0,863,69,932,932,0,0
40296,2019-10-27,909,0,909,72,981,981,0,0
40297,2019-10-27,631,0,631,50,681,681,0,0
40298,2019-10-27,892,0,892,71,963,963,0,0
40299,2019-10-27,297,0,297,23,320,320,0,0
40300,2019-10-27,370,0,370,37,407,407,0,0
40301,2019-10-27,714,0,714,57,771,771,0,0
40302,2019-10-27,538,0,538,43,581,0,0,581
40303,2019-10-27,389,0,389,38,427,427,0,0
40304,2019-10-27,733,0,733,58,791,791,0,0
40305,2019-10-27,667,0,667,53,720,720,0,0
40306,2019-10-27,364,0,364,29,393,393,0,0
40307,2019-10-27,651,0,651,52,703,703,0,0
40308,2019-10-27,472,0,472,47,519,519,0,0
40309,2019-10-27,464,0,464,37,501,501,0,0
40310,2019-10-27,1465,0,1465,146,1611,1611,0,0
40311,2019-10-27,640,0,640,51,691,691,0,0
40312,2019-10-27,325,-32,293,23,316,316,0,0
40313,2019-10-27,317,0,317,25,342,342,0,0
40314,2019-10-27,370,0,370,37,407,407,0,0
40315,2019-10-27,621,0,621,49,670,0,670,0
40316,2019-10-27,567,0,567,56,623,0,623,0
40317,2019-10-27,336,0,336,26,362,0,362,0
40318,2019-10-27,401,0,401,32,433,433,0,0
40319,2019-10-27,686,0,686,54,740,740,0,0
40320,2019-10-27,725,0,725,58,783,783,0,0
40321,2019-10-27,605,0,605,48,653,653,0,0
40322,2019-10-27,474,0,474,37,511,511,0,0
40323,2019-10-27,214,0,214,17,231,0,231,0
40324,2019-10-27,1898,0,1898,189,2087,2087,0,0
40325,2019-10-27,594,0,594,47,641,0,0,641
40326,2019-10-27,660,0,660,52,712,712,0,0
40327,2019-10-27,613,0,613,49,662,662,0,0
40328,2019-10-27,186,0,186,18,204,204,0,0
40329,2019-10-27,288,0,288,23,311,311,0,0
40330,2019-10-27,288,0,288,23,311,311,0,0
40331,2019-10-27,2390,0,2390,239,2629,2629,0,0
40332,2019-10-27,473,0,473,37,510,510,0,0
40333,2019-10-27,353,0,353,28,381,381,0,0
40334,2019-10-27,1150,0,1150,92,1242,1242,0,0
40335,2019-10-27,483,0,483,38,521,521,0,0
40336,2019-10-27,620,0,620,62,682,682,0,0
40337,2019-10-27,947,0,947,75,1022,1022,0,0
40338,2019-10-27,316,0,316,25,341,0,341,0
40339,2019-10-27,817,0,817,65,882,882,0,0
40340,2019-10-27,654,0,654,52,706,706,0,0
40341,2019-10-27,846,-84,762,60,822,822,0,0
40342,2019-10-27,214,0,214,17,231,231,0,0
40343,2019-10-27,966,0,966,77,1043,1043,0,0
40344,2019-10-27,167,0,167,13,180,0,0,180
40345,2019-10-27,640,0,640,64,704,704,0,0
40346,2019-10-27,873,0,873,69,942,942,0,0
40347,2019-10-27,260,0,260,20,280,280,0,0
40348,2019-10-27,325,0,325,26,351,351,0,0
40349,2019-10-27,418,0,418,33,451,451,0,0
40350,2019-10-27,204,0,204,16,220,220,0,0
40351,2019-10-27,491,0,491,49,540,540,0,0
40352,2019-10-27,352,0,352,35,387,387,0,0
40353,2019-10-27,1167,0,1167,116,1283,0,0,1283
40354,2019-10-27,334,0,334,26,360,360,0,0
40355,2019-10-27,1690,0,1690,135,1825,1825,0,0
40356,2019-10-27,224,0,224,22,246,0,0,246
40357,2019-10-27,519,0,519,51,570,570,0,0
40358,2019-10-27,501,0,501,50,551,551,0,0
40359,2019-10-27,237,0,237,18,255,255,0,0
40360,2019-10-27,279,-27,252,20,272,0,0,272
40361,2019-10-27,546,0,546,54,600,600,0,0
40362,2019-10-27,595,0,595,47,642,642,0,0
40363,2019-10-27,493,0,493,39,532,532,0,0
40364,2019-10-27,1546,-154,1392,139,1531,1531,0,0
40365,2019-10-27,2534,0,2534,202,2736,2736,0,0
40366,2019-10-27,455,0,455,36,491,491,0,0
40367,2019-10-27,519,0,519,51,570,570,0,0
40368,2019-10-27,354,0,354,28,382,382,0,0
40369,2019-10-27,788,0,788,78,866,0,0,866
40370,2019-10-27,1676,-167,1509,150,1659,1659,0,0
40371,2019-10-27,-1676,0,-1676,-167,-1843,0,-1843,0
40372,2019-10-27,1140,0,1140,114,1254,1254,0,0
40373,2019-10-27,250,0,250,20,270,270,0,0
40374,2019-10-27,1068,0,1068,85,1153,1153,0,0
40375,2019-10-27,380,0,380,30,410,410,0,0
40376,2019-10-27,334,0,334,26,360,360,0,0
40377,2019-10-27,630,0,630,63,693,693,0,0
40378,2019-10-27,298,0,298,23,321,321,0,0
40379,2019-10-27,1279,0,1279,127,1406,1406,0,0
40380,2019-10-27,1253,0,1253,100,1353,0,1353,0
40381,2019-10-27,1002,0,1002,80,1082,0,1082,0
40382,2019-10-27,1650,0,1650,132,1782,0,1782,0
40383,2019-10-27,566,0,566,45,611,611,0,0
40384,2019-10-27,603,0,603,48,651,651,0,0
40385,2019-10-27,818,0,818,65,883,883,0,0
40386,2019-10-27,919,0,919,73,992,0,0,992
40387,2019-10-27,705,0,705,70,775,775,0,0
40388,2019-10-27,773,0,773,77,850,850,0,0
40389,2019-10-27,167,0,167,13,180,180,0,0
40390,2019-10-27,1279,0,1279,127,1406,1406,0,0
40391,2019-10-27,732,0,732,58,790,0,790,0
40392,2019-10-27,501,0,501,40,541,541,0,0
40393,2019-10-27,623,0,623,49,672,672,0,0
40394,2019-10-27,773,0,773,77,850,850,0,0
40395,2019-10-27,437,0,437,43,480,480,0,0
40396,2019-10-27,678,0,678,54,732,732,0,0
40397,2019-10-27,2924,0,2924,233,3157,0,3157,0
40398,2019-10-27,380,0,380,30,410,410,0,0
40399,2019-10-27,773,0,773,77,850,850,0,0
40400,2019-10-27,594,0,594,47,641,641,0,0
40401,2019-10-27,1150,0,1150,92,1242,1242,0,0
40402,2019-10-27,380,0,380,30,410,0,410,0
40403,2019-10-27,325,0,325,26,351,351,0,0
40404,2019-10-27,909,0,909,72,981,981,0,0
40405,2019-10-27,269,0,269,21,290,290,0,0
40406,2019-10-27,557,0,557,44,601,601,0,0
40407,2019-10-27,816,0,816,81,897,897,0,0
40408,2019-10-27,798,0,798,63,861,861,0,0
40409,2019-10-27,232,0,232,18,250,250,0,0
40410,2019-10-27,1316,0,1316,105,1421,1421,0,0
40411,2019-10-27,362,0,362,28,390,390,0,0
40412,2019-10-27,773,0,773,77,850,850,0,0
40413,2019-10-27,445,0,445,35,480,480,0,0
40414,2019-10-27,1317,0,1317,105,1422,1422,0,0
40415,2019-10-27,1088,0,1088,108,1196,1196,0,0
40416,2019-10-27,1057,0,1057,84,1141,1141,0,0
40417,2019-10-27,1067,0,1067,85,1152,1152,0,0
40418,2019-10-27,-1088,0,-1088,-108,-1196,-1196,0,0
40419,2019-10-27,2368,0,2368,189,2557,2557,0,0
40420,2019-10-27,1819,0,1819,181,2000,0,2000,0
40421,2019-10-27,1546,0,1546,154,1700,0,1700,0
40422,2019-10-27,306,0,306,24,330,330,0,0
40423,2019-10-27,603,0,603,48,651,651,0,0
40424,2019-10-27,1546,0,1546,154,1700,1700,0,0
40425,2019-10-27,1559,0,1559,124,1683,1683,0,0
40426,2019-10-27,316,0,316,25,341,341,0,0
40427,2019-10-27,778,0,778,77,855,855,0,0
40428,2019-10-27,455,0,455,36,491,491,0,0
40429,2019-10-27,1546,0,1546,154,1700,1700,0,0
40430,2019-10-27,640,0,640,64,704,0,704,0
40431,2019-10-27,195,0,195,15,210,210,0,0
40432,2019-10-27,94,0,94,9,103,103,0,0
40433,2019-10-28,409,0,409,40,449,449,0,0
40434,2019-10-28,826,0,826,82,908,908,0,0
40435,2019-10-28,2673,0,2673,267,2940,2940,0,0
40436,2019-10-28,1259,0,1259,125,1384,1384,0,0
40437,2019-10-28,232,0,232,18,250,250,0,0
40438,2019-10-28,464,0,464,37,501,501,0,0
40439,2019-10-28,576,0,576,46,622,622,0,0
40440,2019-10-28,1782,0,1782,178,1960,1960,0,0
40441,2019-10-28,1364,0,1364,109,1473,1473,0,0
40442,2019-10-28,1215,0,1215,121,1336,1336,0,0
40443,2019-10-28,594,0,594,47,641,641,0,0
40444,2019-10-28,891,0,891,89,980,980,0,0
40445,2019-10-28,380,0,380,30,410,0,0,410
40446,2019-10-28,1000,0,1000,100,1100,1100,0,0
40447,2019-10-28,1000,0,1000,100,1100,1100,0,0
40448,2019-10-28,1195,0,1195,119,1314,1314,0,0
40449,2019-10-28,1782,0,1782,178,1960,1960,0,0
40450,2019-10-28,880,0,880,88,968,968,0,0
40451,2019-10-28,426,0,426,42,468,468,0,0
40452,2019-10-28,891,0,891,89,980,980,0,0
40453,2019-10-28,343,0,343,27,370,370,0,0
40454,2019-10-28,891,0,891,89,980,0,0,980
40455,2019-10-28,493,0,493,39,532,532,0,0
40456,2019-10-28,1119,0,1119,111,1230,1230,0,0
40457,2019-10-28,891,0,891,89,980,980,0,0
40458,2019-10-28,483,0,483,38,521,521,0,0
40459,2019-10-28,455,0,455,36,491,491,0,0
40460,2019-10-28,241,-24,217,21,238,238,0,0
40461,2019-10-28,540,0,540,43,583,0,583,0
40462,2019-10-28,659,0,659,52,711,711,0,0
40463,2019-10-28,741,0,741,74,815,815,0,0
40464,2019-10-28,1244,0,1244,99,1343,1343,0,0
40465,2019-10-28,1110,0,1110,111,1221,1221,0,0
40466,2019-10-28,1107,0,1107,88,1195,1195,0,0
40467,2019-10-28,260,0,260,20,280,280,0,0
40468,2019-10-28,575,0,575,57,632,632,0,0
40469,2019-10-28,907,0,907,90,997,997,0,0
40470,2019-10-28,817,0,817,65,882,882,0,0
40471,2019-10-28,302,0,302,24,326,326,0,0
40472,2019-10-28,779,0,779,62,841,841,0,0
40473,2019-10-28,538,0,538,43,581,581,0,0
40474,2019-10-28,676,0,676,67,743,743,0,0
40475,2019-10-28,1677,0,1677,167,1844,1844,0,0
40476,2019-10-28,1782,0,1782,178,1960,1960,0,0
40477,2019-10-28,563,0,563,45,608,0,0,608
40478,2019-10-28,1864,0,1864,149,2013,2013,0,0
40479,2019-10-28,455,0,455,36,491,491,0,0
40480,2019-10-28,464,0,464,37,501,501,0,0
40481,2019-10-28,325,0,325,32,357,357,0,0
40482,2019-10-28,288,0,288,28,316,316,0,0
40483,2019-10-28,1018,0,1018,101,1119,1119,0,0
40484,2019-10-28,740,0,740,74,814,814,0,0
40485,2019-10-28,269,0,269,21,290,290,0,0
40486,2019-10-28,475,0,475,38,513,513,0,0
40487,2019-10-28,773,0,773,77,850,850,0,0
40488,2019-10-28,102,0,102,8,110,110,0,0
40489,2019-10-28,773,0,773,77,850,850,0,0
40490,2019-10-28,2324,0,2324,232,2556,0,2556,0
40491,2019-10-28,241,0,241,19,260,260,0,0
40492,2019-10-28,362,0,362,28,390,390,0,0
40493,2019-10-28,733,-73,660,52,712,712,0,0
40494,2019-10-28,1308,0,1308,104,1412,1412,0,0
40495,2019-10-28,297,0,297,23,320,320,0,0
40496,2019-10-28,550,0,550,44,594,594,0,0
40497,2019-10-28,672,0,672,53,725,725,0,0
40498,2019-10-28,890,0,890,71,961,961,0,0
40499,2019-10-28,147,0,147,14,161,161,0,0
40500,2019-10-28,1474,0,1474,147,1621,1621,0,0
40501,2019-10-28,603,0,603,48,651,651,0,0
40502,2019-10-28,463,0,463,46,509,509,0,0
40503,2019-10-28,1546,-154,1392,139,1531,1531,0,0
40504,2019-10-28,547,0,547,43,590,590,0,0
40505,2019-10-28,1306,0,1306,130,1436,0,1436,0
40506,2019-10-28,871,0,871,87,958,958,0,0
40507,2019-10-28,1657,0,1657,165,1822,0,0,1822
40508,2019-10-28,456,0,456,36,492,0,492,0
40509,2019-10-28,269,0,269,21,290,290,0,0
40510,2019-10-28,2253,0,2253,180,2433,0,2433,0
40511,2019-10-28,260,0,260,20,280,280,0,0
40512,2019-10-28,418,0,418,33,451,451,0,0
40513,2019-10-28,632,0,632,63,695,695,0,0
40514,2019-10-28,1085,0,1085,86,1171,1171,0,0
40515,2019-10-28,728,0,728,72,800,800,0,0
40516,2019-10-28,271,0,271,21,292,292,0,0
40517,2019-10-28,891,0,891,89,980,980,0,0
40518,2019-10-28,1256,0,1256,125,1381,0,1381,0
40519,2019-10-28,807,0,807,64,871,871,0,0
40520,2019-10-28,139,0,139,11,150,150,0,0
40521,2019-10-28,628,0,628,62,690,690,0,0
40522,2019-10-28,628,0,628,62,690,690,0,0
40523,2019-10-28,740,0,740,74,814,814,0,0
40524,2019-10-28,548,0,548,43,591,591,0,0
40525,2019-10-28,580,0,580,46,626,626,0,0
40526,2019-10-28,631,0,631,50,681,681,0,0
40527,2019-10-28,260,0,260,20,280,280,0,0
40528,2019-10-28,529,0,529,42,571,571,0,0
40529,2019-10-28,557,0,557,44,601,601,0,0
40530,2019-10-28,297,0,297,29,326,0,326,0
40531,2019-10-28,1000,0,1000,100,1100,1100,0,0
40532,2019-10-28,567,0,567,45,612,0,612,0
40533,2019-10-28,269,0,269,21,290,290,0,0
40534,2019-10-28,1567,0,1567,156,1723,1723,0,0
40535,2019-10-28,1289,-257,1032,82,1114,1114,0,0
40536,2019-10-28,1074,0,1074,107,1181,1181,0,0
40537,2019-10-28,1540,0,1540,123,1663,1663,0,0
40538,2019-10-28,343,0,343,34,377,377,0,0
40539,2019-10-28,2341,0,2341,234,2575,0,2575,0
40540,2019-10-28,911,0,911,72,983,983,0,0
40541,2019-10-28,1095,0,1095,87,1182,0,1182,0
40542,2019-10-29,158,0,158,12,170,170,0,0
40543,2019-10-29,371,0,371,29,400,400,0,0
40544,2019-10-29,509,0,509,50,559,559,0,0
40545,2019-10-29,695,0,695,69,764,764,0,0
40546,2019-10-29,640,0,640,64,704,704,0,0
40547,2019-10-29,472,0,472,47,519,519,0,0
40548,2019-10-29,491,0,491,49,540,540,0,0
40549,2019-10-29,630,0,630,63,693,693,0,0
40550,2019-10-29,1233,0,1233,123,1356,1356,0,0
40551,2019-10-29,1670,0,1670,133,1803,1803,0,0
40552,2019-10-29,918,0,918,73,991,991,0,0
40553,2019-10-29,186,0,186,14,200,200,0,0
40554,2019-10-29,1059,0,1059,84,1143,1143,0,0
40555,2019-10-29,344,0,344,27,371,371,0,0
40556,2019-10-29,327,0,327,26,353,353,0,0
40557,2019-10-29,540,0,540,43,583,0,583,0
40558,2019-10-29,208,0,208,16,224,224,0,0
40559,2019-10-29,974,0,974,77,1051,1051,0,0
40560,2019-10-29,269,0,269,21,290,290,0,0
40561,2019-10-29,1537,0,1537,153,1690,1690,0,0
40562,2019-10-29,770,0,770,61,831,831,0,0
40563,2019-10-29,524,0,524,41,565,565,0,0
40564,2019-10-30,436,0,436,43,479,479,0,0
40565,2019-10-30,186,0,186,14,200,200,0,0
40566,2019-10-30,576,0,576,46,622,0,622,0
40567,2019-10-30,891,0,891,89,980,980,0,0
40568,2019-10-30,251,0,251,20,271,271,0,0
40569,2019-10-30,2697,0,2697,269,2966,0,2966,0
40570,2019-10-30,566,0,566,56,622,622,0,0
40571,2019-10-30,1495,0,1495,119,1614,1614,0,0
40572,2019-10-30,370,0,370,37,407,407,0,0
40573,2019-10-30,697,0,697,55,752,752,0,0
40574,2019-10-30,1736,-173,1563,125,1688,1688,0,0
40575,2019-10-30,881,0,881,88,969,969,0,0
40576,2019-10-30,519,0,519,41,560,560,0,0
40577,2019-10-30,751,0,751,60,811,811,0,0
40578,2019-10-30,482,0,482,38,520,520,0,0
40579,2019-10-30,759,0,759,75,834,834,0,0
40580,2019-10-30,2673,0,2673,267,2940,2940,0,0
40581,2019-10-30,891,0,891,89,980,980,0,0
40582,2019-10-30,891,0,891,89,980,980,0,0
40583,2019-10-30,409,0,409,32,441,441,0,0
40584,2019-10-30,464,0,464,37,501,501,0,0
40585,2019-10-30,511,0,511,40,551,551,0,0
40586,2019-10-30,596,0,596,47,643,643,0,0
40587,2019-10-30,1782,0,1782,178,1960,1960,0,0
40588,2019-10-30,482,0,482,38,520,520,0,0
40589,2019-10-30,1040,0,1040,83,1123,1123,0,0
40590,2019-10-30,641,0,641,51,692,692,0,0
40591,2019-10-30,260,0,260,20,280,280,0,0
40592,2019-10-30,861,0,861,86,947,947,0,0
40593,2019-10-30,603,0,603,48,651,651,0,0
40594,2019-10-30,390,0,390,31,421,0,421,0
40595,2019-10-30,428,0,428,34,462,462,0,0
40596,2019-10-30,483,0,483,48,531,531,0,0
40597,2019-10-30,141,0,141,11,152,152,0,0
40598,2019-10-30,696,0,696,55,751,751,0,0
40599,2019-10-30,891,0,891,89,980,980,0,0
40600,2019-10-30,1148,0,1148,114,1262,1262,0,0
40601,2019-10-30,316,0,316,25,341,0,341,0
40602,2019-10-30,1105,0,1105,88,1193,1193,0,0
40603,2019-10-30,715,-143,572,57,629,629,0,0
40604,2019-10-30,556,0,556,44,600,600,0,0
40605,2019-10-30,399,0,399,31,430,430,0,0
40606,2019-10-30,659,0,659,52,711,711,0,0
40607,2019-10-30,584,0,584,58,642,642,0,0
40608,2019-10-30,167,0,167,13,180,180,0,0
40609,2019-10-30,631,0,631,50,681,681,0,0
40610,2019-10-30,890,0,890,71,961,961,0,0
40611,2019-10-30,723,0,723,57,780,780,0,0
40612,2019-10-30,1179,0,1179,94,1273,1273,0,0
40613,2019-10-30,734,0,734,58,792,792,0,0
40614,2019-10-30,733,0,733,73,806,806,0,0
40615,2019-10-30,1280,0,1280,102,1382,0,1382,0
40616,2019-10-30,1558,0,1558,155,1713,1713,0,0
40617,2019-10-30,1021,0,1021,102,1123,1123,0,0
40618,2019-10-30,418,0,418,33,451,451,0,0
40619,2019-10-30,-1021,0,-1021,-102,-1123,-1123,0,0
40620,2019-10-30,1546,0,1546,154,1700,1700,0,0
40621,2019-10-30,641,0,641,51,692,692,0,0
40622,2019-10-30,1213,0,1213,121,1334,1334,0,0
40623,2019-10-30,1990,0,1990,199,2189,0,2189,0
40624,2019-10-30,381,0,381,30,411,411,0,0
40625,2019-10-30,370,0,370,37,407,407,0,0
40626,2019-10-30,269,0,269,21,290,290,0,0
40627,2019-10-30,861,0,861,86,947,947,0,0
40628,2019-10-30,389,0,389,38,427,427,0,0
40629,2019-10-30,1176,0,1176,117,1293,1293,0,0
40630,2019-10-30,437,0,437,34,471,471,0,0
40631,2019-10-30,773,0,773,77,850,850,0,0
40632,2019-10-30,773,0,773,77,850,850,0,0
40633,2019-10-30,773,0,773,77,850,850,0,0
40634,2019-10-30,619,0,619,49,668,668,0,0
40635,2019-10-30,679,0,679,54,733,733,0,0
40636,2019-10-30,835,0,835,66,901,901,0,0
40637,2019-10-30,446,0,446,35,481,481,0,0
40638,2019-10-30,306,0,306,24,330,330,0,0
40639,2019-10-30,908,0,908,90,998,998,0,0
40640,2019-10-30,945,0,945,94,1039,1039,0,0
40641,2019-10-30,1546,0,1546,154,1700,1700,0,0
40642,2019-10-30,773,0,773,77,850,850,0,0
40643,2019-10-30,677,0,677,54,731,731,0,0
40644,2019-10-30,-899,0,-899,-89,-988,-988,0,0
40645,2019-10-30,260,0,260,20,280,280,0,0
40646,2019-10-30,937,0,937,74,1011,1011,0,0
40647,2019-10-30,1546,0,1546,154,1700,0,0,1700
40648,2019-10-30,723,0,723,72,795,795,0,0
40649,2019-10-30,271,0,271,21,292,292,0,0
40650,2019-10-30,269,0,269,21,290,290,0,0
40651,2019-10-30,891,0,891,89,980,980,0,0
40652,2019-10-30,1021,0,1021,102,1123,1123,0,0
40653,2019-10-30,891,0,891,89,980,980,0,0
40654,2019-10-30,899,0,899,89,988,988,0,0
40655,2019-10-30,891,0,891,89,980,980,0,0
40656,2019-10-30,168,0,168,13,181,0,0,181
40657,2019-10-30,176,0,176,17,193,0,0,193
40658,2019-10-30,696,0,696,55,751,751,0,0
40659,2019-10-30,891,0,891,89,980,980,0,0
40660,2019-10-30,836,0,836,66,902,902,0,0
40661,2019-10-30,773,0,773,77,850,0,850,0
40662,2019-10-30,399,0,399,31,430,430,0,0
40663,2019-10-30,436,0,436,34,470,470,0,0
40664,2019-10-30,789,0,789,63,852,852,0,0
40665,2019-10-30,269,0,269,21,290,290,0,0
40666,2019-10-30,139,0,139,11,150,150,0,0
40667,2019-10-30,446,0,446,35,481,481,0,0
40668,2019-10-30,362,0,362,28,390,390,0,0
40669,2019-10-30,486,0,486,38,524,524,0,0
40670,2019-10-30,594,0,594,47,641,641,0,0
40671,2019-10-30,594,0,594,47,641,641,0,0
40672,2019-10-30,2003,-200,1803,144,1947,1947,0,0
40673,2019-10-30,501,0,501,40,541,541,0,0
40674,2019-10-30,297,0,297,23,320,320,0,0
40675,2019-10-31,141,0,141,11,152,0,0,152
40676,2019-10-31,1821,0,1821,145,1966,1966,0,0
40677,2019-10-31,640,0,640,51,691,691,0,0
40678,2019-10-31,1744,0,1744,139,1883,1883,0,0
40679,2019-10-31,353,0,353,28,381,381,0,0
40680,2019-10-31,269,0,269,21,290,290,0,0
40681,2019-10-31,2717,0,2717,271,2988,2988,0,0
40682,2019-10-31,362,0,362,28,390,390,0,0
40683,2019-10-31,260,0,260,20,280,280,0,0
40684,2019-10-31,426,0,426,34,460,0,0,460
40685,2019-10-31,650,-65,585,46,631,631,0,0
40686,2019-10-31,846,0,846,67,913,913,0,0
40687,2019-10-31,891,0,891,89,980,980,0,0
40688,2019-10-31,196,0,196,15,211,211,0,0
40689,2019-10-31,1403,0,1403,112,1515,1515,0,0
40690,2019-10-31,112,0,112,8,120,120,0,0
40691,2019-10-31,891,0,891,89,980,980,0,0
40692,2019-10-31,891,0,891,89,980,980,0,0
40693,2019-10-31,891,0,891,89,980,980,0,0
40694,2019-10-31,891,0,891,89,980,980,0,0
40695,2019-10-31,918,0,918,73,991,991,0,0
40696,2019-10-31,891,0,891,89,980,980,0,0
40697,2019-10-31,298,0,298,29,327,327,0,0
40698,2019-10-31,603,0,603,48,651,651,0,0
40699,2019-10-31,2089,0,2089,208,2297,2297,0,0
40700,2019-10-31,1310,0,1310,104,1414,1414,0,0
40701,2019-10-31,3564,0,3564,356,3920,3920,0,0
40702,2019-10-31,1067,0,1067,85,1152,1152,0,0
40703,2019-10-31,473,0,473,37,510,510,0,0
40704,2019-10-31,1011,0,1011,80,1091,1091,0,0
40705,2019-10-31,854,0,854,68,922,922,0,0
40706,2019-10-31,891,0,891,89,980,0,980,0
40707,2019-10-31,891,0,891,89,980,980,0,0
40708,2019-10-31,892,0,892,89,981,981,0,0
40709,2019-10-31,605,0,605,48,653,653,0,0
40710,2019-10-31,260,0,260,20,280,280,0,0
40711,2019-10-31,269,0,269,21,290,290,0,0
40712,2019-10-31,957,0,957,76,1033,1033,0,0
40713,2019-10-31,399,0,399,31,430,430,0,0
40714,2019-10-31,269,0,269,21,290,290,0,0
40715,2019-10-31,139,0,139,11,150,150,0,0
40716,2019-10-31,417,0,417,41,458,458,0,0
40717,2019-10-31,1463,0,1463,146,1609,1609,0,0
40718,2019-10-31,291,0,291,23,314,314,0,0
40719,2019-10-31,780,0,780,62,842,842,0,0
40720,2019-10-31,410,0,410,21,431,431,0,0
40721,2019-10-31,640,0,640,51,691,0,691,0
40722,2019-10-31,995,0,995,79,1074,0,1074,0
40723,2019-10-31,1084,0,1084,108,1192,1192,0,0
40724,2019-10-31,389,0,389,38,427,427,0,0
40725,2019-10-31,502,0,502,40,542,542,0,0
40726,2019-10-31,789,0,789,63,852,852,0,0
40727,2019-10-31,612,0,612,48,660,660,0,0
40728,2019-10-31,390,0,390,31,421,421,0,0
40729,2019-10-31,1234,-123,1111,88,1199,0,1199,0
40730,2019-10-31,409,0,409,32,441,0,0,441
40731,2019-10-31,260,0,260,20,280,280,0,0
40732,2019-10-31,575,0,575,46,621,621,0,0
40733,2019-10-31,947,0,947,75,1022,1022,0,0
40734,2019-10-31,455,0,455,36,491,491,0,0
40735,2019-10-31,994,0,994,79,1073,1073,0,0
40736,2019-10-31,566,0,566,45,611,0,611,0
40737,2019-10-31,491,0,491,49,540,540,0,0
40738,2019-10-31,891,0,891,89,980,0,980,0
40739,2019-10-31,492,0,492,39,531,531,0,0
40740,2019-10-31,827,0,827,66,893,893,0,0
40741,2019-10-31,538,0,538,43,581,581,0,0
40742,2019-10-31,473,0,473,37,510,510,0,0
40743,2019-10-31,232,0,232,18,250,250,0,0
40744,2019-10-31,891,0,891,89,980,980,0,0
40745,2019-10-31,389,0,389,38,427,427,0,0
40746,2019-10-31,1028,0,1028,102,1130,1130,0,0
40747,2019-10-31,1463,0,1463,146,1609,1609,0,0
40748,2019-10-31,112,0,112,11,123,123,0,0
40749,2019-10-31,491,0,491,49,540,540,0,0
40750,2019-10-31,-370,0,-370,-37,-407,-407,0,0
40751,2019-10-31,1298,0,1298,129,1427,1427,0,0
40752,2019-10-31,371,0,371,29,400,400,0,0
40753,2019-10-31,1169,0,1169,93,1262,1262,0,0
40754,2019-10-31,817,0,817,65,882,882,0,0
40755,2019-10-31,1546,0,1546,154,1700,1700,0,0
40756,2019-10-31,773,0,773,77,850,850,0,0
40757,2019-10-31,773,0,773,77,850,850,0,0
40758,2019-10-31,484,0,484,38,522,522,0,0
40759,2019-10-31,232,0,232,18,250,250,0,0
40760,2019-10-31,446,0,446,35,481,481,0,0
40761,2019-10-31,260,0,260,20,280,280,0,0
40762,2019-10-31,585,0,585,46,631,631,0,0
40763,2019-10-31,1573,0,1573,157,1730,1730,0,0
40764,2019-10-31,659,0,659,52,711,711,0,0
40765,2019-10-31,465,0,465,37,502,502,0,0
40766,2019-10-31,843,0,843,84,927,927,0,0
40767,2019-10-31,-861,0,-861,-86,-947,-947,0,0
40768,2019-10-31,839,0,839,83,922,922,0,0
40769,2019-10-31,502,0,502,40,542,542,0,0
40770,2019-10-31,483,0,483,38,521,521,0,0
40771,2019-10-31,705,0,705,70,775,775,0,0
40772,2019-10-31,649,0,649,64,713,713,0,0
40773,2019-10-31,875,0,875,70,945,945,0,0
40774,2019-10-31,598,0,598,47,645,0,645,0
40775,2019-10-31,167,0,167,13,180,180,0,0
40776,2019-10-31,279,0,279,22,301,301,0,0
40777,2019-10-31,214,0,214,17,231,231,0,0
40778,2019-10-31,903,0,903,72,975,975,0,0
40779,2019-10-31,773,0,773,77,850,850,0,0
40780,2019-10-31,957,0,957,76,1033,1033,0,0
40781,2019-10-31,742,0,742,59,801,801,0,0
40782,2019-10-31,705,0,705,56,761,761,0,0
40783,2019-10-31,798,0,798,79,877,0,877,0
40784,2019-10-31,982,0,982,98,1080,1080,0,0
40785,2019-10-31,326,0,326,26,352,0,352,0
40786,2019-10-31,576,0,576,46,622,622,0,0
40787,2019-10-31,445,0,445,35,480,0,480,0
40788,2019-10-31,1659,0,1659,165,1824,1824,0,0
40789,2019-10-31,622,0,622,49,671,671,0,0
40790,2019-10-31,389,0,389,31,420,0,420,0
40791,2019-10-31,836,0,836,66,902,902,0,0
40792,2019-10-31,1001,0,1001,80,1081,1081,0,0
40793,2019-10-31,2074,0,2074,207,2281,2281,0,0
40794,2019-10-31,1288,0,1288,128,1416,1416,0,0
40795,2019-10-31,371,0,371,29,400,400,0,0
40796,2019-10-31,539,0,539,43,582,0,0,582
40797,2019-10-31,1197,0,1197,95,1292,1292,0,0
40798,2019-10-31,773,0,773,77,850,850,0,0
40799,2019-10-31,446,0,446,24,470,470,0,0
40800,2019-10-31,370,0,370,37,407,407,0,0
40801,2019-10-31,501,0,501,40,541,541,0,0
40802,2019-10-31,443,0,443,35,478,478,0,0
40803,2019-10-31,1089,0,1089,87,1176,1176,0,0
40804,2019-10-31,642,0,642,51,693,693,0,0
40805,2019-10-31,306,0,306,24,330,330,0,0
40806,2019-10-31,353,0,353,28,381,381,0,0
40807,2019-10-31,863,0,863,69,932,932,0,0
40808,2019-10-31,204,0,204,16,220,220,0,0
40809,2019-10-31,370,0,370,37,407,407,0,0
40810,2019-10-31,334,0,334,26,360,360,0,0
40811,2019-10-31,759,0,759,75,834,834,0,0
40812,2019-10-31,678,0,678,54,732,732,0,0
40813,2019-11-01,362,0,362,36,398,398,0,0
40814,2019-11-01,594,0,594,47,641,641,0,0
40815,2019-11-01,1458,0,1458,116,1574,1574,0,0
40816,2019-11-01,139,0,139,11,150,150,0,0
40817,2019-11-01,-778,0,-778,-77,-855,-855,0,0
40818,2019-11-01,740,0,740,74,814,814,0,0
40819,2019-11-01,848,0,848,67,915,915,0,0
40820,2019-11-01,135,0,135,10,145,145,0,0
40821,2019-11-01,1782,0,1782,178,1960,1960,0,0
40822,2019-11-01,315,0,315,25,340,340,0,0
40823,2019-11-01,269,0,269,21,290,290,0,0
40824,2019-11-01,280,0,280,22,302,302,0,0
40825,2019-11-01,149,0,149,11,160,160,0,0
40826,2019-11-01,778,0,778,77,855,855,0,0
40827,2019-11-01,779,0,779,62,841,841,0,0
40828,2019-11-01,1239,0,1239,99,1338,0,0,1338
40829,2019-11-01,891,0,891,89,980,980,0,0
40830,2019-11-01,1359,0,1359,108,1467,1467,0,0
40831,2019-11-01,232,0,232,18,250,250,0,0
40832,2019-11-01,233,0,233,18,251,251,0,0
40833,2019-11-01,2014,0,2014,161,2175,2175,0,0
40834,2019-11-01,292,0,292,23,315,315,0,0
40835,2019-11-01,915,0,915,73,988,988,0,0
40836,2019-11-01,427,0,427,42,469,469,0,0
40837,2019-11-01,370,0,370,37,407,407,0,0
40838,2019-11-01,1317,0,1317,105,1422,0,1422,0
40839,2019-11-01,2414,0,2414,208,2622,2622,0,0
40840,2019-11-01,668,0,668,53,721,721,0,0
40841,2019-11-01,371,0,371,29,400,400,0,0
40842,2019-11-01,640,0,640,51,691,691,0,0
40843,2019-11-01,1022,0,1022,81,1103,1103,0,0
40844,2019-11-01,891,0,891,89,980,980,0,0
40845,2019-11-01,891,0,891,89,980,980,0,0
40846,2019-11-01,742,0,742,59,801,801,0,0
40847,2019-11-01,891,0,891,89,980,980,0,0
40848,2019-11-01,724,0,724,57,781,781,0,0
40849,2019-11-01,511,0,511,40,551,551,0,0
40850,2019-11-01,381,0,381,30,411,411,0,0
40851,2019-11-01,2140,0,2140,214,2354,2354,0,0
40852,2019-11-01,511,0,511,40,551,551,0,0
40853,2019-11-01,316,0,316,25,341,341,0,0
40854,2019-11-01,390,0,390,31,421,421,0,0
40855,2019-11-01,1438,0,1438,115,1553,1553,0,0
40856,2019-11-01,816,0,816,65,881,881,0,0
40857,2019-11-01,742,0,742,59,801,0,0,801
40858,2019-11-01,1269,0,1269,126,1395,1395,0,0
40859,2019-11-01,446,0,446,35,481,481,0,0
40860,2019-11-01,363,0,363,29,392,392,0,0
40861,2019-11-01,1074,0,1074,107,1181,0,1181,0
40862,2019-11-01,1426,0,1426,142,1568,1568,0,0
40863,2019-11-01,316,0,316,25,341,0,0,341
40864,2019-11-01,1234,0,1234,98,1332,1332,0,0
40865,2019-11-01,445,0,445,35,480,480,0,0
40866,2019-11-01,251,0,251,25,276,0,0,276
40867,2019-11-01,315,0,315,25,340,0,0,340
40868,2019-11-01,168,0,168,16,184,184,0,0
40869,2019-11-01,818,0,818,43,861,861,0,0
40870,2019-11-01,975,0,975,78,1053,1053,0,0
40871,2019-11-01,288,0,288,23,311,311,0,0
40872,2019-11-01,1133,0,1133,90,1223,1223,0,0
40873,2019-11-01,2326,0,2326,232,2558,2558,0,0
40874,2019-11-01,705,0,705,56,761,761,0,0
40875,2019-11-01,827,0,827,66,893,893,0,0
40876,2019-11-01,752,0,752,75,827,827,0,0
40877,2019-11-01,456,0,456,36,492,492,0,0
40878,2019-11-01,335,0,335,26,361,361,0,0
40879,2019-11-01,325,0,325,26,351,351,0,0
40880,2019-11-01,-335,0,-335,-26,-361,-361,0,0
40881,2019-11-01,1782,0,1782,178,1960,1960,0,0
40882,2019-11-01,529,0,529,52,581,581,0,0
40883,2019-11-01,1782,0,1782,178,1960,1960,0,0
40884,2019-11-01,306,0,306,24,330,330,0,0
40885,2019-11-01,1234,0,1234,98,1332,1332,0,0
40886,2019-11-01,890,0,890,89,979,979,0,0
40887,2019-11-01,520,0,520,41,561,561,0,0
40888,2019-11-01,335,0,335,26,361,361,0,0
40889,2019-11-01,891,0,891,89,980,980,0,0
40890,2019-11-01,334,-33,301,24,325,0,0,325
40891,2019-11-01,936,0,936,93,1029,1029,0,0
40892,2019-11-01,473,0,473,37,510,510,0,0
40893,2019-11-01,251,0,251,20,271,0,0,271
40894,2019-11-01,873,0,873,69,942,0,942,0
40895,2019-11-01,788,0,788,63,851,851,0,0
40896,2019-11-01,707,0,707,56,763,0,0,763
40897,2019-11-01,436,0,436,34,470,0,0,470
40898,2019-11-01,751,0,751,60,811,811,0,0
40899,2019-11-01,510,0,510,40,550,550,0,0
40900,2019-11-01,566,0,566,45,611,611,0,0
40901,2019-11-01,1046,0,1046,104,1150,1150,0,0
40902,2019-11-01,773,0,773,77,850,850,0,0
40903,2019-11-01,1046,0,1046,104,1150,1150,0,0
40904,2019-11-01,1297,0,1297,103,1400,1400,0,0
40905,2019-11-01,1546,0,1546,154,1700,0,1700,0
40906,2019-11-01,1819,0,1819,181,2000,0,2000,0
40907,2019-11-01,1194,0,1194,119,1313,1313,0,0
40908,2019-11-01,232,0,232,18,250,250,0,0
40909,2019-11-01,852,0,852,85,937,937,0,0
40910,2019-11-01,1391,0,1391,111,1502,1502,0,0
40911,2019-11-01,168,0,168,16,184,184,0,0
40912,2019-11-01,510,0,510,40,550,550,0,0
40913,2019-11-01,102,0,102,8,110,110,0,0
40914,2019-11-01,232,0,232,18,250,250,0,0
40915,2019-11-01,1002,0,1002,80,1082,1082,0,0
40916,2019-11-01,362,0,362,28,390,390,0,0
40917,2019-11-01,389,0,389,31,420,420,0,0
40918,2019-11-01,362,0,362,28,390,390,0,0
40919,2019-11-01,251,0,251,25,276,276,0,0
40920,2019-11-01,594,0,594,47,641,641,0,0
40921,2019-11-01,130,0,130,10,140,140,0,0
40922,2019-11-01,566,0,566,45,611,611,0,0
40923,2019-11-01,260,0,260,20,280,280,0,0
40924,2019-11-01,1260,0,1260,126,1386,1386,0,0
40925,2019-11-01,649,0,649,64,713,713,0,0
40926,2019-11-01,260,0,260,20,280,280,0,0
40927,2019-11-01,798,0,798,79,877,877,0,0
40928,2019-11-01,260,0,260,20,280,280,0,0
40929,2019-11-01,773,0,773,77,850,850,0,0
40930,2019-11-01,139,0,139,13,152,152,0,0
40931,2019-11-01,2225,0,2225,222,2447,2447,0,0
40932,2019-11-01,2328,0,2328,186,2514,0,2514,0
40933,2019-11-01,1022,0,1022,81,1103,1103,0,0
40934,2019-11-01,1110,0,1110,88,1198,1198,0,0
40935,2019-11-01,362,0,362,28,390,390,0,0
40936,2019-11-01,121,0,121,9,130,130,0,0
40937,2019-11-01,399,0,399,31,430,430,0,0
40938,2019-11-01,835,0,835,66,901,901,0,0
40939,2019-11-01,362,0,362,28,390,390,0,0
40940,2019-11-01,334,0,334,26,360,360,0,0
40941,2019-11-01,529,0,529,42,571,0,0,571
40942,2019-11-01,667,0,667,53,720,720,0,0
40943,2019-11-01,2600,0,2600,229,2829,2829,0,0
40944,2019-11-01,865,0,865,58,923,0,923,0
40945,2019-11-01,260,0,260,20,280,280,0,0
40946,2019-11-01,1196,0,1196,95,1291,1291,0,0
40947,2019-11-01,912,0,912,91,1003,1003,0,0
40948,2019-11-01,390,0,390,31,421,421,0,0
40949,2019-11-01,1067,0,1067,85,1152,1152,0,0
40950,2019-11-01,2424,0,2424,193,2617,2617,0,0
40951,2019-11-01,773,0,773,77,850,0,850,0
40952,2019-11-01,714,0,714,57,771,771,0,0
40953,2019-11-01,740,0,740,59,799,799,0,0
40954,2019-11-01,593,0,593,47,640,0,0,640
40955,2019-11-01,773,0,773,77,850,850,0,0
40956,2019-11-01,1101,0,1101,110,1211,1211,0,0
40957,2019-11-01,593,0,593,47,640,640,0,0
40958,2019-11-01,640,0,640,51,691,691,0,0
40959,2019-11-01,733,0,733,59,792,792,0,0
40960,2019-11-01,880,0,880,88,968,968,0,0
40961,2019-11-01,964,0,964,77,1041,1041,0,0
40962,2019-11-01,686,0,686,68,754,754,0,0
40963,2019-11-01,1352,0,1352,135,1487,1487,0,0
40964,2019-11-01,1546,0,1546,154,1700,1700,0,0
40965,2019-11-01,1189,0,1189,83,1272,1272,0,0
40966,2019-11-01,640,0,640,51,691,691,0,0
40967,2019-11-01,882,0,882,70,952,952,0,0
40968,2019-11-01,844,0,844,67,911,911,0,0
40969,2019-11-01,779,0,779,62,841,841,0,0
40970,2019-11-02,353,0,353,28,381,381,0,0
40971,2019-11-02,557,0,557,55,612,612,0,0
40972,2019-11-02,631,0,631,50,681,681,0,0
40973,2019-11-02,260,0,260,26,286,0,286,0
40974,2019-11-02,631,0,631,63,694,694,0,0
40975,2019-11-02,186,0,186,14,200,0,200,0
40976,2019-11-02,343,0,343,34,377,377,0,0
40977,2019-11-02,368,0,368,29,397,397,0,0
40978,2019-11-02,399,0,399,39,438,438,0,0
40979,2019-11-02,751,0,751,60,811,811,0,0
40980,2019-11-02,334,0,334,26,360,360,0,0
40981,2019-11-02,251,0,251,20,271,271,0,0
40982,2019-11-02,139,0,139,11,150,150,0,0
40983,2019-11-02,677,0,677,54,731,731,0,0
40984,2019-11-02,130,0,130,10,140,140,0,0
40985,2019-11-02,778,0,778,77,855,855,0,0
40986,2019-11-02,761,0,761,76,837,837,0,0
40987,2019-11-02,334,0,334,26,360,360,0,0
40988,2019-11-02,1152,0,1152,92,1244,0,1244,0
40989,2019-11-02,141,0,141,11,152,152,0,0
40990,2019-11-02,1084,0,1084,86,1170,1170,0,0
40991,2019-11-02,437,0,437,34,471,471,0,0
40992,2019-11-02,418,0,418,33,451,451,0,0
40993,2019-11-02,797,0,797,63,860,860,0,0
40994,2019-11-02,740,0,740,74,814,814,0,0
40995,2019-11-02,417,0,417,33,450,450,0,0
40996,2019-11-02,3564,0,3564,356,3920,3920,0,0
40997,2019-11-02,500,0,500,50,550,550,0,0
40998,2019-11-02,791,0,791,79,870,870,0,0
40999,2019-11-02,149,0,149,14,163,163,0,0
41000,2019-11-02,371,0,371,29,400,400,0,0
41001,2019-11-02,584,0,584,46,630,630,0,0
41002,2019-11-02,2058,0,2058,205,2263,2263,0,0
41003,2019-11-02,882,0,882,70,952,952,0,0
41004,2019-11-02,492,0,492,39,531,531,0,0
41005,2019-11-02,697,0,697,55,752,752,0,0
41006,2019-11-02,641,0,641,51,692,0,0,692
41007,2019-11-02,1029,0,1029,82,1111,1111,0,0
41008,2019-11-02,816,0,816,65,881,881,0,0
41009,2019-11-02,297,0,297,23,320,320,0,0
41010,2019-11-02,408,0,408,32,440,0,0,440
41011,2019-11-02,538,0,538,43,581,581,0,0
41012,2019-11-02,343,0,343,34,377,377,0,0
41013,2019-11-02,279,0,279,22,301,301,0,0
41014,2019-11-02,2410,0,2410,241,2651,2651,0,0
41015,2019-11-02,501,0,501,40,541,541,0,0
41016,2019-11-02,631,0,631,50,681,681,0,0
41017,2019-11-02,3134,0,3134,313,3447,3447,0,0
41018,2019-11-02,1141,0,1141,91,1232,0,1232,0
41019,2019-11-02,1440,0,1440,144,1584,1584,0,0
41020,2019-11-02,1782,0,1782,178,1960,1960,0,0
41021,2019-11-02,334,0,334,26,360,360,0,0
41022,2019-11-02,370,0,370,37,407,407,0,0
41023,2019-11-02,844,0,844,67,911,911,0,0
41024,2019-11-02,298,0,298,23,321,321,0,0
41025,2019-11-02,1085,0,1085,108,1193,1193,0,0
41026,2019-11-02,705,0,705,56,761,0,761,0
41027,2019-11-02,761,0,761,76,837,837,0,0
41028,2019-11-02,232,0,232,18,250,250,0,0
41029,2019-11-02,510,0,510,40,550,550,0,0
41030,2019-11-02,1532,0,1532,122,1654,1654,0,0
41031,2019-11-02,603,0,603,60,663,663,0,0
41032,2019-11-02,557,0,557,44,601,601,0,0
41033,2019-11-02,370,0,370,37,407,407,0,0
41034,2019-11-02,306,0,306,24,330,330,0,0
41035,2019-11-02,688,0,688,55,743,743,0,0
41036,2019-11-02,843,0,843,84,927,927,0,0
41037,2019-11-02,835,0,835,66,901,901,0,0
41038,2019-11-02,696,0,696,55,751,751,0,0
41039,2019-11-02,430,0,430,43,473,473,0,0
41040,2019-11-02,463,0,463,46,509,509,0,0
41041,2019-11-02,510,0,510,40,550,550,0,0
41042,2019-11-02,232,0,232,18,250,250,0,0
41043,2019-11-02,853,0,853,85,938,938,0,0
41044,2019-11-02,1782,0,1782,178,1960,1960,0,0
41045,2019-11-02,1075,0,1075,86,1161,1161,0,0
41046,2019-11-02,149,0,149,14,163,163,0,0
41047,2019-11-02,615,0,615,49,664,664,0,0
41048,2019-11-02,946,0,946,75,1021,1021,0,0
41049,2019-11-02,864,0,864,69,933,933,0,0
41050,2019-11-02,343,0,343,34,377,377,0,0
41051,2019-11-02,336,-33,303,24,327,327,0,0
41052,2019-11-02,538,0,538,43,581,581,0,0
41053,2019-11-02,334,0,334,26,360,360,0,0
41054,2019-11-02,362,0,362,28,390,390,0,0
41055,2019-11-02,890,0,890,71,961,961,0,0
41056,2019-11-02,622,0,622,49,671,671,0,0
41057,2019-11-02,928,0,928,74,1002,0,0,1002
41058,2019-11-02,344,0,344,27,371,371,0,0
41059,2019-11-02,714,0,714,57,771,771,0,0
41060,2019-11-02,1086,0,1086,108,1194,1194,0,0
41061,2019-11-02,269,0,269,21,290,290,0,0
41062,2019-11-02,1232,0,1232,123,1355,1355,0,0
41063,2019-11-02,981,0,981,98,1079,1079,0,0
41064,2019-11-02,269,0,269,21,290,290,0,0
41065,2019-11-02,780,-500,280,22,302,302,0,0
41066,2019-11-02,556,0,556,55,611,611,0,0
41067,2019-11-02,834,0,834,83,917,917,0,0
41068,2019-11-02,492,0,492,39,531,531,0,0
41069,2019-11-02,389,0,389,38,427,427,0,0
41070,2019-11-02,1290,0,1290,103,1393,1393,0,0
41071,2019-11-02,149,0,149,14,163,163,0,0
41072,2019-11-02,269,0,269,21,290,290,0,0
41073,2019-11-02,269,0,269,21,290,290,0,0
41074,2019-11-02,463,0,463,46,509,509,0,0
41075,2019-11-02,861,0,861,68,929,929,0,0
41076,2019-11-02,260,0,260,20,280,280,0,0
41077,2019-11-02,381,0,381,30,411,411,0,0
41078,2019-11-02,399,0,399,31,430,0,430,0
41079,2019-11-02,816,0,816,81,897,897,0,0
41080,2019-11-02,297,0,297,23,320,320,0,0
41081,2019-11-02,1011,0,1011,80,1091,1091,0,0
41082,2019-11-02,891,0,891,89,980,980,0,0
41083,2019-11-02,907,0,907,72,979,979,0,0
41084,2019-11-02,770,0,770,61,831,831,0,0
41085,2019-11-02,3676,0,3676,367,4043,0,4043,0
41086,2019-11-02,790,0,790,63,853,853,0,0
41087,2019-11-02,781,0,781,62,843,843,0,0
41088,2019-11-02,400,0,400,32,432,432,0,0
41089,2019-11-02,139,0,139,11,150,150,0,0
41090,2019-11-02,769,0,769,76,845,845,0,0
41091,2019-11-02,918,0,918,73,991,991,0,0
41092,2019-11-02,909,0,909,90,999,999,0,0
41093,2019-11-02,334,0,334,26,360,0,360,0
41094,2019-11-02,502,0,502,40,542,542,0,0
41095,2019-11-02,1028,0,1028,102,1130,1130,0,0
41096,2019-11-02,798,0,798,63,861,861,0,0
41097,2019-11-02,891,0,891,89,980,980,0,0
41098,2019-11-02,278,0,278,22,300,300,0,0
41099,2019-11-02,891,0,891,89,980,980,0,0
41100,2019-11-02,1017,0,1017,101,1118,1118,0,0
41101,2019-11-02,483,0,483,38,521,521,0,0
41102,2019-11-02,288,0,288,23,311,311,0,0
41103,2019-11-02,1782,0,1782,178,1960,0,1960,0
41104,2019-11-02,214,0,214,17,231,231,0,0
41105,2019-11-02,334,0,334,26,360,360,0,0
41106,2019-11-02,102,0,102,8,110,110,0,0
41107,2019-11-02,370,0,370,37,407,407,0,0
41108,2019-11-02,344,0,344,27,371,371,0,0
41109,2019-11-02,889,0,889,88,977,977,0,0
41110,2019-11-02,538,0,538,53,591,591,0,0
41111,2019-11-02,696,0,696,55,751,751,0,0
41112,2019-11-02,520,0,520,41,561,561,0,0
41113,2019-11-02,1782,0,1782,178,1960,0,1960,0
41114,2019-11-02,418,0,418,33,451,451,0,0
41115,2019-11-02,1133,0,1133,90,1223,1223,0,0
41116,2019-11-02,891,0,891,89,980,980,0,0
41117,2019-11-02,628,0,628,62,690,690,0,0
41118,2019-11-02,779,0,779,62,841,841,0,0
41119,2019-11-02,501,0,501,40,541,541,0,0
41120,2019-11-02,650,0,650,52,702,702,0,0
41121,2019-11-02,773,0,773,77,850,0,850,0
41122,2019-11-02,558,0,558,33,591,0,591,0
41123,2019-11-02,773,0,773,77,850,850,0,0
41124,2019-11-02,773,0,773,77,850,850,0,0
41125,2019-11-02,773,0,773,77,850,0,0,850
41126,2019-11-02,1782,0,1782,178,1960,1960,0,0
41127,2019-11-02,251,0,251,20,271,271,0,0
41128,2019-11-02,891,-89,802,64,866,0,866,0
41129,2019-11-02,181,0,181,14,195,195,0,0
41130,2019-11-02,726,0,726,58,784,784,0,0
41131,2019-11-02,408,-40,368,29,397,397,0,0
41132,2019-11-02,736,0,736,58,794,794,0,0
41133,2019-11-02,538,0,538,43,581,581,0,0
41134,2019-11-02,779,0,779,62,841,841,0,0
41135,2019-11-02,1782,0,1782,178,1960,1960,0,0
41136,2019-11-02,604,0,604,48,652,652,0,0
41137,2019-11-02,1782,0,1782,178,1960,1960,0,0
41138,2019-11-02,315,0,315,25,340,340,0,0
41139,2019-11-02,632,0,632,50,682,682,0,0
41140,2019-11-02,298,-59,239,19,258,258,0,0
41141,2019-11-02,1325,0,1325,106,1431,1431,0,0
41142,2019-11-02,2673,0,2673,267,2940,0,0,2940
41143,2019-11-02,1373,0,1373,109,1482,0,0,1482
41144,2019-11-02,3816,0,3816,367,4183,4183,0,0
41145,2019-11-02,891,0,891,89,980,980,0,0
41146,2019-11-02,891,0,891,89,980,980,0,0
41147,2019-11-02,1195,0,1195,119,1314,0,1314,0
41148,2019-11-02,1782,0,1782,178,1960,0,0,1960
41149,2019-11-02,2029,0,2029,202,2231,2231,0,0
41150,2019-11-02,2171,0,2171,217,2388,2388,0,0
41151,2019-11-02,140,-14,126,0,126,126,0,0
41152,2019-11-02,1102,0,1102,110,1212,1212,0,0
41153,2019-11-02,1055,0,1055,105,1160,1160,0,0
41154,2019-11-02,640,0,640,51,691,691,0,0
41155,2019-11-02,241,0,241,19,260,260,0,0
41156,2019-11-02,269,0,269,21,290,290,0,0
41157,2019-11-02,1582,0,1582,158,1740,0,0,1740
41158,2019-11-02,1566,0,1566,156,1722,1722,0,0
41159,2019-11-02,510,-51,459,36,495,495,0,0
41160,2019-11-02,389,0,389,38,427,427,0,0
41161,2019-11-02,352,0,352,35,387,387,0,0
41162,2019-11-02,399,0,399,39,438,438,0,0
41163,2019-11-02,167,0,167,13,180,180,0,0
41164,2019-11-02,167,0,167,13,180,180,0,0
41165,2019-11-02,389,0,389,38,427,427,0,0
41166,2019-11-02,389,0,389,38,427,427,0,0
41167,2019-11-02,491,0,491,49,540,0,0,540
41168,2019-11-02,1074,-107,967,77,1044,1044,0,0
41169,2019-11-02,232,-23,209,16,225,225,0,0
41170,2019-11-02,436,0,436,34,470,470,0,0
41171,2019-11-02,214,0,214,17,231,231,0,0
41172,2019-11-02,1225,0,1225,98,1323,0,1323,0
41173,2019-11-02,1782,0,1782,178,1960,1960,0,0
41174,2019-11-02,1029,0,1029,82,1111,1111,0,0
41175,2019-11-02,566,-56,510,40,550,550,0,0
41176,2019-11-02,269,0,269,21,290,0,0,290
41177,2019-11-02,289,0,289,23,312,0,0,312
41178,2019-11-02,679,0,679,54,733,733,0,0
41179,2019-11-02,334,0,334,33,367,367,0,0
41180,2019-11-02,650,0,650,52,702,702,0,0
41181,2019-11-02,778,0,778,77,855,855,0,0
41182,2019-11-02,1262,0,1262,100,1362,1362,0,0
41183,2019-11-02,389,0,389,38,427,427,0,0
41184,2019-11-02,317,0,317,25,342,342,0,0
41185,2019-11-02,327,0,327,26,353,0,353,0
41186,2019-11-02,945,0,945,94,1039,0,1039,0
41187,2019-11-02,945,0,945,94,1039,1039,0,0
41188,2019-11-02,1771,0,1771,141,1912,0,0,1912
41189,2019-11-02,769,0,769,76,845,845,0,0
41190,2019-11-02,529,0,529,42,571,571,0,0
41191,2019-11-02,1541,0,1541,123,1664,1664,0,0
41192,2019-11-02,2297,0,2297,229,2526,0,2526,0
41193,2019-11-02,261,0,261,20,281,281,0,0
41194,2019-11-02,843,0,843,84,927,927,0,0
41195,2019-11-02,1782,0,1782,178,1960,1960,0,0
41196,2019-11-02,343,0,343,27,370,370,0,0
41197,2019-11-02,501,0,501,40,541,541,0,0
41198,2019-11-02,334,0,334,26,360,360,0,0
41199,2019-11-02,742,0,742,59,801,801,0,0
41200,2019-11-02,1476,0,1476,147,1623,0,1623,0
41201,2019-11-02,872,0,872,69,941,941,0,0
41202,2019-11-02,47,0,47,3,50,50,0,0
41203,2019-11-02,1782,-1000,782,78,860,860,0,0
41204,2019-11-02,2225,0,2225,222,2447,2447,0,0
41205,2019-11-02,853,0,853,85,938,938,0,0
41206,2019-11-02,575,0,575,46,621,621,0,0
41207,2019-11-02,780,0,780,62,842,842,0,0
41208,2019-11-02,788,0,788,78,866,866,0,0
41209,2019-11-02,891,0,891,89,980,980,0,0
41210,2019-11-02,807,0,807,64,871,871,0,0
41211,2019-11-02,510,0,510,51,561,561,0,0
41212,2019-11-02,278,0,278,22,300,300,0,0
41213,2019-11-02,705,0,705,56,761,761,0,0
41214,2019-11-02,167,0,167,16,183,183,0,0
41215,2019-11-02,389,0,389,31,420,420,0,0
41216,2019-11-02,260,0,260,20,280,280,0,0
41217,2019-11-02,343,0,343,34,377,377,0,0
41218,2019-11-02,890,0,890,89,979,979,0,0
41219,2019-11-02,603,0,603,48,651,651,0,0
41220,2019-11-02,139,0,139,11,150,150,0,0
41221,2019-11-02,279,0,279,22,301,301,0,0
41222,2019-11-02,603,0,603,60,663,663,0,0
41223,2019-11-02,529,0,529,42,571,571,0,0
41224,2019-11-02,891,0,891,89,980,980,0,0
41225,2019-11-02,891,0,891,89,980,980,0,0
41226,2019-11-02,575,0,575,46,621,621,0,0
41227,2019-11-02,891,0,891,89,980,980,0,0
41228,2019-11-02,528,0,528,42,570,570,0,0
41229,2019-11-02,752,0,752,60,812,812,0,0
41230,2019-11-02,891,0,891,89,980,980,0,0
41231,2019-11-02,1577,0,1577,126,1703,1703,0,0
41232,2019-11-02,232,0,232,18,250,250,0,0
41233,2019-11-02,445,0,445,35,480,480,0,0
41234,2019-11-02,446,0,446,44,490,490,0,0
41235,2019-11-02,898,0,898,89,987,0,0,987
41236,2019-11-02,456,0,456,36,492,492,0,0
41237,2019-11-02,2542,0,2542,254,2796,2796,0,0
41238,2019-11-02,465,0,465,37,502,502,0,0
41239,2019-11-02,408,0,408,32,440,440,0,0
41240,2019-11-02,391,0,391,31,422,422,0,0
41241,2019-11-02,740,0,740,74,814,814,0,0
41242,2019-11-02,1782,0,1782,178,1960,1960,0,0
41243,2019-11-02,353,0,353,28,381,381,0,0
41244,2019-11-02,2429,0,2429,194,2623,0,0,2623
41245,2019-11-02,1782,0,1782,178,1960,1960,0,0
41246,2019-11-02,1751,0,1751,106,1857,0,0,1857
41247,2019-11-02,371,0,371,29,400,400,0,0
41248,2019-11-02,297,0,297,23,320,320,0,0
41249,2019-11-02,725,0,725,58,783,0,0,783
41250,2019-11-02,538,0,538,43,581,581,0,0
41251,2019-11-02,370,0,370,37,407,407,0,0
41252,2019-11-02,891,0,891,89,980,980,0,0
41253,2019-11-02,722,0,722,72,794,794,0,0
41254,2019-11-02,334,0,334,26,360,360,0,0
41255,2019-11-02,1947,0,1947,194,2141,2141,0,0
41256,2019-11-02,891,0,891,89,980,980,0,0
41257,2019-11-02,891,0,891,89,980,980,0,0
41258,2019-11-02,891,0,891,89,980,980,0,0
41259,2019-11-02,502,0,502,50,552,552,0,0
41260,2019-11-02,1889,0,1889,188,2077,2077,0,0
41261,2019-11-02,640,0,640,51,691,691,0,0
41262,2019-11-02,740,0,740,74,814,814,0,0
41263,2019-11-02,900,0,900,72,972,972,0,0
41264,2019-11-02,1195,0,1195,119,1314,1314,0,0
41265,2019-11-02,232,0,232,18,250,250,0,0
41266,2019-11-02,112,0,112,11,123,123,0,0
41267,2019-11-03,315,0,315,25,340,340,0,0
41268,2019-11-03,566,0,566,45,611,611,0,0
41269,2019-11-03,1782,0,1782,178,1960,1960,0,0
41270,2019-11-03,530,0,530,42,572,572,0,0
41271,2019-11-03,1782,0,1782,178,1960,1960,0,0
41272,2019-11-03,604,0,604,48,652,652,0,0
41273,2019-11-03,872,0,872,69,941,941,0,0
41274,2019-11-03,520,0,520,41,561,561,0,0
41275,2019-11-03,336,0,336,26,362,362,0,0
41276,2019-11-03,1782,0,1782,178,1960,1960,0,0
41277,2019-11-03,2015,0,2015,201,2216,2216,0,0
41278,2019-11-03,622,0,622,49,671,671,0,0
41279,2019-11-03,800,0,800,64,864,864,0,0
41280,2019-11-03,1119,0,1119,111,1230,1230,0,0
41281,2019-11-03,371,0,371,29,400,400,0,0
41282,2019-11-03,1782,0,1782,178,1960,0,1960,0
41283,2019-11-03,976,-976,0,0,0,0,0,0
41284,2019-11-03,334,0,334,26,360,360,0,0
41285,2019-11-03,668,-66,602,48,650,0,650,0
41286,2019-11-03,1017,0,1017,101,1118,1118,0,0
41287,2019-11-03,3214,0,3214,321,3535,3535,0,0
41288,2019-11-03,639,0,639,63,702,702,0,0
41289,2019-11-03,753,0,753,75,828,828,0,0
41290,2019-11-03,269,0,269,21,290,290,0,0
41291,2019-11-03,687,0,687,54,741,741,0,0
41292,2019-11-03,362,0,362,28,390,390,0,0
41293,2019-11-03,891,0,891,89,980,980,0,0
41294,2019-11-03,186,0,186,14,200,200,0,0
41295,2019-11-03,7128,0,7128,712,7840,0,7840,0
41296,2019-11-03,186,0,186,14,200,200,0,0
41297,2019-11-03,139,-27,112,8,120,120,0,0
41298,2019-11-03,621,0,621,49,670,670,0,0
41299,2019-11-03,891,0,891,89,980,980,0,0
41300,2019-11-03,649,0,649,64,713,713,0,0
41301,2019-11-03,371,0,371,29,400,400,0,0
41302,2019-11-03,1504,0,1504,120,1624,1624,0,0
41303,2019-11-03,250,0,250,20,270,270,0,0
41304,2019-11-03,789,0,789,63,852,852,0,0
41305,2019-11-03,660,0,660,41,701,701,0,0
41306,2019-11-03,706,0,706,56,762,762,0,0
41307,2019-11-03,1279,0,1279,102,1381,1381,0,0
41308,2019-11-03,1434,0,1434,143,1577,0,0,1577
41309,2019-11-03,871,0,871,87,958,958,0,0
41310,2019-11-03,1283,0,1283,128,1411,0,0,1411
41311,2019-11-03,436,0,436,34,470,470,0,0
41312,2019-11-03,669,0,669,66,735,735,0,0
41313,2019-11-03,446,0,446,44,490,490,0,0
41314,2019-11-03,278,0,278,22,300,300,0,0
41315,2019-11-03,1782,0,1782,178,1960,1960,0,0
41316,2019-11-03,1782,0,1782,178,1960,1960,0,0
41317,2019-11-03,816,0,816,65,881,881,0,0
41318,2019-11-03,112,0,112,8,120,120,0,0
41319,2019-11-03,1022,0,1022,81,1103,1103,0,0
41320,2019-11-03,251,0,251,20,271,271,0,0
41321,2019-11-03,251,0,251,20,271,271,0,0
41322,2019-11-03,721,0,721,72,793,793,0,0
41323,2019-11-03,260,0,260,20,280,280,0,0
41324,2019-11-03,1782,0,1782,178,1960,1960,0,0
41325,2019-11-03,1802,-1500,302,30,332,332,0,0
41326,2019-11-03,473,0,473,37,510,510,0,0
41327,2019-11-03,325,0,325,32,357,357,0,0
41328,2019-11-03,916,0,916,91,1007,1007,0,0
41329,2019-11-03,519,0,519,51,570,570,0,0
41330,2019-11-03,450,0,450,36,486,486,0,0
41331,2019-11-03,370,0,370,29,399,399,0,0
41332,2019-11-03,761,0,761,60,821,821,0,0
41333,2019-11-03,1604,0,1604,160,1764,1764,0,0
41334,2019-11-03,455,0,455,36,491,491,0,0
41335,2019-11-03,1574,0,1574,157,1731,1731,0,0
41336,2019-11-03,214,0,214,17,231,231,0,0
41337,2019-11-03,982,0,982,98,1080,1080,0,0
41338,2019-11-03,1040,0,1040,83,1123,1123,0,0
41339,2019-11-03,1131,0,1131,90,1221,1221,0,0
41340,2019-11-03,769,0,769,76,845,845,0,0
41341,2019-11-03,1389,0,1389,138,1527,1527,0,0
41342,2019-11-03,492,0,492,39,531,531,0,0
41343,2019-11-03,464,0,464,37,501,501,0,0
41344,2019-11-03,399,0,399,39,438,438,0,0
41345,2019-11-03,649,0,649,51,700,700,0,0
41346,2019-11-03,705,0,705,56,761,761,0,0
41347,2019-11-03,1678,0,1678,167,1845,0,1845,0
41348,2019-11-03,473,0,473,37,510,510,0,0
41349,2019-11-03,889,0,889,88,977,0,977,0
41350,2019-11-03,658,0,658,65,723,723,0,0
41351,2019-11-03,1116,0,1116,111,1227,0,0,1227
41352,2019-11-03,539,0,539,53,592,592,0,0
41353,2019-11-03,612,0,612,48,660,660,0,0
41354,2019-11-03,1009,0,1009,100,1109,1109,0,0
41355,2019-11-03,1672,0,1672,153,1825,1825,0,0
41356,2019-11-03,687,0,687,54,741,741,0,0
41357,2019-11-03,362,0,362,28,390,390,0,0
41358,2019-11-03,998,0,998,99,1097,1097,0,0
41359,2019-11-03,1122,0,1122,112,1234,1234,0,0
41360,2019-11-03,112,0,112,8,120,120,0,0
41361,2019-11-03,334,0,334,26,360,360,0,0
41362,2019-11-03,1782,0,1782,178,1960,1960,0,0
41363,2019-11-03,816,0,816,65,881,881,0,0
41364,2019-11-03,688,0,688,55,743,743,0,0
41365,2019-11-03,650,0,650,52,702,702,0,0
41366,2019-11-03,1001,0,1001,80,1081,1081,0,0
41367,2019-11-03,390,0,390,31,421,421,0,0
41368,2019-11-03,676,0,676,67,743,743,0,0
41369,2019-11-03,827,0,827,66,893,893,0,0
41370,2019-11-03,529,0,529,42,571,571,0,0
41371,2019-11-03,603,0,603,60,663,663,0,0
41372,2019-11-03,1003,0,1003,80,1083,1083,0,0
41373,2019-11-03,297,0,297,23,320,320,0,0
41374,2019-11-03,1002,-100,902,90,992,992,0,0
41375,2019-11-03,632,0,632,50,682,682,0,0
41376,2019-11-03,188,0,188,15,203,0,203,0
41377,2019-11-03,788,0,788,78,866,866,0,0
41378,2019-11-03,1191,0,1191,95,1286,1286,0,0
41379,2019-11-03,593,0,593,59,652,652,0,0
41380,2019-11-03,962,0,962,76,1038,1038,0,0
41381,2019-11-03,1785,0,1785,178,1963,0,1963,0
41382,2019-11-03,541,0,541,43,584,584,0,0
41383,2019-11-03,2136,0,2136,213,2349,2349,0,0
41384,2019-11-03,1317,0,1317,131,1448,1448,0,0
41385,2019-11-03,706,0,706,56,762,762,0,0
41386,2019-11-03,436,0,436,34,470,470,0,0
41387,2019-11-03,372,0,372,37,409,409,0,0
41388,2019-11-03,724,0,724,57,781,781,0,0
41389,2019-11-03,484,0,484,38,522,0,0,522
41390,2019-11-03,195,0,195,15,210,210,0,0
41391,2019-11-03,1782,0,1782,178,1960,0,1960,0
41392,2019-11-03,1456,-145,1311,131,1442,1442,0,0
41393,2019-11-03,704,0,704,70,774,774,0,0
41394,2019-11-03,139,0,139,11,150,150,0,0
41395,2019-11-03,1011,-101,910,91,1001,1001,0,0
41396,2019-11-03,780,0,780,62,842,842,0,0
41397,2019-11-03,532,0,532,42,574,574,0,0
41398,2019-11-03,668,0,668,53,721,0,721,0
41399,2019-11-03,141,0,141,11,152,152,0,0
41400,2019-11-03,1058,0,1058,105,1163,1163,0,0
41401,2019-11-03,633,0,633,50,683,683,0,0
41402,2019-11-03,204,0,204,16,220,220,0,0
41403,2019-11-03,448,-89,359,28,387,387,0,0
41404,2019-11-03,1546,0,1546,154,1700,1700,0,0
41405,2019-11-03,773,0,773,77,850,850,0,0
41406,2019-11-03,2319,0,2319,231,2550,0,2550,0
41407,2019-11-03,556,0,556,55,611,611,0,0
41408,2019-11-03,501,0,501,40,541,541,0,0
41409,2019-11-03,594,0,594,59,653,653,0,0
41410,2019-11-03,677,0,677,67,744,744,0,0
41411,2019-11-03,546,0,546,54,600,600,0,0
41412,2019-11-03,880,0,880,88,968,968,0,0
41413,2019-11-03,1076,0,1076,107,1183,1183,0,0
41414,2019-11-03,649,0,649,64,713,713,0,0
41415,2019-11-03,773,0,773,77,850,850,0,0
41416,2019-11-03,167,0,167,13,180,180,0,0
41417,2019-11-03,1623,0,1623,162,1785,1785,0,0
41418,2019-11-03,37,0,37,3,40,40,0,0
41419,2019-11-03,548,0,548,54,602,602,0,0
41420,2019-11-03,492,0,492,39,531,531,0,0
41421,2019-11-03,232,0,232,18,250,250,0,0
41422,2019-11-03,3637,0,3637,363,4000,4000,0,0
41423,2019-11-03,575,0,575,46,621,0,621,0
41424,2019-11-03,446,0,446,35,481,0,481,0
41425,2019-11-03,362,0,362,28,390,0,0,390
41426,2019-11-03,370,0,370,37,407,407,0,0
41427,2019-11-03,204,0,204,16,220,0,0,220
41428,2019-11-03,370,0,370,37,407,0,407,0
41429,2019-11-03,418,0,418,33,451,451,0,0
41430,2019-11-03,511,0,511,40,551,551,0,0
41431,2019-11-03,520,0,520,41,561,561,0,0
41432,2019-11-03,408,0,408,32,440,440,0,0
41433,2019-11-03,520,0,520,41,561,561,0,0
41434,2019-11-03,964,0,964,96,1060,1060,0,0
41435,2019-11-03,306,0,306,24,330,330,0,0
41436,2019-11-03,2319,0,2319,231,2550,2550,0,0
41437,2019-11-03,1140,0,1140,114,1254,0,1254,0
41438,2019-11-03,325,0,325,26,351,351,0,0
41439,2019-11-03,853,0,853,68,921,0,921,0
41440,2019-11-03,677,0,677,54,731,731,0,0
41441,2019-11-03,586,0,586,46,632,632,0,0
41442,2019-11-03,269,0,269,21,290,0,290,0
41443,2019-11-03,687,0,687,54,741,741,0,0
41444,2019-11-03,1269,0,1269,126,1395,1395,0,0
41445,2019-11-03,224,0,224,17,241,241,0,0
41446,2019-11-03,911,0,911,72,983,983,0,0
41447,2019-11-03,121,0,121,9,130,130,0,0
41448,2019-11-03,547,0,547,43,590,0,590,0
41449,2019-11-03,410,0,410,41,451,451,0,0
41450,2019-11-03,81500,0,81500,6520,88020,88020,0,0
41451,2019-11-03,370,0,370,37,407,407,0,0
41452,2019-11-03,1668,0,1668,133,1801,1801,0,0
41453,2019-11-03,371,0,371,37,408,408,0,0
41454,2019-11-03,1372,0,1372,137,1509,1509,0,0
41455,2019-11-03,649,0,649,50,699,699,0,0
41456,2019-11-03,660,0,660,52,712,712,0,0
41457,2019-11-03,1195,0,1195,119,1314,0,1314,0
41458,2019-11-03,806,0,806,80,886,886,0,0
41459,2019-11-03,381,0,381,30,411,0,411,0
41460,2019-11-03,1307,0,1307,130,1437,0,1437,0
41461,2019-11-03,733,0,733,73,806,0,806,0
41462,2019-11-03,353,0,353,28,381,381,0,0
41463,2019-11-03,325,-32,293,23,316,316,0,0
41464,2019-11-03,1778,0,1778,177,1955,1955,0,0
41465,2019-11-03,873,0,873,87,960,960,0,0
41466,2019-11-03,370,0,370,37,407,407,0,0
41467,2019-11-03,740,0,740,74,814,814,0,0
41468,2019-11-03,575,0,575,46,621,621,0,0
41469,2019-11-03,353,0,353,28,381,381,0,0
41470,2019-11-03,232,0,232,18,250,0,250,0
41471,2019-11-03,1066,0,1066,92,1158,1158,0,0
41472,2019-11-03,594,0,594,47,641,641,0,0
41473,2019-11-03,1141,0,1141,91,1232,1232,0,0
41474,2019-11-03,643,0,643,51,694,694,0,0
41475,2019-11-03,473,0,473,37,510,510,0,0
41476,2019-11-03,843,0,843,84,927,927,0,0
41477,2019-11-03,928,0,928,74,1002,1002,0,0
41478,2019-11-03,270,0,270,21,291,291,0,0
41479,2019-11-03,334,0,334,26,360,360,0,0
41480,2019-11-03,779,-77,702,56,758,758,0,0
41481,2019-11-03,816,0,816,65,881,0,881,0
41482,2019-11-03,974,0,974,97,1071,1071,0,0
41483,2019-11-03,603,0,603,48,651,0,651,0
41484,2019-11-03,370,0,370,37,407,407,0,0
41485,2019-11-03,1139,0,1139,113,1252,0,0,1252
41486,2019-11-03,325,0,325,26,351,0,351,0
41487,2019-11-03,1546,0,1546,154,1700,1700,0,0
41488,2019-11-03,455,0,455,36,491,491,0,0
41489,2019-11-03,707,0,707,56,763,763,0,0
41490,2019-11-03,1141,0,1141,91,1232,1232,0,0
41491,2019-11-03,1546,-154,1392,139,1531,1531,0,0
41492,2019-11-03,3092,0,3092,309,3401,0,0,3401
41493,2019-11-03,1819,0,1819,181,2000,0,0,2000
41494,2019-11-03,530,0,530,53,583,583,0,0
41495,2019-11-03,843,0,843,67,910,910,0,0
41496,2019-11-03,2340,0,2340,176,2516,0,2516,0
41497,2019-11-03,843,0,843,67,910,910,0,0
41498,2019-11-03,594,0,594,47,641,641,0,0
41499,2019-11-03,816,0,816,81,897,897,0,0
41500,2019-11-03,556,0,556,44,600,600,0,0
41501,2019-11-03,1546,-1500,46,4,50,50,0,0
41502,2019-11-03,139,0,139,13,152,152,0,0
41503,2019-11-03,1807,0,1807,180,1987,1987,0,0
41504,2019-11-03,1177,0,1177,94,1271,0,0,1271
41505,2019-11-03,500,0,500,50,550,550,0,0
41506,2019-11-03,734,0,734,58,792,792,0,0
41507,2019-11-03,482,0,482,38,520,520,0,0
41508,2019-11-03,389,0,389,38,427,427,0,0
41509,2019-11-03,139,0,139,11,150,150,0,0
41510,2019-11-03,1371,0,1371,109,1480,1480,0,0
41511,2019-11-03,773,0,773,77,850,850,0,0
41512,2019-11-03,773,0,773,77,850,850,0,0
41513,2019-11-03,773,0,773,77,850,850,0,0
41514,2019-11-03,278,0,278,22,300,300,0,0
41515,2019-11-04,520,0,520,41,561,561,0,0
41516,2019-11-04,1428,0,1428,142,1570,1570,0,0
41517,2019-11-04,668,0,668,53,721,721,0,0
41518,2019-11-04,269,0,269,21,290,0,290,0
41519,2019-11-04,723,0,723,72,795,0,795,0
41520,2019-11-04,994,0,994,79,1073,1073,0,0
41521,2019-11-04,686,0,686,54,740,740,0,0
41522,2019-11-04,632,0,632,50,682,682,0,0
41523,2019-11-04,576,0,576,46,622,622,0,0
41524,2019-11-04,1834,0,1834,183,2017,2017,0,0
41525,2019-11-04,306,0,306,24,330,330,0,0
41526,2019-11-04,538,0,538,43,581,581,0,0
41527,2019-11-04,912,0,912,77,989,989,0,0
41528,2019-11-04,937,0,937,74,1011,1011,0,0
41529,2019-11-04,325,0,325,26,351,0,351,0
41530,2019-11-04,1782,0,1782,178,1960,1960,0,0
41531,2019-11-04,408,0,408,32,440,440,0,0
41532,2019-11-04,852,0,852,85,937,0,937,0
41533,2019-11-04,740,0,740,74,814,814,0,0
41534,2019-11-04,641,0,641,51,692,692,0,0
41535,2019-11-04,1110,0,1110,111,1221,1221,0,0
41536,2019-11-04,511,0,511,40,551,551,0,0
41537,2019-11-04,186,0,186,14,200,200,0,0
41538,2019-11-04,1921,0,1921,153,2074,2074,0,0
41539,2019-11-04,640,0,640,51,691,691,0,0
41540,2019-11-04,778,0,778,77,855,855,0,0
41541,2019-11-04,705,0,705,56,761,761,0,0
41542,2019-11-04,437,0,437,34,471,471,0,0
41543,2019-11-04,269,0,269,21,290,290,0,0
41544,2019-11-04,891,0,891,89,980,980,0,0
41545,2019-11-04,891,0,891,89,980,980,0,0
41546,2019-11-04,993,0,993,99,1092,1092,0,0
41547,2019-11-04,455,0,455,36,491,0,0,491
41548,2019-11-04,149,0,149,11,160,160,0,0
41549,2019-11-04,1782,0,1782,178,1960,0,0,1960
41550,2019-11-04,307,-30,277,22,299,299,0,0
41551,2019-11-04,362,0,362,28,390,390,0,0
41552,2019-11-04,195,0,195,15,210,210,0,0
41553,2019-11-04,472,0,472,47,519,519,0,0
41554,2019-11-04,649,0,649,51,700,700,0,0
41555,2019-11-04,278,0,278,22,300,300,0,0
41556,2019-11-04,176,-35,141,11,152,152,0,0
41557,2019-11-04,1084,0,1084,108,1192,1192,0,0
41558,2019-11-04,994,0,994,79,1073,0,0,1073
41559,2019-11-04,798,0,798,79,877,877,0,0
41560,2019-11-04,1084,0,1084,108,1192,1192,0,0
41561,2019-11-04,372,0,372,29,401,0,401,0
41562,2019-11-04,798,0,798,79,877,877,0,0
41563,2019-11-04,668,0,668,53,721,721,0,0
41564,2019-11-04,260,0,260,20,280,280,0,0
41565,2019-11-04,1012,0,1012,101,1113,0,0,1113
41566,2019-11-04,909,-90,819,81,900,900,0,0
41567,2019-11-04,501,0,501,40,541,541,0,0
41568,2019-11-04,853,0,853,68,921,921,0,0
41569,2019-11-04,371,0,371,29,400,0,400,0
41570,2019-11-04,364,0,364,17,381,381,0,0
41571,2019-11-04,399,0,399,31,430,430,0,0
41572,2019-11-04,139,0,139,13,152,152,0,0
41573,2019-11-04,891,0,891,89,980,980,0,0
41574,2019-11-04,816,0,816,81,897,897,0,0
41575,2019-11-04,269,0,269,21,290,290,0,0
41576,2019-11-04,891,0,891,89,980,980,0,0
41577,2019-11-04,389,0,389,31,420,0,0,420
41578,2019-11-04,389,0,389,31,420,420,0,0
41579,2019-11-04,1068,0,1068,74,1142,1142,0,0
41580,2019-11-04,1256,0,1256,125,1381,1381,0,0
41581,2019-11-04,409,0,409,32,441,0,441,0
41582,2019-11-04,687,-68,619,49,668,668,0,0
41583,2019-11-04,121,0,121,9,130,0,130,0
41584,2019-11-04,1886,0,1886,188,2074,2074,0,0
41585,2019-11-04,389,0,389,38,427,427,0,0
41586,2019-11-04,1109,0,1109,88,1197,1197,0,0
41587,2019-11-04,773,0,773,77,850,850,0,0
41588,2019-11-04,773,0,773,77,850,850,0,0
41589,2019-11-04,773,0,773,77,850,850,0,0
41590,2019-11-04,773,0,773,77,850,0,0,850
41591,2019-11-04,964,0,964,77,1041,1041,0,0
41592,2019-11-04,232,0,232,18,250,0,0,250
41593,2019-11-04,1547,0,1547,154,1701,1701,0,0
41594,2019-11-04,773,0,773,77,850,850,0,0
41595,2019-11-04,1581,0,1581,126,1707,1707,0,0
41596,2019-11-04,492,0,492,39,531,531,0,0
41597,2019-11-04,362,0,362,28,390,0,390,0
41598,2019-11-04,389,0,389,38,427,427,0,0
41599,2019-11-04,1234,0,1234,98,1332,1332,0,0
41600,2019-11-04,-773,0,-773,-77,-850,-850,0,0
41601,2019-11-04,344,0,344,27,371,371,0,0
41602,2019-11-04,1067,0,1067,106,1173,1173,0,0
41603,2019-11-04,250,0,250,20,270,270,0,0
41604,2019-11-04,937,0,937,93,1030,0,1030,0
41605,2019-11-04,306,0,306,24,330,330,0,0
41606,2019-11-04,1205,0,1205,96,1301,1301,0,0
41607,2019-11-04,167,0,167,13,180,180,0,0
41608,2019-11-04,315,0,315,25,340,340,0,0
41609,2019-11-04,232,0,232,18,250,250,0,0
41610,2019-11-04,5770,0,5770,461,6231,6231,0,0
41611,2019-11-04,334,0,334,26,360,360,0,0
41612,2019-11-04,260,0,260,20,280,280,0,0
41613,2019-11-04,863,0,863,69,932,932,0,0
41614,2019-11-04,436,0,436,34,470,470,0,0
41615,2019-11-04,520,0,520,41,561,561,0,0
41616,2019-11-04,418,0,418,33,451,451,0,0
41617,2019-11-04,1270,0,1270,127,1397,1397,0,0
41618,2019-11-04,436,0,436,34,470,470,0,0
41619,2019-11-04,1546,0,1546,154,1700,1700,0,0
41620,2019-11-04,2092,0,2092,209,2301,2301,0,0
41621,2019-11-04,773,0,773,77,850,850,0,0
41622,2019-11-04,278,0,278,27,305,305,0,0
41623,2019-11-04,1725,0,1725,172,1897,1897,0,0
41624,2019-11-04,362,0,362,28,390,390,0,0
41625,2019-11-04,1298,0,1298,129,1427,0,1427,0
41626,2019-11-04,306,0,306,24,330,330,0,0
41627,2019-11-04,1546,0,1546,154,1700,0,1700,0
41628,2019-11-04,389,0,389,38,427,427,0,0
41629,2019-11-04,1962,0,1962,196,2158,2158,0,0
41630,2019-11-04,260,0,260,20,280,280,0,0
41631,2019-11-04,2673,-267,2406,240,2646,2646,0,0
41632,2019-11-04,492,0,492,35,527,527,0,0
41633,2019-11-04,436,0,436,34,470,470,0,0
41634,2019-11-04,567,0,567,56,623,623,0,0
41635,2019-11-04,501,0,501,50,551,551,0,0
41636,2019-11-04,530,0,530,53,583,583,0,0
41637,2019-11-04,538,0,538,53,591,591,0,0
41638,2019-11-04,1214,0,1214,97,1311,0,0,1311
41639,2019-11-04,158,0,158,15,173,173,0,0
41640,2019-11-04,1974,0,1974,197,2171,2171,0,0
41641,2019-11-04,1546,0,1546,154,1700,1700,0,0
41642,2019-11-04,594,0,594,47,641,641,0,0
41643,2019-11-04,391,0,391,31,422,422,0,0
41644,2019-11-04,417,0,417,41,458,458,0,0
41645,2019-11-04,139,0,139,11,150,150,0,0
41646,2019-11-04,472,0,472,47,519,519,0,0
41647,2019-11-04,464,0,464,37,501,501,0,0
41648,2019-11-04,362,0,362,28,390,390,0,0
41649,2019-11-04,670,0,670,53,723,723,0,0
41650,2019-11-04,1400,0,1400,140,1540,1540,0,0
41651,2019-11-04,520,0,520,41,561,561,0,0
41652,2019-11-04,269,0,269,21,290,290,0,0
41653,2019-11-04,1269,0,1269,126,1395,1395,0,0
41654,2019-11-04,556,0,556,44,600,600,0,0
41655,2019-11-04,668,0,668,53,721,721,0,0
41656,2019-11-05,491,0,491,49,540,540,0,0
41657,2019-11-05,167,0,167,16,183,183,0,0
41658,2019-11-05,658,0,658,65,723,723,0,0
41659,2019-11-05,1139,0,1139,113,1252,1252,0,0
41660,2019-11-05,214,0,214,21,235,235,0,0
41661,2019-11-05,279,0,279,27,306,306,0,0
41662,2019-11-05,501,0,501,50,551,551,0,0
41663,2019-11-05,381,0,381,38,419,419,0,0
41664,2019-11-05,334,0,334,33,367,367,0,0
41665,2019-11-05,370,0,370,37,407,407,0,0
41666,2019-11-05,260,0,260,20,280,0,280,0
41667,2019-11-05,260,0,260,20,280,280,0,0
41668,2019-11-05,1299,0,1299,129,1428,1428,0,0
41669,2019-11-05,2009,0,2009,200,2209,2209,0,0
41670,2019-11-05,476,0,476,38,514,514,0,0
41671,2019-11-05,1121,0,1121,112,1233,1233,0,0
41672,2019-11-05,-491,0,-491,-39,-530,-530,0,0
41673,2019-11-05,269,0,269,21,290,290,0,0
41674,2019-11-05,188,0,188,15,203,203,0,0
41675,2019-11-05,334,0,334,26,360,360,0,0
41676,2019-11-05,343,0,343,27,370,370,0,0
41677,2019-11-05,223,0,223,17,240,240,0,0
41678,2019-11-05,139,0,139,11,150,150,0,0
41679,2019-11-05,400,0,400,40,440,440,0,0
41680,2019-11-05,389,0,389,38,427,427,0,0
41681,2019-11-05,2419,0,2419,193,2612,2612,0,0
41682,2019-11-05,436,0,436,34,470,470,0,0
41683,2019-11-05,1451,0,1451,116,1567,1567,0,0
41684,2019-11-05,853,0,853,68,921,921,0,0
41685,2019-11-05,316,0,316,25,341,341,0,0
41686,2019-11-05,1827,0,1827,182,2009,2009,0,0
41687,2019-11-05,658,0,658,52,710,710,0,0
41688,2019-11-05,658,0,658,52,710,710,0,0
41689,2019-11-05,798,0,798,79,877,877,0,0
41690,2019-11-05,-658,0,-658,-52,-710,-710,0,0
41691,2019-11-06,584,0,584,46,630,630,0,0
41692,2019-11-06,676,0,676,67,743,743,0,0
41693,2019-11-06,372,0,372,29,401,401,0,0
41694,2019-11-06,528,0,528,52,580,580,0,0
41695,2019-11-06,556,0,556,55,611,611,0,0
41696,2019-11-06,344,0,344,27,371,371,0,0
41697,2019-11-06,798,0,798,63,861,861,0,0
41698,2019-11-06,687,0,687,54,741,0,741,0
41699,2019-11-06,2472,0,2472,197,2669,2669,0,0
41700,2019-11-06,176,0,176,14,190,190,0,0
41701,2019-11-06,668,0,668,53,721,721,0,0
41702,2019-11-06,418,0,418,33,451,0,0,451
41703,2019-11-06,1466,0,1466,117,1583,1583,0,0
41704,2019-11-06,891,0,891,89,980,980,0,0
41705,2019-11-06,260,0,260,20,280,280,0,0
41706,2019-11-06,1782,0,1782,178,1960,1960,0,0
41707,2019-11-06,251,0,251,20,271,271,0,0
41708,2019-11-06,510,0,510,40,550,550,0,0
41709,2019-11-06,722,0,722,72,794,794,0,0
41710,2019-11-06,315,0,315,25,340,340,0,0
41711,2019-11-06,315,0,315,25,340,340,0,0
41712,2019-11-06,856,0,856,68,924,924,0,0
41713,2019-11-06,1422,0,1422,113,1535,1535,0,0
41714,2019-11-06,1493,0,1493,119,1612,1612,0,0
41715,2019-11-06,1153,0,1153,92,1245,1245,0,0
41716,2019-11-06,605,0,605,48,653,653,0,0
41717,2019-11-06,937,0,937,74,1011,1011,0,0
41718,2019-11-06,1365,0,1365,109,1474,0,1474,0
41719,2019-11-06,454,0,454,36,490,0,490,0
41720,2019-11-06,371,0,371,29,400,400,0,0
41721,2019-11-06,376,-37,339,27,366,0,366,0
41722,2019-11-06,1952,0,1952,195,2147,2147,0,0
41723,2019-11-06,1133,0,1133,90,1223,0,1223,0
41724,2019-11-06,399,0,399,31,430,0,430,0
41725,2019-11-06,215,0,215,17,232,232,0,0
41726,2019-11-06,1196,0,1196,119,1315,1315,0,0
41727,2019-11-06,242,0,242,24,266,266,0,0
41728,2019-11-06,641,0,641,51,692,692,0,0
41729,2019-11-06,811,0,811,64,875,875,0,0
41730,2019-11-06,439,0,439,35,474,474,0,0
41731,2019-11-06,1231,0,1231,123,1354,1354,0,0
41732,2019-11-06,1335,0,1335,133,1468,1468,0,0
41733,2019-11-06,695,0,695,69,764,764,0,0
41734,2019-11-06,488,0,488,39,527,527,0,0
41735,2019-11-06,260,0,260,20,280,280,0,0
41736,2019-11-06,628,0,628,62,690,690,0,0
41737,2019-11-06,891,0,891,89,980,980,0,0
41738,2019-11-06,900,0,900,72,972,972,0,0
41739,2019-11-06,232,0,232,18,250,250,0,0
41740,2019-11-06,808,-80,728,58,786,786,0,0
41741,2019-11-06,1256,0,1256,125,1381,0,1381,0
41742,2019-11-06,116,0,116,9,125,125,0,0
41743,2019-11-06,260,0,260,20,280,0,280,0
41744,2019-11-06,417,0,417,33,450,450,0,0
41745,2019-11-06,529,0,529,42,571,571,0,0
41746,2019-11-06,334,0,334,33,367,367,0,0
41747,2019-11-06,502,0,502,40,542,0,542,0
41748,2019-11-06,548,0,548,43,591,591,0,0
41749,2019-11-06,1596,0,1596,127,1723,1723,0,0
41750,2019-11-06,399,0,399,31,430,0,430,0
41751,2019-11-06,1372,0,1372,109,1481,1481,0,0
41752,2019-11-06,370,0,370,37,407,407,0,0
41753,2019-11-06,676,0,676,67,743,743,0,0
41754,2019-11-06,556,0,556,55,611,611,0,0
41755,2019-11-06,844,0,844,84,928,928,0,0
41756,2019-11-06,773,0,773,77,850,850,0,0
41757,2019-11-06,1225,0,1225,98,1323,1323,0,0
41758,2019-11-06,2092,0,2092,209,2301,2301,0,0
41759,2019-11-06,565,0,565,45,610,610,0,0
41760,2019-11-06,484,0,484,16,500,500,0,0
41761,2019-11-06,1403,0,1403,140,1543,0,1543,0
41762,2019-11-06,380,0,380,30,410,410,0,0
41763,2019-11-06,269,0,269,21,290,290,0,0
41764,2019-11-06,834,0,834,83,917,917,0,0
41765,2019-11-06,273,0,273,27,300,300,0,0
41766,2019-11-06,1191,0,1191,119,1310,1310,0,0
41767,2019-11-06,455,0,455,36,491,491,0,0
41768,2019-11-06,362,0,362,28,390,390,0,0
41769,2019-11-06,362,0,362,28,390,390,0,0
41770,2019-11-06,362,0,362,28,390,390,0,0
41771,2019-11-06,250,0,250,20,270,270,0,0
41772,2019-11-06,773,0,773,77,850,850,0,0
41773,2019-11-06,1270,0,1270,127,1397,1397,0,0
41774,2019-11-06,1546,0,1546,154,1700,1700,0,0
41775,2019-11-06,1520,0,1520,152,1672,1672,0,0
41776,2019-11-06,370,0,370,37,407,407,0,0
41777,2019-11-06,492,0,492,39,531,531,0,0
41778,2019-11-06,204,0,204,20,224,224,0,0
41779,2019-11-06,773,0,773,77,850,850,0,0
41780,2019-11-06,891,-89,802,64,866,866,0,0
41781,2019-11-06,1068,0,1068,85,1153,1153,0,0
41782,2019-11-06,872,0,872,69,941,941,0,0
41783,2019-11-06,640,0,640,64,704,704,0,0
41784,2019-11-06,612,0,612,48,660,660,0,0
41785,2019-11-06,740,0,740,74,814,814,0,0
41786,2019-11-06,676,0,676,67,743,743,0,0
41787,2019-11-06,269,0,269,21,290,290,0,0
41788,2019-11-06,695,0,695,69,764,0,764,0
41789,2019-11-06,538,0,538,53,591,591,0,0
41790,2019-11-06,2032,0,2032,162,2194,2194,0,0
41791,2019-11-06,343,0,343,27,370,370,0,0
41792,2019-11-06,345,0,345,27,372,372,0,0
41793,2019-11-06,1782,0,1782,178,1960,0,1960,0
41794,2019-11-06,687,0,687,54,741,741,0,0
41795,2019-11-06,491,0,491,49,540,540,0,0
41796,2019-11-06,242,0,242,10,252,0,0,252
41797,2019-11-06,176,-35,141,11,152,152,0,0
41798,2019-11-06,261,0,261,20,281,281,0,0
41799,2019-11-06,992,0,992,79,1071,1071,0,0
41800,2019-11-06,576,0,576,46,622,0,622,0
41801,2019-11-06,620,0,620,62,682,682,0,0
41802,2019-11-06,269,0,269,21,290,290,0,0
41803,2019-11-06,566,0,566,45,611,611,0,0
41804,2019-11-06,872,0,872,73,945,945,0,0
41805,2019-11-06,1782,0,1782,178,1960,1960,0,0
41806,2019-11-06,772,-77,695,55,750,750,0,0
41807,2019-11-06,1325,0,1325,106,1431,1431,0,0
41808,2019-11-06,1132,0,1132,90,1222,1222,0,0
41809,2019-11-07,288,0,288,23,311,311,0,0
41810,2019-11-07,511,0,511,40,551,551,0,0
41811,2019-11-07,482,0,482,38,520,0,520,0
41812,2019-11-07,1174,0,1174,117,1291,0,1291,0
41813,2019-11-07,353,0,353,28,381,381,0,0
41814,2019-11-07,204,0,204,16,220,220,0,0
41815,2019-11-07,102,0,102,8,110,110,0,0
41816,2019-11-07,288,0,288,28,316,0,316,0
41817,2019-11-07,1782,0,1782,178,1960,1960,0,0
41818,2019-11-07,891,0,891,89,980,980,0,0
41819,2019-11-07,121,0,121,9,130,130,0,0
41820,2019-11-07,539,0,539,43,582,582,0,0
41821,2019-11-07,1012,0,1012,80,1092,1092,0,0
41822,2019-11-07,891,0,891,89,980,980,0,0
41823,2019-11-07,511,0,511,40,551,551,0,0
41824,2019-11-07,677,0,677,54,731,731,0,0
41825,2019-11-07,995,0,995,79,1074,1074,0,0
41826,2019-11-07,667,0,667,66,733,733,0,0
41827,2019-11-07,891,0,891,89,980,980,0,0
41828,2019-11-07,1334,0,1334,106,1440,1440,0,0
41829,2019-11-07,603,0,603,48,651,651,0,0
41830,2019-11-07,427,0,427,34,461,461,0,0
41831,2019-11-07,1865,-186,1679,134,1813,0,1813,0
41832,2019-11-07,482,0,482,38,520,520,0,0
41833,2019-11-07,634,0,634,50,684,684,0,0
41834,2019-11-07,697,0,697,55,752,0,752,0
41835,2019-11-07,362,0,362,28,390,390,0,0
41836,2019-11-07,658,0,658,65,723,723,0,0
41837,2019-11-07,1299,0,1299,103,1402,1402,0,0
41838,2019-11-07,521,0,521,41,562,562,0,0
41839,2019-11-07,232,0,232,18,250,250,0,0
41840,2019-11-07,891,-89,802,80,882,882,0,0
41841,2019-11-07,918,0,918,73,991,991,0,0
41842,2019-11-07,446,0,446,35,481,481,0,0
41843,2019-11-07,615,0,615,49,664,0,0,664
41844,2019-11-07,707,0,707,56,763,763,0,0
41845,2019-11-07,629,0,629,50,679,679,0,0
41846,2019-11-07,334,0,334,26,360,360,0,0
41847,2019-11-07,306,0,306,24,330,330,0,0
41848,2019-11-07,112,0,112,8,120,120,0,0
41849,2019-11-07,825,0,825,82,907,907,0,0
41850,2019-11-07,659,0,659,52,711,711,0,0
41851,2019-11-07,622,0,622,49,671,671,0,0
41852,2019-11-07,882,0,882,70,952,952,0,0
41853,2019-11-07,520,0,520,41,561,561,0,0
41854,2019-11-07,1120,0,1120,89,1209,0,0,1209
41855,2019-11-07,622,0,622,62,684,684,0,0
41856,2019-11-07,454,0,454,45,499,499,0,0
41857,2019-11-07,473,0,473,47,520,520,0,0
41858,2019-11-07,585,0,585,46,631,631,0,0
41859,2019-11-07,1126,0,1126,90,1216,0,0,1216
41860,2019-11-07,845,0,845,67,912,0,912,0
41861,2019-11-07,557,0,557,44,601,601,0,0
41862,2019-11-07,603,0,603,48,651,651,0,0
41863,2019-11-07,530,0,530,42,572,572,0,0
41864,2019-11-07,446,0,446,35,481,481,0,0
41865,2019-11-07,1782,0,1782,178,1960,1960,0,0
41866,2019-11-07,687,0,687,54,741,741,0,0
41867,2019-11-07,640,0,640,64,704,704,0,0
41868,2019-11-07,381,0,381,30,411,411,0,0
41869,2019-11-07,371,0,371,29,400,0,400,0
41870,2019-11-07,473,0,473,37,510,510,0,0
41871,2019-11-07,482,0,482,38,520,520,0,0
41872,2019-11-07,640,0,640,51,691,0,691,0
41873,2019-11-07,288,0,288,23,311,311,0,0
41874,2019-11-07,269,0,269,21,290,290,0,0
41875,2019-11-07,4016,0,4016,401,4417,0,4417,0
41876,2019-11-07,427,0,427,34,461,0,461,0
41877,2019-11-07,577,0,577,46,623,623,0,0
41878,2019-11-07,691,0,691,55,746,746,0,0
41879,2019-11-07,556,0,556,44,600,600,0,0
41880,2019-11-07,195,0,195,15,210,210,0,0
41881,2019-11-07,408,0,408,32,440,440,0,0
41882,2019-11-07,370,0,370,37,407,407,0,0
41883,2019-11-07,371,0,371,29,400,400,0,0
41884,2019-11-07,362,0,362,28,390,390,0,0
41885,2019-11-07,517,0,517,51,568,568,0,0
41886,2019-11-07,307,0,307,24,331,331,0,0
41887,2019-11-07,362,0,362,28,390,390,0,0
41888,2019-11-07,116,0,116,9,125,0,0,125
41889,2019-11-07,279,0,279,22,301,301,0,0
41890,2019-11-07,789,0,789,63,852,852,0,0
41891,2019-11-07,724,0,724,57,781,781,0,0
41892,2019-11-07,761,0,761,62,823,823,0,0
41893,2019-11-07,713,0,713,57,770,0,770,0
41894,2019-11-07,389,0,389,31,420,420,0,0
41895,2019-11-07,761,-76,685,54,739,739,0,0
41896,2019-11-07,464,0,464,37,501,501,0,0
41897,2019-11-07,149,0,149,14,163,163,0,0
41898,2019-11-07,491,0,491,49,540,540,0,0
41899,2019-11-07,769,0,769,76,845,845,0,0
41900,2019-11-07,1150,0,1150,115,1265,1265,0,0
41901,2019-11-07,982,0,982,98,1080,1080,0,0
41902,2019-11-07,112,0,112,11,123,123,0,0
41903,2019-11-07,735,0,735,58,793,793,0,0
41904,2019-11-07,343,0,343,34,377,377,0,0
41905,2019-11-07,204,0,204,16,220,220,0,0
41906,2019-11-07,102,0,102,8,110,110,0,0
41907,2019-11-07,260,0,260,20,280,280,0,0
41908,2019-11-07,873,0,873,69,942,942,0,0
41909,2019-11-07,474,0,474,37,511,511,0,0
41910,2019-11-07,491,0,491,49,540,540,0,0
41911,2019-11-07,491,0,491,49,540,540,0,0
41912,2019-11-07,399,0,399,39,438,438,0,0
41913,2019-11-07,993,0,993,99,1092,1092,0,0
41914,2019-11-07,3249,0,3249,324,3573,3573,0,0
41915,2019-11-07,370,0,370,37,407,407,0,0
41916,2019-11-07,881,0,881,70,951,951,0,0
41917,2019-11-07,1546,0,1546,154,1700,0,0,1700
41918,2019-11-07,273,0,273,27,300,0,0,300
41919,2019-11-07,307,0,307,24,331,331,0,0
41920,2019-11-07,584,0,584,46,630,630,0,0
41921,2019-11-07,854,0,854,68,922,0,922,0
41922,2019-11-07,835,0,835,66,901,0,901,0
41923,2019-11-07,520,0,520,41,561,561,0,0
41924,2019-11-07,334,0,334,26,360,360,0,0
41925,2019-11-07,1058,0,1058,84,1142,1142,0,0
41926,2019-11-07,891,0,891,89,980,980,0,0
41927,2019-11-07,891,0,891,89,980,980,0,0
41928,2019-11-07,891,0,891,89,980,980,0,0
41929,2019-11-07,799,0,799,63,862,862,0,0
41930,2019-11-07,1546,0,1546,154,1700,1700,0,0
41931,2019-11-07,372,0,372,29,401,401,0,0
41932,2019-11-07,773,0,773,77,850,850,0,0
41933,2019-11-07,594,0,594,47,641,641,0,0
41934,2019-11-07,556,0,556,44,600,600,0,0
41935,2019-11-07,1985,0,1985,158,2143,2143,0,0
41936,2019-11-07,882,0,882,70,952,952,0,0
41937,2019-11-07,352,0,352,28,380,380,0,0
41938,2019-11-07,1852,0,1852,185,2037,2037,0,0
41939,2019-11-07,325,0,325,26,351,351,0,0
41940,2019-11-07,1546,0,1546,154,1700,1700,0,0
41941,2019-11-07,773,0,773,77,850,850,0,0
41942,2019-11-07,773,0,773,77,850,850,0,0
41943,2019-11-07,773,0,773,77,850,850,0,0
41944,2019-11-07,1615,0,1615,129,1744,1744,0,0
41945,2019-11-07,1546,0,1546,154,1700,0,1700,0
41946,2019-11-07,773,0,773,77,850,850,0,0
41947,2019-11-07,773,0,773,77,850,0,850,0
41948,2019-11-07,1326,-265,1061,84,1145,1145,0,0
41949,2019-11-07,773,0,773,77,850,850,0,0
41950,2019-11-07,426,0,426,34,460,460,0,0
41951,2019-11-08,1017,0,1017,101,1118,1118,0,0
41952,2019-11-08,362,0,362,28,390,0,0,390
41953,2019-11-08,761,0,761,60,821,821,0,0
41954,2019-11-08,2560,0,2560,256,2816,2816,0,0
41955,2019-11-08,1782,0,1782,178,1960,1960,0,0
41956,2019-11-08,724,0,724,72,796,796,0,0
41957,2019-11-08,362,0,362,28,390,390,0,0
41958,2019-11-08,500,-50,450,36,486,486,0,0
41959,2019-11-08,594,-59,535,42,577,577,0,0
41960,2019-11-08,875,0,875,87,962,0,962,0
41961,2019-11-08,167,0,167,13,180,180,0,0
41962,2019-11-08,1114,0,1114,89,1203,1203,0,0
41963,2019-11-08,436,0,436,34,470,470,0,0
41964,2019-11-08,370,0,370,29,399,399,0,0
41965,2019-11-08,687,0,687,54,741,741,0,0
41966,2019-11-08,891,0,891,71,962,0,0,962
41967,2019-11-08,429,0,429,34,463,463,0,0
41968,2019-11-08,278,0,278,22,300,300,0,0
41969,2019-11-08,334,0,334,33,367,367,0,0
41970,2019-11-08,260,0,260,20,280,280,0,0
41971,2019-11-08,713,0,713,71,784,784,0,0
41972,2019-11-08,3488,0,3488,267,3755,0,3755,0
41973,2019-11-08,390,0,390,31,421,421,0,0
41974,2019-11-08,1058,0,1058,84,1142,1142,0,0
41975,2019-11-08,919,0,919,73,992,992,0,0
41976,2019-11-08,292,0,292,23,315,315,0,0
41977,2019-11-08,630,0,630,63,693,693,0,0
41978,2019-11-08,1196,0,1196,95,1291,1291,0,0
41979,2019-11-08,1030,0,1030,82,1112,1112,0,0
41980,2019-11-08,1265,0,1265,90,1355,1355,0,0
41981,2019-11-08,714,0,714,57,771,771,0,0
41982,2019-11-08,1399,0,1399,139,1538,1538,0,0
41983,2019-11-08,534,0,534,42,576,576,0,0
41984,2019-11-08,594,0,594,47,641,641,0,0
41985,2019-11-08,938,0,938,75,1013,1013,0,0
41986,2019-11-08,2999,0,2999,239,3238,0,0,3238
41987,2019-11-08,762,0,762,60,822,822,0,0
41988,2019-11-08,1097,0,1097,109,1206,1206,0,0
41989,2019-11-08,519,0,519,41,560,560,0,0
41990,2019-11-08,1601,0,1601,160,1761,1761,0,0
41991,2019-11-08,484,0,484,48,532,532,0,0
41992,2019-11-08,891,0,891,89,980,980,0,0
41993,2019-11-08,167,0,167,16,183,183,0,0
41994,2019-11-08,269,-26,243,19,262,262,0,0
41995,2019-11-08,1232,0,1232,98,1330,1330,0,0
41996,2019-11-08,167,0,167,13,180,180,0,0
41997,2019-11-08,445,0,445,35,480,480,0,0
41998,2019-11-08,760,0,760,76,836,836,0,0
41999,2019-11-08,595,0,595,47,642,642,0,0
42000,2019-11-08,762,0,762,60,822,822,0,0
42001,2019-11-08,622,0,622,49,671,671,0,0
42002,2019-11-08,632,0,632,50,682,682,0,0
42003,2019-11-08,1722,0,1722,172,1894,1894,0,0
42004,2019-11-08,770,0,770,61,831,831,0,0
42005,2019-11-08,139,0,139,13,152,152,0,0
42006,2019-11-08,947,0,947,80,1027,1027,0,0
42007,2019-11-08,603,0,603,48,651,651,0,0
42008,2019-11-08,1139,0,1139,113,1252,1252,0,0
42009,2019-11-08,242,0,242,19,261,261,0,0
42010,2019-11-08,547,0,547,43,590,590,0,0
42011,2019-11-08,269,0,269,21,290,0,0,290
42012,2019-11-08,167,0,167,13,180,180,0,0
42013,2019-11-08,233,0,233,18,251,251,0,0
42014,2019-11-08,1202,0,1202,96,1298,1298,0,0
42015,2019-11-08,149,0,149,11,160,160,0,0
42016,2019-11-08,353,0,353,28,381,381,0,0
42017,2019-11-08,334,0,334,26,360,360,0,0
42018,2019-11-08,1519,0,1519,151,1670,0,1670,0
42019,2019-11-08,-491,0,-491,-39,-530,-530,0,0
42020,2019-11-08,510,0,510,40,550,0,550,0
42021,2019-11-08,1251,0,1251,125,1376,0,1376,0
42022,2019-11-08,204,0,204,16,220,220,0,0
42023,2019-11-08,501,0,501,50,551,551,0,0
42024,2019-11-08,102,0,102,8,110,110,0,0
42025,2019-11-08,261,0,261,26,287,287,0,0
42026,2019-11-08,1997,0,1997,199,2196,2196,0,0
42027,2019-11-08,873,0,873,69,942,942,0,0
42028,2019-11-08,891,0,891,89,980,0,0,980
42029,2019-11-08,834,0,834,83,917,0,917,0
42030,2019-11-08,167,0,167,16,183,183,0,0
42031,2019-11-08,214,0,214,17,231,231,0,0
42032,2019-11-08,1196,0,1196,119,1315,1315,0,0
42033,2019-11-08,139,0,139,11,150,150,0,0
42034,2019-11-08,139,0,139,11,150,150,0,0
42035,2019-11-08,1482,0,1482,148,1630,1630,0,0
42036,2019-11-08,149,0,149,11,160,160,0,0
42037,2019-11-08,751,0,751,60,811,811,0,0
42038,2019-11-08,50,0,50,4,54,54,0,0
42039,2019-11-08,1508,0,1508,150,1658,0,1658,0
42040,2019-11-08,-1508,0,-1508,-150,-1658,0,-1658,0
42041,2019-11-08,891,0,891,71,962,0,962,0
42042,2019-11-08,1604,0,1604,128,1732,1732,0,0
42043,2019-11-08,585,0,585,46,631,0,0,631
42044,2019-11-08,834,0,834,66,900,900,0,0
42045,2019-11-08,130,0,130,10,140,140,0,0
42046,2019-11-08,773,0,773,77,850,850,0,0
42047,2019-11-08,3138,0,3138,313,3451,3451,0,0
42048,2019-11-08,2592,0,2592,259,2851,2851,0,0
42049,2019-11-08,3138,0,3138,313,3451,3451,0,0
42050,2019-11-08,1261,0,1261,126,1387,1387,0,0
42051,2019-11-08,773,0,773,77,850,850,0,0
42052,2019-11-08,1546,0,1546,154,1700,1700,0,0
42053,2019-11-08,446,0,446,24,470,470,0,0
42054,2019-11-08,577,0,577,46,623,623,0,0
42055,2019-11-08,2092,0,2092,209,2301,2301,0,0
42056,2019-11-08,964,0,964,77,1041,1041,0,0
42057,2019-11-08,511,0,511,40,551,551,0,0
42058,2019-11-08,273,0,273,27,300,300,0,0
42059,2019-11-08,1159,0,1159,115,1274,1274,0,0
42060,2019-11-08,1261,0,1261,126,1387,0,1387,0
42061,2019-11-08,1346,0,1346,120,1466,0,1466,0
42062,2019-11-08,463,0,463,46,509,0,509,0
42063,2019-11-08,390,0,390,31,421,421,0,0
42064,2019-11-08,1574,0,1574,157,1731,1731,0,0
42065,2019-11-08,1011,0,1011,80,1091,1091,0,0
42066,2019-11-08,352,0,352,35,387,0,0,387
42067,2019-11-08,594,0,594,47,641,641,0,0
42068,2019-11-08,1179,0,1179,112,1291,1291,0,0
42069,2019-11-08,417,0,417,33,450,450,0,0
42070,2019-11-08,299,0,299,29,328,328,0,0
42071,2019-11-08,767,0,767,76,843,843,0,0
42072,2019-11-08,188,0,188,15,203,203,0,0
42073,2019-11-08,278,0,278,22,300,300,0,0
42074,2019-11-08,176,0,176,14,190,190,0,0
42075,2019-11-08,455,0,455,36,491,491,0,0
42076,2019-11-08,167,0,167,13,180,180,0,0
42077,2019-11-08,260,0,260,20,280,280,0,0
42078,2019-11-08,740,0,740,74,814,814,0,0
42079,2019-11-08,779,0,779,62,841,841,0,0
42080,2019-11-08,761,-152,609,48,657,657,0,0
42081,2019-11-08,214,0,214,17,231,231,0,0
42082,2019-11-08,893,0,893,37,930,930,0,0
42083,2019-11-08,908,0,908,90,998,998,0,0
42084,2019-11-08,529,0,529,42,571,571,0,0
42085,2019-11-08,501,0,501,40,541,541,0,0
42086,2019-11-08,501,0,501,40,541,541,0,0
42087,2019-11-08,630,0,630,63,693,693,0,0
42088,2019-11-08,417,0,417,33,450,450,0,0
42089,2019-11-08,269,0,269,21,290,290,0,0
42090,2019-11-08,796,0,796,79,875,875,0,0
42091,2019-11-08,232,-23,209,16,225,225,0,0
42092,2019-11-08,2465,0,2465,246,2711,2711,0,0
42093,2019-11-08,613,0,613,49,662,662,0,0
42094,2019-11-08,1782,0,1782,178,1960,0,0,1960
42095,2019-11-08,603,0,603,48,651,651,0,0
42096,2019-11-08,819,0,819,65,884,884,0,0
42097,2019-11-08,353,0,353,28,381,381,0,0
42098,2019-11-08,1399,0,1399,139,1538,1538,0,0
42099,2019-11-08,298,0,298,23,321,321,0,0
42100,2019-11-08,417,0,417,33,450,450,0,0
42101,2019-11-08,565,0,565,56,621,621,0,0
42102,2019-11-08,492,0,492,39,531,531,0,0
42103,2019-11-08,1418,0,1418,141,1559,1559,0,0
42104,2019-11-08,-492,0,-492,-39,-531,-531,0,0
42105,2019-11-08,492,0,492,49,541,541,0,0
42106,2019-11-08,529,0,529,52,581,581,0,0
42107,2019-11-08,316,0,316,25,341,341,0,0
42108,2019-11-08,538,0,538,43,581,581,0,0
42109,2019-11-08,1086,0,1086,75,1161,1161,0,0
42110,2019-11-08,1546,0,1546,154,1700,1700,0,0
42111,2019-11-08,631,0,631,50,681,681,0,0
42112,2019-11-08,269,-26,243,19,262,262,0,0
42113,2019-11-08,1037,0,1037,103,1140,1140,0,0
42114,2019-11-08,742,0,742,59,801,801,0,0
42115,2019-11-08,916,0,916,91,1007,1007,0,0
42116,2019-11-08,1213,0,1213,121,1334,0,0,1334
42117,2019-11-08,1119,0,1119,111,1230,1230,0,0
42118,2019-11-08,316,0,316,25,341,341,0,0
42119,2019-11-08,773,0,773,77,850,0,850,0
42120,2019-11-08,362,0,362,28,390,390,0,0
42121,2019-11-08,1546,0,1546,154,1700,1700,0,0
42122,2019-11-08,370,0,370,29,399,399,0,0
42123,2019-11-08,556,0,556,55,611,0,611,0
42124,2019-11-08,1546,0,1546,154,1700,0,0,1700
42125,2019-11-08,2402,0,2402,192,2594,2594,0,0
42126,2019-11-08,492,0,492,39,531,531,0,0
42127,2019-11-08,1782,0,1782,178,1960,1960,0,0
42128,2019-11-08,269,0,269,21,290,290,0,0
42129,2019-11-08,-321,0,-321,-25,-346,-346,0,0
42130,2019-11-08,1909,0,1909,190,2099,0,0,2099
42131,2019-11-08,250,0,250,20,270,270,0,0
42132,2019-11-08,733,0,733,73,806,806,0,0
42133,2019-11-08,724,0,724,57,781,781,0,0
42134,2019-11-08,321,0,321,25,346,346,0,0
42135,2019-11-08,826,0,826,66,892,892,0,0
42136,2019-11-08,260,0,260,20,280,280,0,0
42137,2019-11-09,1390,0,1390,139,1529,1529,0,0
42138,2019-11-09,548,0,548,43,591,591,0,0
42139,2019-11-09,585,0,585,46,631,631,0,0
42140,2019-11-09,965,-96,869,86,955,955,0,0
42141,2019-11-09,2403,0,2403,181,2584,2584,0,0
42142,2019-11-09,1538,0,1538,153,1691,1691,0,0
42143,2019-11-09,455,0,455,36,491,491,0,0
42144,2019-11-09,427,0,427,34,461,461,0,0
42145,2019-11-09,1826,0,1826,182,2008,2008,0,0
42146,2019-11-09,965,0,965,96,1061,1061,0,0
42147,2019-11-09,503,0,503,40,543,543,0,0
42148,2019-11-09,1226,0,1226,98,1324,1324,0,0
42149,2019-11-09,1049,0,1049,83,1132,1132,0,0
42150,2019-11-09,400,0,400,32,432,432,0,0
42151,2019-11-09,307,0,307,24,331,331,0,0
42152,2019-11-09,510,0,510,40,550,550,0,0
42153,2019-11-09,947,0,947,75,1022,1022,0,0
42154,2019-11-09,779,0,779,77,856,856,0,0
42155,2019-11-09,167,0,167,16,183,183,0,0
42156,2019-11-09,1065,0,1065,106,1171,1171,0,0
42157,2019-11-09,427,0,427,34,461,461,0,0
42158,2019-11-09,-965,0,-965,-96,-1061,-1061,0,0
42159,2019-11-09,677,0,677,67,744,744,0,0
42160,2019-11-09,677,0,677,67,744,744,0,0
42161,2019-11-09,334,0,334,26,360,360,0,0
42162,2019-11-09,279,0,279,22,301,301,0,0
42163,2019-11-09,706,0,706,56,762,762,0,0
42164,2019-11-09,1195,0,1195,119,1314,0,1314,0
42165,2019-11-09,1712,0,1712,171,1883,1883,0,0
42166,2019-11-09,1782,0,1782,178,1960,1960,0,0
42167,2019-11-09,1448,0,1448,115,1563,0,1563,0
42168,2019-11-09,1596,0,1596,159,1755,1755,0,0
42169,2019-11-09,1519,0,1519,151,1670,1670,0,0
42170,2019-11-09,1782,0,1782,178,1960,1960,0,0
42171,2019-11-09,1337,0,1337,106,1443,1443,0,0
42172,2019-11-09,705,0,705,56,761,761,0,0
42173,2019-11-09,501,0,501,40,541,541,0,0
42174,2019-11-09,566,0,566,56,622,622,0,0
42175,2019-11-09,334,0,334,26,360,360,0,0
42176,2019-11-09,726,0,726,46,772,772,0,0
42177,2019-11-09,1661,0,1661,166,1827,0,1827,0
42178,2019-11-09,316,0,316,25,341,341,0,0
42179,2019-11-09,589,0,589,47,636,636,0,0
42180,2019-11-09,445,0,445,35,480,480,0,0
42181,2019-11-09,316,0,316,25,341,0,0,341
42182,2019-11-09,651,0,651,52,703,703,0,0
42183,2019-11-09,214,0,214,17,231,231,0,0
42184,2019-11-09,651,0,651,40,691,0,691,0
42185,2019-11-09,149,0,149,14,163,163,0,0
42186,2019-11-09,501,0,501,40,541,541,0,0
42187,2019-11-09,409,0,409,32,441,441,0,0
42188,2019-11-09,1299,0,1299,103,1402,1402,0,0
42189,2019-11-09,343,0,343,27,370,370,0,0
42190,2019-11-09,1345,0,1345,107,1452,0,1452,0
42191,2019-11-09,188,0,188,15,203,203,0,0
42192,2019-11-09,47,0,47,4,51,51,0,0
42193,2019-11-09,575,0,575,46,621,621,0,0
42194,2019-11-09,835,0,835,66,901,901,0,0
42195,2019-11-09,845,0,845,67,912,912,0,0
42196,2019-11-09,251,0,251,20,271,271,0,0
42197,2019-11-09,256,0,256,20,276,276,0,0
42198,2019-11-09,1102,0,1102,110,1212,1212,0,0
42199,2019-11-09,381,0,381,30,411,411,0,0
42200,2019-11-09,427,0,427,42,469,469,0,0
42201,2019-11-09,510,0,510,40,550,550,0,0
42202,2019-11-09,223,0,223,22,245,245,0,0
42203,2019-11-09,204,0,204,16,220,220,0,0
42204,2019-11-09,696,0,696,55,751,751,0,0
42205,2019-11-09,-427,0,-427,-42,-469,-469,0,0
42206,2019-11-09,682,0,682,54,736,736,0,0
42207,2019-11-09,1130,0,1130,113,1243,1243,0,0
42208,2019-11-09,936,0,936,93,1029,1029,0,0
42209,2019-11-09,446,0,446,35,481,481,0,0
42210,2019-11-09,677,0,677,54,731,731,0,0
42211,2019-11-09,288,0,288,28,316,316,0,0
42212,2019-11-09,1668,0,1668,166,1834,1834,0,0
42213,2019-11-09,1029,0,1029,102,1131,1131,0,0
42214,2019-11-09,732,0,732,73,805,805,0,0
42215,2019-11-09,167,0,167,13,180,180,0,0
42216,2019-11-09,778,0,778,77,855,855,0,0
42217,2019-11-09,389,0,389,38,427,427,0,0
42218,2019-11-09,93,0,93,7,100,100,0,0
42219,2019-11-09,1503,0,1503,150,1653,0,1653,0
42220,2019-11-09,1446,0,1446,144,1590,1590,0,0
42221,2019-11-09,668,0,668,53,721,721,0,0
42222,2019-11-09,362,0,362,28,390,390,0,0
42223,2019-11-09,799,-79,720,57,777,777,0,0
42224,2019-11-09,139,0,139,13,152,152,0,0
42225,2019-11-09,1892,0,1892,151,2043,2043,0,0
42226,2019-11-09,1385,0,1385,110,1495,0,0,1495
42227,2019-11-09,483,0,483,38,521,521,0,0
42228,2019-11-09,1649,0,1649,164,1813,1813,0,0
42229,2019-11-09,418,-41,377,30,407,407,0,0
42230,2019-11-09,316,0,316,25,341,341,0,0
42231,2019-11-09,362,0,362,28,390,390,0,0
42232,2019-11-09,459,0,459,45,504,504,0,0
42233,2019-11-09,1337,0,1337,133,1470,1470,0,0
42234,2019-11-09,1179,0,1179,94,1273,1273,0,0
42235,2019-11-09,2001,0,2001,200,2201,2201,0,0
42236,2019-11-09,1160,0,1160,92,1252,1252,0,0
42237,2019-11-09,863,0,863,69,932,932,0,0
42238,2019-11-09,538,0,538,43,581,581,0,0
42239,2019-11-09,1429,0,1429,142,1571,1571,0,0
42240,2019-11-09,575,0,575,46,621,621,0,0
42241,2019-11-09,501,-50,451,36,487,487,0,0
42242,2019-11-09,204,0,204,16,220,220,0,0
42243,2019-11-09,334,0,334,26,360,360,0,0
42244,2019-11-09,288,0,288,23,311,0,0,311
42245,2019-11-09,510,0,510,40,550,550,0,0
42246,2019-11-09,269,-53,216,17,233,233,0,0
42247,2019-11-09,773,0,773,77,850,850,0,0
42248,2019-11-09,1546,0,1546,154,1700,1700,0,0
42249,2019-11-09,5411,0,5411,541,5952,0,5952,0
42250,2019-11-09,733,0,733,58,791,791,0,0
42251,2019-11-09,773,0,773,77,850,850,0,0
42252,2019-11-09,773,0,773,77,850,850,0,0
42253,2019-11-09,773,0,773,77,850,850,0,0
42254,2019-11-09,773,0,773,77,850,850,0,0
42255,2019-11-09,2092,0,2092,209,2301,0,2301,0
42256,2019-11-09,1425,0,1425,142,1567,1567,0,0
42257,2019-11-09,1546,0,1546,154,1700,0,1700,0
42258,2019-11-09,445,0,445,35,480,480,0,0
42259,2019-11-09,567,0,567,45,612,612,0,0
42260,2019-11-09,807,0,807,64,871,871,0,0
42261,2019-11-09,761,0,761,49,810,810,0,0
42262,2019-11-09,1546,0,1546,154,1700,0,1700,0
42263,2019-11-09,1546,0,1546,154,1700,1700,0,0
42264,2019-11-09,698,0,698,55,753,753,0,0
42265,2019-11-09,1092,0,1092,109,1201,1201,0,0
42266,2019-11-09,882,0,882,70,952,952,0,0
42267,2019-11-09,176,0,176,14,190,190,0,0
42268,2019-11-09,269,0,269,21,290,290,0,0
42269,2019-11-09,167,0,167,13,180,180,0,0
42270,2019-11-09,788,0,788,78,866,866,0,0
42271,2019-11-09,546,0,546,54,600,600,0,0
42272,2019-11-09,1112,0,1112,111,1223,1223,0,0
42273,2019-11-09,853,0,853,85,938,938,0,0
42274,2019-11-09,373,0,373,29,402,402,0,0
42275,2019-11-09,446,0,446,35,481,481,0,0
42276,2019-11-09,501,0,501,40,541,541,0,0
42277,2019-11-09,641,0,641,51,692,0,692,0
42278,2019-11-09,232,0,232,18,250,250,0,0
42279,2019-11-09,436,0,436,34,470,470,0,0
42280,2019-11-09,603,0,603,48,651,651,0,0
42281,2019-11-09,269,0,269,21,290,290,0,0
42282,2019-11-09,297,0,297,23,320,320,0,0
42283,2019-11-09,445,0,445,35,480,480,0,0
42284,2019-11-09,503,0,503,40,543,543,0,0
42285,2019-11-09,696,0,696,55,751,751,0,0
42286,2019-11-09,371,0,371,29,400,400,0,0
42287,2019-11-09,261,0,261,20,281,281,0,0
42288,2019-11-09,538,0,538,43,581,581,0,0
42289,2019-11-09,1400,0,1400,140,1540,1540,0,0
42290,2019-11-09,1742,0,1742,174,1916,0,1916,0
42291,2019-11-09,956,0,956,81,1037,1037,0,0
42292,2019-11-09,1407,0,1407,140,1547,1547,0,0
42293,2019-11-09,445,0,445,35,480,480,0,0
42294,2019-11-09,500,0,500,40,540,540,0,0
42295,2019-11-09,1546,0,1546,154,1700,1700,0,0
42296,2019-11-09,1972,0,1972,197,2169,2169,0,0
42297,2019-11-09,556,0,556,44,600,600,0,0
42298,2019-11-09,510,0,510,40,550,550,0,0
42299,2019-11-09,1188,0,1188,95,1283,1283,0,0
42300,2019-11-09,1046,0,1046,104,1150,1150,0,0
42301,2019-11-09,484,0,484,27,511,511,0,0
42302,2019-11-09,1149,0,1149,114,1263,1263,0,0
42303,2019-11-09,779,0,779,62,841,841,0,0
42304,2019-11-09,269,0,269,21,290,290,0,0
42305,2019-11-09,306,-30,276,22,298,298,0,0
42306,2019-11-09,834,0,834,66,900,900,0,0
42307,2019-11-09,1030,0,1030,82,1112,1112,0,0
42308,2019-11-09,890,0,890,71,961,961,0,0
42309,2019-11-09,455,0,455,45,500,500,0,0
42310,2019-11-09,891,0,891,89,980,980,0,0
42311,2019-11-09,214,0,214,21,235,235,0,0
42312,2019-11-09,418,0,418,33,451,451,0,0
42313,2019-11-09,891,0,891,89,980,0,980,0
42314,2019-11-09,362,0,362,28,390,390,0,0
42315,2019-11-09,306,0,306,24,330,330,0,0
42316,2019-11-09,343,0,343,27,370,370,0,0
42317,2019-11-09,2354,0,2354,235,2589,0,0,2589
42318,2019-11-09,2092,0,2092,209,2301,2301,0,0
42319,2019-11-09,1281,0,1281,102,1383,1383,0,0
42320,2019-11-09,788,0,788,63,851,851,0,0
42321,2019-11-09,315,0,315,25,340,340,0,0
42322,2019-11-09,409,0,409,40,449,449,0,0
42323,2019-11-09,1807,0,1807,180,1987,1987,0,0
42324,2019-11-09,1546,0,1546,154,1700,0,1700,0
42325,2019-11-09,141,0,141,11,152,152,0,0
42326,2019-11-09,1102,0,1102,110,1212,1212,0,0
42327,2019-11-09,593,0,593,47,640,0,0,640
42328,2019-11-09,1085,0,1085,86,1171,1171,0,0
42329,2019-11-09,316,0,316,25,341,341,0,0
42330,2019-11-09,773,0,773,77,850,850,0,0
42331,2019-11-09,1546,0,1546,154,1700,0,0,1700
42332,2019-11-09,1480,0,1480,148,1628,1628,0,0
42333,2019-11-09,604,0,604,48,652,652,0,0
42334,2019-11-09,594,0,594,47,641,641,0,0
42335,2019-11-09,891,0,891,71,962,962,0,0
42336,2019-11-09,371,0,371,29,400,400,0,0
42337,2019-11-09,334,0,334,26,360,0,360,0
42338,2019-11-09,1546,0,1546,154,1700,1700,0,0
42339,2019-11-09,1546,0,1546,154,1700,0,1700,0
42340,2019-11-09,918,0,918,73,991,991,0,0
42341,2019-11-10,334,0,334,26,360,360,0,0
42342,2019-11-10,927,-92,835,66,901,901,0,0
42343,2019-11-10,334,0,334,26,360,360,0,0
42344,2019-11-10,779,0,779,77,856,856,0,0
42345,2019-11-10,991,0,991,99,1090,1090,0,0
42346,2019-11-10,769,0,769,76,845,845,0,0
42347,2019-11-10,418,0,418,33,451,451,0,0
42348,2019-11-10,676,0,676,67,743,743,0,0
42349,2019-11-10,667,0,667,53,720,720,0,0
42350,2019-11-10,660,0,660,52,712,712,0,0
42351,2019-11-10,297,0,297,29,326,326,0,0
42352,2019-11-10,269,0,269,21,290,0,0,290
42353,2019-11-10,677,0,677,54,731,0,0,731
42354,2019-11-10,1325,0,1325,106,1431,0,0,1431
42355,2019-11-10,297,0,297,23,320,320,0,0
42356,2019-11-10,102,0,102,8,110,110,0,0
42357,2019-11-10,501,0,501,40,541,541,0,0
42358,2019-11-10,233,0,233,18,251,251,0,0
42359,2019-11-10,1171,0,1171,93,1264,1264,0,0
42360,2019-11-10,463,0,463,46,509,509,0,0
42361,2019-11-10,306,0,306,24,330,330,0,0
42362,2019-11-10,946,0,946,75,1021,1021,0,0
42363,2019-11-10,510,0,510,40,550,550,0,0
42364,2019-11-10,139,0,139,11,150,150,0,0
42365,2019-11-10,473,0,473,37,510,510,0,0
42366,2019-11-10,278,0,278,22,300,300,0,0
42367,2019-11-10,100,0,100,10,110,110,0,0
42368,2019-11-10,863,0,863,69,932,932,0,0
42369,2019-11-10,788,0,788,63,851,851,0,0
42370,2019-11-10,1372,0,1372,137,1509,1509,0,0
42371,2019-11-10,557,0,557,44,601,601,0,0
42372,2019-11-10,705,0,705,56,761,761,0,0
42373,2019-11-10,937,0,937,74,1011,1011,0,0
42374,2019-11-10,604,0,604,48,652,652,0,0
42375,2019-11-10,204,0,204,16,220,220,0,0
42376,2019-11-10,603,0,603,48,651,651,0,0
42377,2019-11-10,538,0,538,43,581,581,0,0
42378,2019-11-10,454,0,454,45,499,499,0,0
42379,2019-11-10,1493,0,1493,119,1612,0,0,1612
42380,2019-11-10,1539,0,1539,153,1692,1692,0,0
42381,2019-11-10,891,0,891,89,980,0,980,0
42382,2019-11-10,94,0,94,9,103,0,103,0
42383,2019-11-10,204,0,204,16,220,0,220,0
42384,2019-11-10,686,0,686,68,754,0,754,0
42385,2019-11-10,167,0,167,13,180,180,0,0
42386,2019-11-10,724,0,724,57,781,781,0,0
42387,2019-11-10,464,-92,372,29,401,401,0,0
42388,2019-11-10,316,0,316,25,341,341,0,0
42389,2019-11-10,371,0,371,29,400,400,0,0
42390,2019-11-10,343,0,343,27,370,370,0,0
42391,2019-11-10,891,0,891,89,980,980,0,0
42392,2019-11-10,734,0,734,58,792,792,0,0
42393,2019-11-10,1110,0,1110,111,1221,1221,0,0
42394,2019-11-10,1429,0,1429,114,1543,1543,0,0
42395,2019-11-10,463,0,463,46,509,509,0,0
42396,2019-11-10,1782,0,1782,178,1960,1960,0,0
42397,2019-11-10,1113,0,1113,89,1202,0,0,1202
42398,2019-11-10,891,0,891,89,980,980,0,0
42399,2019-11-10,335,0,335,26,361,0,0,361
42400,2019-11-10,797,0,797,79,876,876,0,0
42401,2019-11-10,797,0,797,79,876,876,0,0
42402,2019-11-10,2195,0,2195,175,2370,2370,0,0
42403,2019-11-10,371,0,371,29,400,400,0,0
42404,2019-11-10,1100,0,1100,88,1188,1188,0,0
42405,2019-11-10,445,0,445,35,480,480,0,0
42406,2019-11-10,1038,0,1038,83,1121,1121,0,0
42407,2019-11-10,381,0,381,30,411,411,0,0
42408,2019-11-10,1225,0,1225,98,1323,0,1323,0
42409,2019-11-10,891,0,891,89,980,980,0,0
42410,2019-11-10,1326,0,1326,132,1458,1458,0,0
42411,2019-11-10,891,0,891,89,980,0,980,0
42412,2019-11-10,455,0,455,36,491,491,0,0
42413,2019-11-10,390,0,390,31,421,421,0,0
42414,2019-11-10,874,-87,787,62,849,849,0,0
42415,2019-11-10,881,0,881,70,951,951,0,0
42416,2019-11-10,4455,0,4455,445,4900,4900,0,0
42417,2019-11-10,539,0,539,43,582,582,0,0
42418,2019-11-10,557,0,557,55,612,612,0,0
42419,2019-11-10,659,0,659,52,711,711,0,0
42420,2019-11-10,722,0,722,72,794,794,0,0
42421,2019-11-10,121,0,121,9,130,130,0,0
42422,2019-11-10,334,0,334,26,360,360,0,0
42423,2019-11-10,260,0,260,20,280,280,0,0
42424,2019-11-10,232,0,232,18,250,250,0,0
42425,2019-11-10,1143,0,1143,91,1234,1234,0,0
42426,2019-11-10,121,0,121,9,130,130,0,0
42427,2019-11-10,520,0,520,41,561,561,0,0
42428,2019-11-10,260,0,260,20,280,280,0,0
42429,2019-11-10,630,0,630,63,693,693,0,0
42430,2019-11-10,787,0,787,78,865,865,0,0
42431,2019-11-10,278,0,278,22,300,300,0,0
42432,2019-11-10,186,0,186,14,200,200,0,0
42433,2019-11-10,232,0,232,23,255,255,0,0
42434,2019-11-10,232,0,232,18,250,250,0,0
42435,2019-11-10,797,-79,718,57,775,775,0,0
42436,2019-11-10,1110,0,1110,111,1221,1221,0,0
42437,2019-11-10,740,0,740,59,799,799,0,0
42438,2019-11-10,728,0,728,58,786,786,0,0
42439,2019-11-10,473,-47,426,34,460,0,460,0
42440,2019-11-10,224,0,224,17,241,241,0,0
42441,2019-11-10,631,0,631,50,681,681,0,0
42442,2019-11-10,399,0,399,31,430,430,0,0
42443,2019-11-10,845,0,845,67,912,0,912,0
42444,2019-11-10,1016,0,1016,81,1097,1097,0,0
42445,2019-11-10,-845,0,-845,-67,-912,-912,0,0
42446,2019-11-10,1286,0,1286,128,1414,1414,0,0
42447,2019-11-10,512,-51,461,36,497,0,0,497
42448,2019-11-10,742,0,742,74,816,816,0,0
42449,2019-11-10,223,0,223,17,240,0,0,240
42450,2019-11-10,334,0,334,26,360,360,0,0
42451,2019-11-10,547,0,547,43,590,590,0,0
42452,2019-11-10,556,0,556,44,600,600,0,0
42453,2019-11-10,538,0,538,43,581,581,0,0
42454,2019-11-10,353,0,353,28,381,381,0,0
42455,2019-11-10,806,0,806,64,870,870,0,0
42456,2019-11-10,1817,0,1817,145,1962,1962,0,0
42457,2019-11-10,502,0,502,40,542,542,0,0
42458,2019-11-10,520,0,520,41,561,0,561,0
42459,2019-11-10,260,0,260,20,280,280,0,0
42460,2019-11-10,381,0,381,30,411,411,0,0
42461,2019-11-10,178,0,178,14,192,192,0,0
42462,2019-11-10,510,0,510,40,550,550,0,0
42463,2019-11-10,2453,0,2453,245,2698,2698,0,0
42464,2019-11-10,900,0,900,72,972,972,0,0
42465,2019-11-10,204,0,204,16,220,220,0,0
42466,2019-11-10,454,0,454,36,490,490,0,0
42467,2019-11-10,461,-46,415,33,448,0,448,0
42468,2019-11-10,334,0,334,26,360,360,0,0
42469,2019-11-10,574,0,574,57,631,631,0,0
42470,2019-11-10,621,0,621,62,683,683,0,0
42471,2019-11-10,984,0,984,67,1051,1051,0,0
42472,2019-11-10,732,0,732,73,805,805,0,0
42473,2019-11-10,640,0,640,51,691,0,691,0
42474,2019-11-10,260,0,260,20,280,280,0,0
42475,2019-11-10,510,0,510,40,550,550,0,0
42476,2019-11-10,530,0,530,53,583,583,0,0
42477,2019-11-10,454,-45,409,32,441,441,0,0
42478,2019-11-10,613,0,613,61,674,674,0,0
42479,2019-11-10,1040,0,1040,83,1123,1123,0,0
42480,2019-11-10,733,0,733,58,791,0,0,791
42481,2019-11-10,491,0,491,49,540,540,0,0
42482,2019-11-10,186,-37,149,11,160,160,0,0
42483,2019-11-10,1546,0,1546,154,1700,1700,0,0
42484,2019-11-10,936,0,936,93,1029,1029,0,0
42485,2019-11-10,834,0,834,83,917,917,0,0
42486,2019-11-10,1546,0,1546,154,1700,1700,0,0
42487,2019-11-10,773,0,773,77,850,850,0,0
42488,2019-11-10,1546,0,1546,154,1700,0,1700,0
42489,2019-11-10,1546,0,1546,154,1700,1700,0,0
42490,2019-11-10,773,0,773,77,850,850,0,0
42491,2019-11-10,528,0,528,42,570,0,570,0
42492,2019-11-10,176,0,176,14,190,190,0,0
42493,2019-11-10,200,0,200,16,216,216,0,0
42494,2019-11-10,704,0,704,70,774,0,774,0
42495,2019-11-10,167,0,167,13,180,180,0,0
42496,2019-11-10,1123,0,1123,89,1212,0,1212,0
42497,2019-11-11,102,0,102,8,110,110,0,0
42498,2019-11-11,455,0,455,45,500,500,0,0
42499,2019-11-11,445,0,445,44,489,489,0,0
42500,2019-11-11,872,0,872,87,959,959,0,0
42501,2019-11-11,204,0,204,16,220,0,220,0
42502,2019-11-11,1087,0,1087,86,1173,1173,0,0
42503,2019-11-11,1782,0,1782,178,1960,1960,0,0
42504,2019-11-11,408,0,408,40,448,448,0,0
42505,2019-11-11,705,0,705,56,761,761,0,0
42506,2019-11-11,389,0,389,38,427,427,0,0
42507,2019-11-11,640,0,640,51,691,691,0,0
42508,2019-11-11,677,0,677,53,730,730,0,0
42509,2019-11-11,501,0,501,40,541,0,541,0
42510,2019-11-11,2014,0,2014,201,2215,2215,0,0
42511,2019-11-11,725,0,725,58,783,783,0,0
42512,2019-11-11,616,0,616,38,654,654,0,0
42513,2019-11-11,982,0,982,98,1080,1080,0,0
42514,2019-11-11,232,0,232,18,250,250,0,0
42515,2019-11-11,1179,0,1179,94,1273,1273,0,0
42516,2019-11-11,334,0,334,33,367,367,0,0
42517,2019-11-11,759,0,759,75,834,834,0,0
42518,2019-11-11,298,0,298,29,327,327,0,0
42519,2019-11-11,520,0,520,41,561,561,0,0
42520,2019-11-11,1418,0,1418,141,1559,0,1559,0
42521,2019-11-11,854,0,854,68,922,0,0,922
42522,2019-11-11,473,0,473,37,510,510,0,0
42523,2019-11-11,891,0,891,89,980,980,0,0
42524,2019-11-11,891,0,891,89,980,0,980,0
42525,2019-11-11,891,0,891,89,980,0,980,0
42526,2019-11-11,576,0,576,46,622,0,622,0
42527,2019-11-11,530,0,530,42,572,572,0,0
42528,2019-11-11,1782,0,1782,178,1960,0,1960,0
42529,2019-11-11,1675,0,1675,167,1842,1842,0,0
42530,2019-11-11,2029,0,2029,202,2231,2231,0,0
42531,2019-11-11,689,0,689,55,744,744,0,0
42532,2019-11-11,1971,0,1971,197,2168,2168,0,0
42533,2019-11-11,233,0,233,18,251,251,0,0
42534,2019-11-11,1076,0,1076,107,1183,1183,0,0
42535,2019-11-11,2529,0,2529,252,2781,2781,0,0
42536,2019-11-11,399,0,399,31,430,430,0,0
42537,2019-11-11,668,0,668,53,721,0,721,0
42538,2019-11-11,788,0,788,63,851,851,0,0
42539,2019-11-11,260,0,260,20,280,280,0,0
42540,2019-11-11,232,0,232,18,250,0,250,0
42541,2019-11-11,806,0,806,80,886,886,0,0
42542,2019-11-11,687,0,687,68,755,755,0,0
42543,2019-11-11,209,0,209,16,225,225,0,0
42544,2019-11-11,668,0,668,53,721,721,0,0
42545,2019-11-11,761,0,761,60,821,821,0,0
42546,2019-11-11,-1675,0,-1675,-167,-1842,-1842,0,0
42547,2019-11-11,1675,0,1675,167,1842,1842,0,0
42548,2019-11-11,1353,0,1353,135,1488,0,1488,0
42549,2019-11-11,1480,0,1480,118,1598,1598,0,0
42550,2019-11-11,370,0,370,29,399,399,0,0
42551,2019-11-11,826,0,826,66,892,892,0,0
42552,2019-11-11,288,0,288,28,316,316,0,0
42553,2019-11-11,204,0,204,16,220,220,0,0
42554,2019-11-11,724,0,724,57,781,781,0,0
42555,2019-11-11,390,0,390,39,429,429,0,0
42556,2019-11-11,269,0,269,21,290,290,0,0
42557,2019-11-11,705,0,705,56,761,0,761,0
42558,2019-11-11,139,0,139,11,150,150,0,0
42559,2019-11-11,139,0,139,11,150,150,0,0
42560,2019-11-11,463,0,463,37,500,500,0,0
42561,2019-11-11,418,-41,377,30,407,0,407,0
42562,2019-11-11,695,0,695,69,764,764,0,0
42563,2019-11-11,632,0,632,50,682,682,0,0
42564,2019-11-11,491,0,491,49,540,540,0,0
42565,2019-11-11,631,0,631,50,681,681,0,0
42566,2019-11-11,473,0,473,37,510,510,0,0
42567,2019-11-11,543,0,543,43,586,586,0,0
42568,2019-11-11,1512,0,1512,120,1632,1632,0,0
42569,2019-11-11,510,0,510,40,550,550,0,0
42570,2019-11-11,695,0,695,55,750,750,0,0
42571,2019-11-11,205,0,205,16,221,221,0,0
42572,2019-11-11,1546,0,1546,154,1700,1700,0,0
42573,2019-11-11,352,0,352,35,387,387,0,0
42574,2019-11-11,1546,0,1546,154,1700,0,1700,0
42575,2019-11-11,1546,0,1546,154,1700,1700,0,0
42576,2019-11-11,773,0,773,77,850,850,0,0
42577,2019-11-11,974,0,974,77,1051,0,0,1051
42578,2019-11-11,558,0,558,33,591,591,0,0
42579,2019-11-11,778,0,778,62,840,840,0,0
42580,2019-11-11,364,0,364,17,381,381,0,0
42581,2019-11-11,599,0,599,47,646,646,0,0
42582,2019-11-11,547,0,547,54,601,601,0,0
42583,2019-11-11,630,0,630,63,693,693,0,0
42584,2019-11-11,1029,0,1029,102,1131,1131,0,0
42585,2019-11-11,288,0,288,23,311,311,0,0
42586,2019-11-11,628,0,628,62,690,690,0,0
42587,2019-11-11,628,0,628,62,690,690,0,0
42588,2019-11-11,260,0,260,20,280,280,0,0
42589,2019-11-11,1373,0,1373,137,1510,1510,0,0
42590,2019-11-11,740,0,740,74,814,814,0,0
42591,2019-11-11,621,0,621,49,670,670,0,0
42592,2019-11-11,1659,0,1659,114,1773,1773,0,0
42593,2019-11-11,520,0,520,41,561,561,0,0
42594,2019-11-11,261,0,261,9,270,270,0,0
42595,2019-11-11,603,0,603,60,663,663,0,0
42596,2019-11-11,167,0,167,13,180,180,0,0
42597,2019-11-11,900,0,900,72,972,972,0,0
42598,2019-11-11,195,0,195,15,210,210,0,0
42599,2019-11-11,612,0,612,48,660,660,0,0
42600,2019-11-11,773,0,773,77,850,0,850,0
42601,2019-11-11,911,0,911,77,988,0,0,988
42602,2019-11-11,1782,-178,1604,160,1764,1764,0,0
42603,2019-11-11,-1782,0,-1782,-178,-1960,-1960,0,0
42604,2019-11-11,1782,0,1782,178,1960,1960,0,0
42605,2019-11-11,417,0,417,41,458,458,0,0
42606,2019-11-11,2031,-406,1625,130,1755,1755,0,0
42607,2019-11-11,1782,0,1782,178,1960,1960,0,0
42608,2019-11-11,687,0,687,54,741,741,0,0
42609,2019-11-11,1819,0,1819,181,2000,2000,0,0
42610,2019-11-11,836,-167,669,53,722,722,0,0
42611,2019-11-11,195,0,195,15,210,210,0,0
42612,2019-11-11,1112,0,1112,111,1223,1223,0,0
42613,2019-11-11,891,0,891,89,980,980,0,0
42614,2019-11-11,370,0,370,37,407,407,0,0
42615,2019-11-11,623,0,623,49,672,672,0,0
42616,2019-11-11,315,0,315,25,340,340,0,0
42617,2019-11-11,306,0,306,24,330,330,0,0
42618,2019-11-11,232,0,232,18,250,250,0,0
42619,2019-11-11,370,0,370,37,407,407,0,0
42620,2019-11-11,352,0,352,35,387,387,0,0
42621,2019-11-11,659,0,659,52,711,711,0,0
42622,2019-11-11,232,0,232,18,250,250,0,0
42623,2019-11-11,343,0,343,34,377,377,0,0
42624,2019-11-11,1075,0,1075,107,1182,1182,0,0
42625,2019-11-11,273,0,273,27,300,300,0,0
42626,2019-11-11,1169,0,1169,93,1262,1262,0,0
42627,2019-11-11,140,0,140,0,140,140,0,0
42628,2019-11-11,929,0,929,74,1003,1003,0,0
42629,2019-11-11,883,0,883,70,953,0,953,0
42630,2019-11-11,1186,0,1186,118,1304,1304,0,0
42631,2019-11-11,1024,0,1024,81,1105,1105,0,0
42632,2019-11-11,910,0,910,72,982,982,0,0
42633,2019-11-12,566,0,566,45,611,611,0,0
42634,2019-11-12,742,0,742,59,801,801,0,0
42635,2019-11-12,472,0,472,47,519,0,519,0
42636,2019-11-12,1538,0,1538,153,1691,1691,0,0
42637,2019-11-12,343,0,343,27,370,370,0,0
42638,2019-11-12,706,0,706,56,762,762,0,0
42639,2019-11-12,343,0,343,27,370,0,0,370
42640,2019-11-12,835,0,835,66,901,0,901,0
42641,2019-11-12,720,-72,648,51,699,699,0,0
42642,2019-11-12,642,0,642,51,693,693,0,0
42643,2019-11-12,280,0,280,22,302,302,0,0
42644,2019-11-12,853,0,853,68,921,921,0,0
42645,2019-11-12,1207,0,1207,96,1303,1303,0,0
42646,2019-11-12,1110,0,1110,111,1221,1221,0,0
42647,2019-11-12,752,0,752,60,812,812,0,0
42648,2019-11-12,844,0,844,67,911,911,0,0
42649,2019-11-12,547,0,547,43,590,590,0,0
42650,2019-11-12,306,0,306,24,330,330,0,0
42651,2019-11-12,1083,0,1083,86,1169,1169,0,0
42652,2019-11-12,456,0,456,36,492,492,0,0
42653,2019-11-12,500,0,500,40,540,540,0,0
42654,2019-11-12,501,0,501,40,541,541,0,0
42655,2019-11-12,640,0,640,51,691,691,0,0
42656,2019-11-12,116,0,116,9,125,125,0,0
42657,2019-11-12,1521,0,1521,121,1642,1642,0,0
42658,2019-11-12,519,0,519,41,560,560,0,0
42659,2019-11-12,102,0,102,8,110,110,0,0
42660,2019-11-12,483,0,483,38,521,521,0,0
42661,2019-11-12,288,0,288,23,311,311,0,0
42662,2019-11-12,233,0,233,18,251,251,0,0
42663,2019-11-12,139,0,139,11,150,0,0,150
42664,2019-11-13,363,0,363,36,399,0,399,0
42665,2019-11-13,297,0,297,23,320,320,0,0
42666,2019-11-13,288,0,288,23,311,311,0,0
42667,2019-11-13,465,0,465,37,502,502,0,0
42668,2019-11-13,334,0,334,26,360,360,0,0
42669,2019-11-13,1782,0,1782,178,1960,1960,0,0
42670,2019-11-13,1782,0,1782,178,1960,1960,0,0
42671,2019-11-13,891,0,891,89,980,980,0,0
42672,2019-11-13,640,0,640,51,691,691,0,0
42673,2019-11-13,269,0,269,21,290,0,290,0
42674,2019-11-13,1049,-104,945,75,1020,1020,0,0
42675,2019-11-13,891,0,891,89,980,980,0,0
42676,2019-11-13,343,0,343,27,370,370,0,0
42677,2019-11-13,2248,0,2248,224,2472,2472,0,0
42678,2019-11-13,1519,0,1519,151,1670,1670,0,0
42679,2019-11-13,251,0,251,20,271,271,0,0
42680,2019-11-13,919,0,919,73,992,0,992,0
42681,2019-11-13,121,0,121,9,130,130,0,0
42682,2019-11-13,102,0,102,8,110,110,0,0
42683,2019-11-13,628,0,628,62,690,0,690,0
42684,2019-11-13,863,0,863,69,932,932,0,0
42685,2019-11-13,417,0,417,33,450,450,0,0
42686,2019-11-13,1123,0,1123,89,1212,1212,0,0
42687,2019-11-13,918,0,918,73,991,991,0,0
42688,2019-11-13,769,0,769,76,845,845,0,0
42689,2019-11-13,389,0,389,38,427,427,0,0
42690,2019-11-13,668,0,668,53,721,721,0,0
42691,2019-11-13,667,0,667,66,733,733,0,0
42692,2019-11-13,482,0,482,38,520,520,0,0
42693,2019-11-13,149,0,149,11,160,160,0,0
42694,2019-11-13,797,0,797,63,860,860,0,0
42695,2019-11-13,516,0,516,41,557,557,0,0
42696,2019-11-13,642,0,642,51,693,693,0,0
42697,2019-11-13,399,0,399,39,438,438,0,0
42698,2019-11-13,344,0,344,27,371,371,0,0
42699,2019-11-13,566,0,566,45,611,611,0,0
42700,2019-11-13,372,0,372,29,401,401,0,0
42701,2019-11-13,891,0,891,89,980,980,0,0
42702,2019-11-13,491,-98,393,39,432,432,0,0
42703,2019-11-13,251,0,251,20,271,271,0,0
42704,2019-11-13,1511,0,1511,151,1662,1662,0,0
42705,2019-11-13,891,0,891,89,980,0,980,0
42706,2019-11-13,891,0,891,89,980,0,980,0
42707,2019-11-13,492,0,492,39,531,531,0,0
42708,2019-11-13,722,0,722,72,794,794,0,0
42709,2019-11-13,705,0,705,56,761,761,0,0
42710,2019-11-13,288,0,288,23,311,311,0,0
42711,2019-11-13,686,0,686,54,740,740,0,0
42712,2019-11-13,269,0,269,21,290,290,0,0
42713,2019-11-13,1485,0,1485,118,1603,1603,0,0
42714,2019-11-13,530,0,530,42,572,572,0,0
42715,2019-11-13,188,0,188,15,203,203,0,0
42716,2019-11-13,269,0,269,21,290,290,0,0
42717,2019-11-13,1844,0,1844,184,2028,2028,0,0
42718,2019-11-13,1546,0,1546,154,1700,1700,0,0
42719,2019-11-13,167,0,167,13,180,180,0,0
42720,2019-11-13,1059,0,1059,84,1143,1143,0,0
42721,2019-11-13,1546,0,1546,154,1700,1700,0,0
42722,2019-11-13,639,0,639,51,690,690,0,0
42723,2019-11-13,1297,0,1297,129,1426,0,1426,0
42724,2019-11-13,399,0,399,31,430,430,0,0
42725,2019-11-13,770,0,770,77,847,847,0,0
42726,2019-11-13,483,0,483,48,531,531,0,0
42727,2019-11-13,1819,0,1819,181,2000,0,2000,0
42728,2019-11-13,640,0,640,51,691,691,0,0
42729,2019-11-13,399,0,399,39,438,438,0,0
42730,2019-11-13,623,-62,561,44,605,605,0,0
42731,2019-11-13,1788,0,1788,178,1966,1966,0,0
42732,2019-11-13,5625,0,5625,450,6075,0,6075,0
42733,2019-11-13,705,0,705,56,761,761,0,0
42734,2019-11-13,1225,0,1225,98,1323,1323,0,0
42735,2019-11-13,982,0,982,98,1080,1080,0,0
42736,2019-11-13,853,0,853,85,938,938,0,0
42737,2019-11-13,576,0,576,46,622,622,0,0
42738,2019-11-13,381,0,381,30,411,411,0,0
42739,2019-11-13,575,0,575,46,621,621,0,0
42740,2019-11-13,417,0,417,33,450,450,0,0
42741,2019-11-13,445,0,445,35,480,480,0,0
42742,2019-11-13,409,0,409,32,441,441,0,0
42743,2019-11-13,1093,0,1093,87,1180,1180,0,0
42744,2019-11-13,1392,-778,614,61,675,675,0,0
42745,2019-11-13,677,0,677,54,731,731,0,0
42746,2019-11-13,659,0,659,52,711,711,0,0
42747,2019-11-13,538,0,538,43,581,0,581,0
42748,2019-11-13,399,0,399,31,430,430,0,0
42749,2019-11-13,881,0,881,70,951,951,0,0
42750,2019-11-13,957,0,957,76,1033,1033,0,0
42751,2019-11-13,1782,0,1782,178,1960,0,1960,0
42752,2019-11-13,1121,0,1121,112,1233,1233,0,0
42753,2019-11-13,464,0,464,37,501,501,0,0
42754,2019-11-13,2365,0,2365,236,2601,2601,0,0
42755,2019-11-13,485,0,485,27,512,512,0,0
42756,2019-11-13,159,-15,144,14,158,158,0,0
42757,2019-11-13,381,0,381,30,411,411,0,0
42758,2019-11-13,1782,0,1782,178,1960,1960,0,0
42759,2019-11-13,937,0,937,74,1011,1011,0,0
42760,2019-11-13,344,0,344,27,371,371,0,0
42761,2019-11-14,891,0,891,89,980,980,0,0
42762,2019-11-14,270,0,270,21,291,0,291,0
42763,2019-11-14,1975,0,1975,158,2133,0,2133,0
42764,2019-11-14,1088,0,1088,87,1175,0,1175,0
42765,2019-11-14,345,0,345,27,372,0,372,0
42766,2019-11-14,891,0,891,89,980,980,0,0
42767,2019-11-14,743,0,743,59,802,802,0,0
42768,2019-11-14,724,0,724,57,781,0,781,0
42769,2019-11-14,594,0,594,59,653,653,0,0
42770,2019-11-14,853,0,853,85,938,938,0,0
42771,2019-11-14,548,0,548,54,602,602,0,0
42772,2019-11-14,93,0,93,7,100,100,0,0
42773,2019-11-14,584,0,584,46,630,630,0,0
42774,2019-11-14,196,0,196,15,211,0,211,0
42775,2019-11-14,667,0,667,53,720,720,0,0
42776,2019-11-14,1094,0,1094,87,1181,1181,0,0
42777,2019-11-14,167,0,167,13,180,180,0,0
42778,2019-11-14,474,0,474,37,511,511,0,0
42779,2019-11-14,1687,0,1687,168,1855,1855,0,0
42780,2019-11-14,537,0,537,42,579,0,579,0
42781,2019-11-14,427,0,427,34,461,461,0,0
42782,2019-11-14,529,0,529,42,571,571,0,0
42783,2019-11-14,2311,0,2311,231,2542,0,2542,0
42784,2019-11-14,139,0,139,13,152,0,0,152
42785,2019-11-14,920,0,920,51,971,971,0,0
42786,2019-11-14,770,0,770,61,831,831,0,0
42787,2019-11-14,2972,0,2972,226,3198,0,0,3198
42788,2019-11-14,483,0,483,38,521,521,0,0
42789,2019-11-14,806,0,806,80,886,886,0,0
42790,2019-11-14,437,0,437,34,471,471,0,0
42791,2019-11-14,167,0,167,13,180,180,0,0
42792,2019-11-14,584,0,584,58,642,642,0,0
42793,2019-11-14,584,0,584,58,642,642,0,0
42794,2019-11-14,966,0,966,96,1062,1062,0,0
42795,2019-11-14,354,0,354,28,382,382,0,0
42796,2019-11-14,927,0,927,92,1019,1019,0,0
42797,2019-11-14,640,0,640,51,691,691,0,0
42798,2019-11-14,883,0,883,70,953,953,0,0
42799,2019-11-14,584,0,584,46,630,630,0,0
42800,2019-11-14,797,0,797,79,876,876,0,0
42801,2019-11-14,649,0,649,51,700,0,0,700
42802,2019-11-14,1271,0,1271,101,1372,1372,0,0
42803,2019-11-14,501,0,501,40,541,541,0,0
42804,2019-11-14,464,0,464,37,501,501,0,0
42805,2019-11-14,149,0,149,14,163,163,0,0
42806,2019-11-14,56,0,56,4,60,60,0,0
42807,2019-11-14,345,0,345,27,372,372,0,0
42808,2019-11-14,909,0,909,72,981,981,0,0
42809,2019-11-14,1228,0,1228,98,1326,0,1326,0
42810,2019-11-14,269,0,269,21,290,290,0,0
42811,2019-11-14,1500,0,1500,150,1650,1650,0,0
42812,2019-11-14,829,0,829,55,884,884,0,0
42813,2019-11-14,483,0,483,38,521,521,0,0
42814,2019-11-14,630,0,630,63,693,0,693,0
42815,2019-11-14,1048,0,1048,104,1152,1152,0,0
42816,2019-11-14,307,0,307,30,337,337,0,0
42817,2019-11-14,548,0,548,43,591,591,0,0
42818,2019-11-14,891,0,891,89,980,980,0,0
42819,2019-11-14,900,0,900,72,972,972,0,0
42820,2019-11-14,891,0,891,89,980,980,0,0
42821,2019-11-14,195,0,195,15,210,210,0,0
42822,2019-11-14,612,0,612,48,660,660,0,0
42823,2019-11-14,705,0,705,70,775,775,0,0
42824,2019-11-14,362,0,362,28,390,390,0,0
42825,2019-11-14,705,0,705,70,775,775,0,0
42826,2019-11-14,854,0,854,68,922,922,0,0
42827,2019-11-14,2265,0,2265,226,2491,2491,0,0
42828,2019-11-14,1612,0,1612,161,1773,1773,0,0
42829,2019-11-14,631,0,631,50,681,681,0,0
42830,2019-11-14,417,0,417,33,450,450,0,0
42831,2019-11-14,307,0,307,30,337,337,0,0
42832,2019-11-14,112,0,112,11,123,123,0,0
42833,2019-11-14,316,0,316,25,341,341,0,0
42834,2019-11-14,1059,-105,954,76,1030,1030,0,0
42835,2019-11-14,501,-50,451,36,487,487,0,0
42836,2019-11-14,491,0,491,49,540,540,0,0
42837,2019-11-14,778,0,778,77,855,855,0,0
42838,2019-11-14,751,0,751,75,826,826,0,0
42839,2019-11-14,1067,0,1067,85,1152,1152,0,0
42840,2019-11-14,1864,0,1864,149,2013,2013,0,0
42841,2019-11-14,477,0,477,38,515,515,0,0
42842,2019-11-14,706,-70,636,50,686,686,0,0
42843,2019-11-14,1040,0,1040,83,1123,1123,0,0
42844,2019-11-14,696,0,696,55,751,751,0,0
42845,2019-11-14,297,0,297,23,320,0,0,320
42846,2019-11-14,2319,0,2319,231,2550,2550,0,0
42847,2019-11-14,510,0,510,40,550,550,0,0
42848,2019-11-14,556,0,556,44,600,600,0,0
42849,2019-11-14,1925,0,1925,192,2117,2117,0,0
42850,2019-11-14,556,0,556,44,600,600,0,0
42851,2019-11-14,269,0,269,21,290,290,0,0
42852,2019-11-14,1046,0,1046,104,1150,0,0,1150
42853,2019-11-14,863,0,863,86,949,949,0,0
42854,2019-11-14,94,0,94,7,101,0,101,0
42855,2019-11-14,650,0,650,65,715,715,0,0
42856,2019-11-14,334,0,334,33,367,367,0,0
42857,2019-11-14,817,0,817,65,882,882,0,0
42858,2019-11-14,371,0,371,29,400,400,0,0
42859,2019-11-14,1879,0,1879,187,2066,0,2066,0
42860,2019-11-14,715,0,715,57,772,772,0,0
42861,2019-11-14,930,0,930,74,1004,0,1004,0
42862,2019-11-14,520,0,520,41,561,561,0,0
42863,2019-11-14,1480,0,1480,148,1628,1628,0,0
42864,2019-11-14,298,0,298,29,327,327,0,0
42865,2019-11-14,484,0,484,38,522,522,0,0
42866,2019-11-14,492,0,492,39,531,0,0,531
42867,2019-11-14,836,0,836,66,902,0,902,0
42868,2019-11-14,911,0,911,72,983,983,0,0
42869,2019-11-14,47,0,47,4,51,51,0,0
42870,2019-11-14,362,0,362,28,390,0,390,0
42871,2019-11-14,1523,0,1523,152,1675,1675,0,0
42872,2019-11-14,696,0,696,55,751,751,0,0
42873,2019-11-14,691,0,691,55,746,746,0,0
42874,2019-11-14,1002,0,1002,80,1082,1082,0,0
42875,2019-11-14,1782,0,1782,178,1960,1960,0,0
42876,2019-11-14,956,0,956,76,1032,1032,0,0
42877,2019-11-14,834,-83,751,60,811,811,0,0
42878,2019-11-14,334,0,334,26,360,0,360,0
42879,2019-11-14,1315,0,1315,131,1446,0,1446,0
42880,2019-11-14,427,0,427,34,461,461,0,0
42881,2019-11-14,686,0,686,68,754,754,0,0
42882,2019-11-14,1193,0,1193,84,1277,0,1277,0
42883,2019-11-14,677,0,677,54,731,731,0,0
42884,2019-11-14,630,0,630,50,680,680,0,0
42885,2019-11-14,251,0,251,20,271,271,0,0
42886,2019-11-14,1910,0,1910,152,2062,2062,0,0
42887,2019-11-14,1149,0,1149,114,1263,1263,0,0
42888,2019-11-14,740,0,740,74,814,814,0,0
42889,2019-11-14,362,0,362,28,390,390,0,0
42890,2019-11-14,788,0,788,63,851,851,0,0
42891,2019-11-14,1087,0,1087,86,1173,1173,0,0
42892,2019-11-14,773,0,773,77,850,850,0,0
42893,2019-11-14,1796,0,1796,179,1975,0,1975,0
42894,2019-11-14,993,0,993,79,1072,1072,0,0
42895,2019-11-14,1456,0,1456,116,1572,1572,0,0
42896,2019-11-14,676,0,676,67,743,743,0,0
42897,2019-11-14,658,0,658,65,723,723,0,0
42898,2019-11-14,649,0,649,51,700,0,700,0
42899,2019-11-14,278,0,278,22,300,300,0,0
42900,2019-11-14,1720,0,1720,172,1892,0,1892,0
42901,2019-11-14,3640,0,3640,291,3931,3931,0,0
42902,2019-11-14,351,0,351,28,379,379,0,0
42903,2019-11-14,363,0,363,29,392,392,0,0
42904,2019-11-14,676,0,676,67,743,743,0,0
42905,2019-11-14,964,0,964,96,1060,1060,0,0
42906,2019-11-14,306,0,306,24,330,330,0,0
42907,2019-11-14,1546,0,1546,154,1700,1700,0,0
42908,2019-11-14,1178,-235,943,75,1018,1018,0,0
42909,2019-11-15,965,0,965,77,1042,1042,0,0
42910,2019-11-15,2058,0,2058,164,2222,2222,0,0
42911,2019-11-15,306,0,306,24,330,330,0,0
42912,2019-11-15,899,0,899,71,970,970,0,0
42913,2019-11-15,1782,0,1782,178,1960,1960,0,0
42914,2019-11-15,779,0,779,62,841,0,0,841
42915,2019-11-15,836,0,836,66,902,902,0,0
42916,2019-11-15,863,0,863,69,932,932,0,0
42917,2019-11-15,1158,0,1158,115,1273,1273,0,0
42918,2019-11-15,269,0,269,21,290,290,0,0
42919,2019-11-15,204,0,204,16,220,220,0,0
42920,2019-11-15,1077,0,1077,86,1163,1163,0,0
42921,2019-11-15,2138,0,2138,171,2309,0,0,2309
42922,2019-11-15,891,0,891,89,980,980,0,0
42923,2019-11-15,1883,-1500,383,30,413,413,0,0
42924,2019-11-15,1782,0,1782,178,1960,1960,0,0
42925,2019-11-15,370,0,370,37,407,407,0,0
42926,2019-11-15,576,-57,519,41,560,0,0,560
42927,2019-11-15,2487,0,2487,187,2674,2674,0,0
42928,2019-11-15,752,0,752,60,812,812,0,0
42929,2019-11-15,2044,0,2044,152,2196,0,0,2196
42930,2019-11-15,1160,0,1160,92,1252,1252,0,0
42931,2019-11-15,400,0,400,32,432,432,0,0
42932,2019-11-15,568,0,568,45,613,0,613,0
42933,2019-11-15,652,0,652,52,704,704,0,0
42934,2019-11-15,422,0,422,22,444,444,0,0
42935,2019-11-15,288,0,288,23,311,0,311,0
42936,2019-11-15,594,0,594,47,641,641,0,0
42937,2019-11-15,1059,0,1059,84,1143,1143,0,0
42938,2019-11-15,1782,0,1782,178,1960,1960,0,0
42939,2019-11-15,260,0,260,20,280,280,0,0
42940,2019-11-15,1782,0,1782,178,1960,1960,0,0
42941,2019-11-15,492,0,492,39,531,531,0,0
42942,2019-11-15,3564,0,3564,356,3920,3920,0,0
42943,2019-11-15,741,0,741,59,800,800,0,0
42944,2019-11-15,492,0,492,39,531,531,0,0
42945,2019-11-15,1188,0,1188,104,1292,1292,0,0
42946,2019-11-15,1529,0,1529,152,1681,1681,0,0
42947,2019-11-15,482,0,482,38,520,0,520,0
42948,2019-11-15,270,0,270,21,291,291,0,0
42949,2019-11-15,335,0,335,26,361,361,0,0
42950,2019-11-15,139,0,139,11,150,150,0,0
42951,2019-11-15,463,0,463,37,500,500,0,0
42952,2019-11-15,779,0,779,62,841,841,0,0
42953,2019-11-15,677,0,677,67,744,0,744,0
42954,2019-11-15,612,0,612,61,673,673,0,0
42955,2019-11-15,1201,0,1201,96,1297,1297,0,0
42956,2019-11-15,371,0,371,29,400,400,0,0
42957,2019-11-15,538,0,538,43,581,581,0,0
42958,2019-11-15,1305,0,1305,130,1435,1435,0,0
42959,2019-11-15,740,0,740,59,799,799,0,0
42960,2019-11-15,140,0,140,11,151,151,0,0
42961,2019-11-15,334,0,334,26,360,360,0,0
42962,2019-11-15,509,0,509,50,559,559,0,0
42963,2019-11-15,1345,-500,845,67,912,0,0,912
42964,2019-11-15,417,0,417,33,450,450,0,0
42965,2019-11-15,670,0,670,53,723,723,0,0
42966,2019-11-15,1904,0,1904,168,2072,2072,0,0
42967,2019-11-15,473,0,473,37,510,510,0,0
42968,2019-11-15,306,0,306,24,330,0,330,0
42969,2019-11-15,966,0,966,77,1043,1043,0,0
42970,2019-11-15,1191,0,1191,95,1286,1286,0,0
42971,2019-11-15,1354,0,1354,108,1462,1462,0,0
42972,2019-11-15,761,0,761,60,821,821,0,0
42973,2019-11-15,538,0,538,43,581,581,0,0
42974,2019-11-15,464,0,464,37,501,501,0,0
42975,2019-11-15,520,-33,487,48,535,535,0,0
42976,2019-11-15,484,0,484,38,522,522,0,0
42977,2019-11-15,706,0,706,56,762,762,0,0
42978,2019-11-15,278,0,278,22,300,300,0,0
42979,2019-11-15,815,0,815,81,896,0,896,0
42980,2019-11-15,1224,0,1224,97,1321,1321,0,0
42981,2019-11-15,2387,0,2387,238,2625,2625,0,0
42982,2019-11-15,891,0,891,89,980,980,0,0
42983,2019-11-15,603,0,603,48,651,651,0,0
42984,2019-11-15,382,0,382,30,412,412,0,0
42985,2019-11-15,740,0,740,74,814,814,0,0
42986,2019-11-15,584,0,584,46,630,0,0,630
42987,2019-11-15,1782,0,1782,178,1960,0,0,1960
42988,2019-11-15,464,0,464,37,501,501,0,0
42989,2019-11-15,763,-152,611,48,659,659,0,0
42990,2019-11-15,795,0,795,79,874,0,874,0
42991,2019-11-15,773,0,773,77,850,0,850,0
42992,2019-11-15,1244,0,1244,124,1368,1368,0,0
42993,2019-11-15,773,0,773,77,850,850,0,0
42994,2019-11-15,1546,0,1546,154,1700,1700,0,0
42995,2019-11-15,1928,0,1928,192,2120,0,2120,0
42996,2019-11-15,832,0,832,66,898,898,0,0
42997,2019-11-15,1546,0,1546,154,1700,0,1700,0
42998,2019-11-15,1209,0,1209,96,1305,1305,0,0
42999,2019-11-15,1546,0,1546,154,1700,1700,0,0
43000,2019-11-15,1420,0,1420,113,1533,1533,0,0
43001,2019-11-15,250,0,250,20,270,270,0,0
43002,2019-11-15,176,0,176,14,190,0,190,0
43003,2019-11-15,909,0,909,72,981,981,0,0
43004,2019-11-15,773,0,773,77,850,850,0,0
43005,2019-11-15,773,0,773,77,850,850,0,0
43006,2019-11-15,593,0,593,47,640,0,0,640
43007,2019-11-15,269,0,269,21,290,0,290,0
43008,2019-11-15,188,0,188,15,203,203,0,0
43009,2019-11-15,3564,0,3564,356,3920,0,3920,0
43010,2019-11-15,362,0,362,28,390,390,0,0
43011,2019-11-15,260,0,260,20,280,280,0,0
43012,2019-11-15,473,0,473,37,510,510,0,0
43013,2019-11-15,733,-73,660,52,712,712,0,0
43014,2019-11-15,464,0,464,37,501,501,0,0
43015,2019-11-15,816,0,816,65,881,881,0,0
43016,2019-11-15,882,0,882,70,952,952,0,0
43017,2019-11-15,214,0,214,21,235,235,0,0
43018,2019-11-15,484,0,484,38,522,522,0,0
43019,2019-11-15,232,0,232,18,250,250,0,0
43020,2019-11-15,260,0,260,20,280,280,0,0
43021,2019-11-15,139,0,139,11,150,150,0,0
43022,2019-11-15,167,0,167,13,180,180,0,0
43023,2019-11-15,241,0,241,19,260,260,0,0
43024,2019-11-15,436,0,436,34,470,470,0,0
43025,2019-11-15,195,0,195,15,210,210,0,0
43026,2019-11-15,946,0,946,75,1021,1021,0,0
43027,2019-11-15,325,0,325,26,351,351,0,0
43028,2019-11-15,1819,0,1819,181,2000,2000,0,0
43029,2019-11-15,1974,0,1974,197,2171,2171,0,0
43030,2019-11-15,734,0,734,58,792,792,0,0
43031,2019-11-15,1467,0,1467,106,1573,1573,0,0
43032,2019-11-15,1274,0,1274,90,1364,0,1364,0
43033,2019-11-15,1105,0,1105,88,1193,1193,0,0
43034,2019-11-15,538,0,538,43,581,581,0,0
43035,2019-11-15,816,0,816,65,881,881,0,0
43036,2019-11-15,817,0,817,73,890,890,0,0
43037,2019-11-15,445,0,445,35,480,480,0,0
43038,2019-11-15,845,0,845,84,929,929,0,0
43039,2019-11-15,353,0,353,28,381,381,0,0
43040,2019-11-15,891,0,891,89,980,980,0,0
43041,2019-11-15,260,0,260,20,280,280,0,0
43042,2019-11-15,695,0,695,55,750,750,0,0
43043,2019-11-15,585,0,585,46,631,0,631,0
43044,2019-11-15,1074,0,1074,85,1159,1159,0,0
43045,2019-11-15,343,0,343,27,370,370,0,0
43046,2019-11-15,753,0,753,60,813,813,0,0
43047,2019-11-15,1021,0,1021,70,1091,1091,0,0
43048,2019-11-15,1777,0,1777,177,1954,1954,0,0
43049,2019-11-15,1419,0,1419,113,1532,1532,0,0
43050,2019-11-15,297,0,297,23,320,320,0,0
43051,2019-11-15,1546,0,1546,154,1700,1700,0,0
43052,2019-11-15,1541,0,1541,123,1664,1664,0,0
43053,2019-11-15,909,-90,819,65,884,0,884,0
43054,2019-11-15,1232,0,1232,123,1355,1355,0,0
43055,2019-11-15,899,0,899,71,970,970,0,0
43056,2019-11-15,371,0,371,29,400,400,0,0
43057,2019-11-15,566,0,566,45,611,611,0,0
43058,2019-11-15,343,0,343,27,370,370,0,0
43059,2019-11-15,278,0,278,22,300,300,0,0
43060,2019-11-15,640,-64,576,46,622,622,0,0
43061,2019-11-15,1271,0,1271,101,1372,1372,0,0
43062,2019-11-15,250,0,250,20,270,270,0,0
43063,2019-11-15,297,0,297,23,320,320,0,0
43064,2019-11-15,834,0,834,66,900,900,0,0
43065,2019-11-15,584,0,584,46,630,630,0,0
43066,2019-11-15,705,-70,635,50,685,685,0,0
43067,2019-11-16,861,0,861,68,929,929,0,0
43068,2019-11-16,512,0,512,29,541,541,0,0
43069,2019-11-16,297,0,297,29,326,326,0,0
43070,2019-11-16,1782,0,1782,178,1960,1960,0,0
43071,2019-11-16,492,0,492,39,531,531,0,0
43072,2019-11-16,891,0,891,89,980,980,0,0
43073,2019-11-16,417,0,417,33,450,450,0,0
43074,2019-11-16,306,0,306,24,330,330,0,0
43075,2019-11-16,242,0,242,19,261,261,0,0
43076,2019-11-16,1782,0,1782,178,1960,1960,0,0
43077,2019-11-16,491,0,491,49,540,540,0,0
43078,2019-11-16,567,0,567,45,612,612,0,0
43079,2019-11-16,260,-26,234,18,252,0,252,0
43080,2019-11-16,1170,0,1170,93,1263,1263,0,0
43081,2019-11-16,714,0,714,57,771,771,0,0
43082,2019-11-16,891,0,891,89,980,980,0,0
43083,2019-11-16,622,0,622,49,671,671,0,0
43084,2019-11-16,288,0,288,23,311,311,0,0
43085,2019-11-16,1402,0,1402,112,1514,1514,0,0
43086,2019-11-16,1040,0,1040,83,1123,1123,0,0
43087,2019-11-16,1298,-129,1169,116,1285,0,0,1285
43088,2019-11-16,1718,0,1718,171,1889,1889,0,0
43089,2019-11-16,297,0,297,23,320,320,0,0
43090,2019-11-16,882,0,882,70,952,952,0,0
43091,2019-11-16,529,0,529,42,571,571,0,0
43092,2019-11-16,279,0,279,22,301,301,0,0
43093,2019-11-16,1180,0,1180,94,1274,0,1274,0
43094,2019-11-16,491,0,491,49,540,540,0,0
43095,2019-11-16,1010,0,1010,101,1111,1111,0,0
43096,2019-11-16,2673,0,2673,267,2940,0,2940,0
43097,2019-11-16,2673,0,2673,267,2940,2940,0,0
43098,2019-11-16,584,0,584,46,630,630,0,0
43099,2019-11-16,584,0,584,46,630,0,630,0
43100,2019-11-16,742,0,742,59,801,801,0,0
43101,2019-11-16,751,0,751,60,811,811,0,0
43102,2019-11-16,1493,0,1493,149,1642,1642,0,0
43103,2019-11-16,1782,0,1782,178,1960,1960,0,0
43104,2019-11-16,1383,0,1383,110,1493,1493,0,0
43105,2019-11-16,1383,-138,1245,99,1344,1344,0,0
43106,2019-11-16,686,0,686,68,754,0,754,0
43107,2019-11-16,446,0,446,35,481,0,481,0
43108,2019-11-16,436,0,436,34,470,470,0,0
43109,2019-11-16,491,0,491,49,540,540,0,0
43110,2019-11-16,946,0,946,94,1040,1040,0,0
43111,2019-11-16,890,0,890,89,979,0,979,0
43112,2019-11-16,1226,0,1226,98,1324,0,1324,0
43113,2019-11-16,1003,0,1003,80,1083,1083,0,0
43114,2019-11-16,1282,0,1282,102,1384,1384,0,0
43115,2019-11-16,511,0,511,40,551,551,0,0
43116,2019-11-16,251,0,251,20,271,271,0,0
43117,2019-11-16,745,0,745,48,793,0,0,793
43118,2019-11-16,362,0,362,28,390,390,0,0
43119,2019-11-16,920,0,920,73,993,993,0,0
43120,2019-11-16,1104,0,1104,88,1192,1192,0,0
43121,2019-11-16,492,0,492,39,531,531,0,0
43122,2019-11-16,1782,0,1782,178,1960,1960,0,0
43123,2019-11-16,540,0,540,43,583,583,0,0
43124,2019-11-16,604,0,604,60,664,664,0,0
43125,2019-11-16,241,0,241,19,260,260,0,0
43126,2019-11-16,446,0,446,35,481,481,0,0
43127,2019-11-16,370,0,370,29,399,399,0,0
43128,2019-11-16,370,0,370,29,399,399,0,0
43129,2019-11-16,473,-47,426,34,460,0,0,460
43130,2019-11-16,186,0,186,14,200,200,0,0
43131,2019-11-16,566,0,566,45,611,611,0,0
43132,2019-11-16,799,0,799,63,862,0,0,862
43133,2019-11-16,1197,0,1197,119,1316,1316,0,0
43134,2019-11-16,724,0,724,57,781,781,0,0
43135,2019-11-16,455,0,455,36,491,0,491,0
43136,2019-11-16,121,0,121,9,130,130,0,0
43137,2019-11-16,399,0,399,39,438,0,438,0
43138,2019-11-16,908,0,908,90,998,998,0,0
43139,2019-11-16,678,0,678,54,732,0,732,0
43140,2019-11-16,381,0,381,30,411,0,411,0
43141,2019-11-16,334,0,334,26,360,360,0,0
43142,2019-11-16,510,0,510,51,561,561,0,0
43143,2019-11-16,250,0,250,20,270,0,270,0
43144,2019-11-16,740,0,740,74,814,814,0,0
43145,2019-11-16,260,0,260,20,280,280,0,0
43146,2019-11-16,362,0,362,28,390,390,0,0
43147,2019-11-16,362,0,362,28,390,390,0,0
43148,2019-11-16,112,0,112,8,120,120,0,0
43149,2019-11-16,197,0,197,15,212,212,0,0
43150,2019-11-16,1817,0,1817,181,1998,1998,0,0
43151,2019-11-16,464,0,464,37,501,501,0,0
43152,2019-11-16,446,0,446,35,481,481,0,0
43153,2019-11-16,280,0,280,22,302,302,0,0
43154,2019-11-16,1363,0,1363,136,1499,1499,0,0
43155,2019-11-16,743,0,743,59,802,802,0,0
43156,2019-11-16,584,0,584,46,630,630,0,0
43157,2019-11-16,761,0,761,76,837,837,0,0
43158,2019-11-16,1286,0,1286,128,1414,0,0,1414
43159,2019-11-16,121,0,121,9,130,130,0,0
43160,2019-11-16,260,0,260,20,280,280,0,0
43161,2019-11-16,47,0,47,3,50,50,0,0
43162,2019-11-16,417,0,417,33,450,450,0,0
43163,2019-11-16,724,0,724,72,796,796,0,0
43164,2019-11-16,529,0,529,42,571,571,0,0
43165,2019-11-16,345,0,345,34,379,379,0,0
43166,2019-11-16,362,0,362,28,390,390,0,0
43167,2019-11-16,856,0,856,68,924,924,0,0
43168,2019-11-16,473,0,473,37,510,0,0,510
43169,2019-11-16,278,0,278,22,300,300,0,0
43170,2019-11-16,492,0,492,39,531,531,0,0
43171,2019-11-16,2616,0,2616,261,2877,2877,0,0
43172,2019-11-16,325,0,325,26,351,351,0,0
43173,2019-11-16,269,0,269,21,290,290,0,0
43174,2019-11-16,530,0,530,42,572,572,0,0
43175,2019-11-16,770,0,770,77,847,847,0,0
43176,2019-11-16,232,0,232,18,250,250,0,0
43177,2019-11-16,1027,0,1027,102,1129,0,0,1129
43178,2019-11-16,980,0,980,98,1078,0,1078,0
43179,2019-11-16,372,0,372,29,401,401,0,0
43180,2019-11-16,780,0,780,62,842,842,0,0
43181,2019-11-16,-1383,0,-1383,-110,-1493,-1493,0,0
43182,2019-11-16,-584,0,-584,-46,-630,-630,0,0
43183,2019-11-16,167,0,167,13,180,180,0,0
43184,2019-11-16,594,0,594,47,641,0,0,641
43185,2019-11-16,575,0,575,46,621,621,0,0
43186,2019-11-16,1012,0,1012,80,1092,1092,0,0
43187,2019-11-16,1181,0,1181,83,1264,1264,0,0
43188,2019-11-16,390,0,390,31,421,421,0,0
43189,2019-11-16,278,0,278,22,300,300,0,0
43190,2019-11-16,233,0,233,18,251,251,0,0
43191,2019-11-16,473,0,473,37,510,510,0,0
43192,2019-11-16,269,0,269,21,290,290,0,0
43193,2019-11-16,1178,0,1178,94,1272,1272,0,0
43194,2019-11-16,112,0,112,8,120,120,0,0
43195,2019-11-16,502,0,502,40,542,542,0,0
43196,2019-11-16,2319,0,2319,231,2550,2550,0,0
43197,2019-11-16,2472,0,2472,228,2700,2700,0,0
43198,2019-11-16,1819,0,1819,181,2000,2000,0,0
43199,2019-11-16,1819,0,1819,181,2000,2000,0,0
43200,2019-11-16,455,0,455,36,491,491,0,0
43201,2019-11-16,1046,0,1046,98,1144,0,0,1144
43202,2019-11-16,1046,0,1046,104,1150,0,1150,0
43203,2019-11-16,1546,0,1546,154,1700,1700,0,0
43204,2019-11-16,773,0,773,77,850,850,0,0
43205,2019-11-16,773,0,773,77,850,0,850,0
43206,2019-11-16,1002,0,1002,80,1082,1082,0,0
43207,2019-11-16,538,0,538,43,581,581,0,0
43208,2019-11-16,835,0,835,66,901,901,0,0
43209,2019-11-16,1113,0,1113,89,1202,1202,0,0
43210,2019-11-16,1546,0,1546,154,1700,1700,0,0
43211,2019-11-16,585,0,585,46,631,631,0,0
43212,2019-11-16,541,0,541,43,584,584,0,0
43213,2019-11-16,661,0,661,52,713,713,0,0
43214,2019-11-16,773,0,773,77,850,850,0,0
43215,2019-11-16,112,0,112,8,120,120,0,0
43216,2019-11-16,1909,0,1909,190,2099,0,2099,0
43217,2019-11-16,260,0,260,20,280,280,0,0
43218,2019-11-16,278,0,278,22,300,300,0,0
43219,2019-11-16,529,0,529,42,571,571,0,0
43220,2019-11-16,826,0,826,66,892,892,0,0
43221,2019-11-16,370,0,370,29,399,399,0,0
43222,2019-11-16,509,0,509,50,559,559,0,0
43223,2019-11-16,297,0,297,23,320,320,0,0
43224,2019-11-16,362,0,362,28,390,390,0,0
43225,2019-11-16,549,0,549,43,592,592,0,0
43226,2019-11-16,399,0,399,39,438,438,0,0
43227,2019-11-16,251,0,251,20,271,271,0,0
43228,2019-11-16,2204,0,2204,220,2424,2424,0,0
43229,2019-11-16,139,0,139,11,150,150,0,0
43230,2019-11-16,854,0,854,68,922,922,0,0
43231,2019-11-16,1002,0,1002,80,1082,1082,0,0
43232,2019-11-16,548,0,548,43,591,591,0,0
43233,2019-11-16,309,0,309,24,333,333,0,0
43234,2019-11-16,575,0,575,46,621,621,0,0
43235,2019-11-16,260,0,260,20,280,280,0,0
43236,2019-11-16,510,0,510,40,550,550,0,0
43237,2019-11-16,1260,0,1260,126,1386,1386,0,0
43238,2019-11-16,724,0,724,57,781,781,0,0
43239,2019-11-16,433,0,433,34,467,467,0,0
43240,2019-11-16,1372,0,1372,137,1509,1509,0,0
43241,2019-11-16,1381,0,1381,138,1519,0,1519,0
43242,2019-11-16,1142,0,1142,91,1233,1233,0,0
43243,2019-11-16,1286,-128,1158,115,1273,0,1273,0
43244,2019-11-16,565,0,565,56,621,621,0,0
43245,2019-11-16,832,0,832,83,915,0,915,0
43246,2019-11-16,1862,0,1862,186,2048,0,2048,0
43247,2019-11-16,269,0,269,21,290,290,0,0
43248,2019-11-16,455,0,455,36,491,491,0,0
43249,2019-11-16,454,0,454,36,490,490,0,0
43250,2019-11-16,773,0,773,77,850,850,0,0
43251,2019-11-16,436,0,436,34,470,470,0,0
43252,2019-11-16,334,0,334,26,360,360,0,0
43253,2019-11-16,446,0,446,35,481,481,0,0
43254,2019-11-16,760,0,760,60,820,820,0,0
43255,2019-11-16,1968,0,1968,157,2125,0,0,2125
43256,2019-11-16,3202,0,3202,256,3458,0,3458,0
43257,2019-11-16,1801,0,1801,121,1922,1922,0,0
43258,2019-11-16,343,0,343,27,370,370,0,0
43259,2019-11-16,715,0,715,57,772,772,0,0
43260,2019-11-16,1020,0,1020,81,1101,1101,0,0
43261,2019-11-16,825,0,825,66,891,891,0,0
43262,2019-11-16,612,0,612,48,660,660,0,0
43263,2019-11-16,891,0,891,89,980,0,980,0
43264,2019-11-16,1410,0,1410,112,1522,1522,0,0
43265,2019-11-16,1782,0,1782,178,1960,1960,0,0
43266,2019-11-16,381,0,381,30,411,411,0,0
43267,2019-11-16,334,0,334,26,360,360,0,0
43268,2019-11-16,501,-50,451,36,487,0,0,487
43269,2019-11-16,455,0,455,45,500,500,0,0
43270,2019-11-16,1782,0,1782,178,1960,0,1960,0
43271,2019-11-16,575,0,575,46,621,621,0,0
43272,2019-11-16,334,0,334,26,360,360,0,0
43273,2019-11-16,334,0,334,26,360,360,0,0
43274,2019-11-16,316,0,316,25,341,341,0,0
43275,2019-11-16,2866,0,2866,229,3095,0,0,3095
43276,2019-11-16,299,0,299,23,322,322,0,0
43277,2019-11-16,891,0,891,89,980,980,0,0
43278,2019-11-16,845,0,845,67,912,912,0,0
43279,2019-11-16,2319,0,2319,231,2550,2550,0,0
43280,2019-11-16,1546,0,1546,154,1700,1700,0,0
43281,2019-11-16,740,0,740,74,814,814,0,0
43282,2019-11-16,773,0,773,77,850,850,0,0
43283,2019-11-16,2870,0,2870,287,3157,3157,0,0
43284,2019-11-16,773,0,773,77,850,0,0,850
43285,2019-11-16,705,0,705,56,761,761,0,0
43286,2019-11-16,992,0,992,79,1071,1071,0,0
43287,2019-11-16,214,0,214,17,231,0,231,0
43288,2019-11-16,927,0,927,74,1001,1001,0,0
43289,2019-11-16,863,0,863,57,920,920,0,0
43290,2019-11-16,538,0,538,43,581,581,0,0
43291,2019-11-16,619,0,619,61,680,680,0,0
43292,2019-11-16,1546,0,1546,154,1700,1700,0,0
43293,2019-11-16,770,0,770,61,831,831,0,0
43294,2019-11-16,1546,0,1546,154,1700,0,1700,0
43295,2019-11-16,273,0,273,21,294,0,0,294
43296,2019-11-16,1177,0,1177,94,1271,0,1271,0
43297,2019-11-16,706,0,706,56,762,762,0,0
43298,2019-11-16,306,0,306,24,330,330,0,0
43299,2019-11-16,1586,0,1586,126,1712,0,1712,0
43300,2019-11-16,1546,0,1546,154,1700,1700,0,0
43301,2019-11-16,334,0,334,26,360,360,0,0
43302,2019-11-16,1546,0,1546,154,1700,1700,0,0
43303,2019-11-16,371,0,371,29,400,400,0,0
43304,2019-11-16,1097,0,1097,87,1184,1184,0,0
43305,2019-11-16,1326,0,1326,132,1458,1458,0,0
43306,2019-11-16,882,0,882,70,952,952,0,0
43307,2019-11-17,891,0,891,89,980,980,0,0
43308,2019-11-17,167,0,167,13,180,180,0,0
43309,2019-11-17,806,0,806,80,886,886,0,0
43310,2019-11-17,1782,0,1782,178,1960,1960,0,0
43311,2019-11-17,1559,0,1559,155,1714,1714,0,0
43312,2019-11-17,640,0,640,51,691,691,0,0
43313,2019-11-17,557,0,557,44,601,601,0,0
43314,2019-11-17,742,0,742,59,801,801,0,0
43315,2019-11-17,510,0,510,40,550,550,0,0
43316,2019-11-17,1154,0,1154,92,1246,1246,0,0
43317,2019-11-17,993,0,993,79,1072,0,1072,0
43318,2019-11-17,753,0,753,60,813,0,813,0
43319,2019-11-17,1410,0,1410,112,1522,1522,0,0
43320,2019-11-17,427,0,427,34,461,461,0,0
43321,2019-11-17,891,0,891,89,980,980,0,0
43322,2019-11-17,891,0,891,89,980,980,0,0
43323,2019-11-17,362,0,362,28,390,0,0,390
43324,2019-11-17,288,0,288,23,311,0,0,311
43325,2019-11-17,362,0,362,28,390,390,0,0
43326,2019-11-17,631,0,631,50,681,681,0,0
43327,2019-11-17,344,0,344,27,371,371,0,0
43328,2019-11-17,668,0,668,53,721,721,0,0
43329,2019-11-17,725,0,725,58,783,0,783,0
43330,2019-11-17,548,0,548,32,580,580,0,0
43331,2019-11-17,371,0,371,29,400,400,0,0
43332,2019-11-17,557,0,557,44,601,601,0,0
43333,2019-11-17,446,0,446,44,490,490,0,0
43334,2019-11-17,418,0,418,41,459,0,0,459
43335,2019-11-17,464,0,464,37,501,501,0,0
43336,2019-11-17,649,0,649,64,713,713,0,0
43337,2019-11-17,195,0,195,15,210,0,0,210
43338,2019-11-17,1689,0,1689,135,1824,1824,0,0
43339,2019-11-17,1560,0,1560,156,1716,1716,0,0
43340,2019-11-17,1782,0,1782,178,1960,0,0,1960
43341,2019-11-17,705,0,705,56,761,761,0,0
43342,2019-11-17,492,0,492,39,531,531,0,0
43343,2019-11-17,678,0,678,43,721,721,0,0
43344,2019-11-17,641,0,641,51,692,692,0,0
43345,2019-11-17,628,0,628,62,690,690,0,0
43346,2019-11-17,482,0,482,38,520,520,0,0
43347,2019-11-17,446,0,446,35,481,481,0,0
43348,2019-11-17,399,0,399,31,430,430,0,0
43349,2019-11-17,2181,0,2181,218,2399,0,2399,0
43350,2019-11-17,642,0,642,51,693,693,0,0
43351,2019-11-17,491,0,491,49,540,540,0,0
43352,2019-11-17,370,0,370,37,407,407,0,0
43353,2019-11-17,370,0,370,37,407,407,0,0
43354,2019-11-17,400,0,400,32,432,432,0,0
43355,2019-11-17,1278,0,1278,127,1405,1405,0,0
43356,2019-11-17,639,0,639,51,690,690,0,0
43357,2019-11-17,260,0,260,20,280,280,0,0
43358,2019-11-17,677,0,677,54,731,731,0,0
43359,2019-11-17,649,0,649,51,700,700,0,0
43360,2019-11-17,1575,0,1575,157,1732,0,1732,0
43361,2019-11-17,437,0,437,34,471,0,471,0
43362,2019-11-17,502,0,502,40,542,542,0,0
43363,2019-11-17,723,0,723,72,795,795,0,0
43364,2019-11-17,1020,0,1020,102,1122,1122,0,0
43365,2019-11-17,640,0,640,64,704,0,704,0
43366,2019-11-17,713,0,713,71,784,784,0,0
43367,2019-11-17,687,0,687,54,741,741,0,0
43368,2019-11-17,1086,0,1086,86,1172,1172,0,0
43369,2019-11-17,761,0,761,60,821,821,0,0
43370,2019-11-17,891,0,891,89,980,980,0,0
43371,2019-11-17,891,0,891,89,980,980,0,0
43372,2019-11-17,743,0,743,59,802,802,0,0
43373,2019-11-17,1753,0,1753,175,1928,1928,0,0
43374,2019-11-17,1457,0,1457,145,1602,1602,0,0
43375,2019-11-17,436,0,436,34,470,470,0,0
43376,2019-11-17,741,0,741,74,815,815,0,0
43377,2019-11-17,1334,0,1334,133,1467,1467,0,0
43378,2019-11-17,1187,0,1187,94,1281,1281,0,0
43379,2019-11-17,269,0,269,21,290,290,0,0
43380,2019-11-17,773,0,773,77,850,850,0,0
43381,2019-11-17,773,0,773,77,850,850,0,0
43382,2019-11-17,1546,0,1546,154,1700,1700,0,0
43383,2019-11-17,873,0,873,73,946,946,0,0
43384,2019-11-17,1546,0,1546,154,1700,0,1700,0
43385,2019-11-17,602,0,602,60,662,662,0,0
43386,2019-11-17,1546,0,1546,154,1700,1700,0,0
43387,2019-11-17,640,0,640,51,691,691,0,0
43388,2019-11-17,1547,0,1547,154,1701,1701,0,0
43389,2019-11-17,167,0,167,13,180,180,0,0
43390,2019-11-17,1864,0,1864,149,2013,0,0,2013
43391,2019-11-17,742,0,742,59,801,801,0,0
43392,2019-11-17,1546,0,1546,154,1700,1700,0,0
43393,2019-11-17,1546,0,1546,154,1700,1700,0,0
43394,2019-11-17,269,0,269,21,290,0,0,290
43395,2019-11-17,269,0,269,21,290,290,0,0
43396,2019-11-17,1093,0,1093,109,1202,0,0,1202
43397,2019-11-17,465,0,465,37,502,502,0,0
43398,2019-11-17,269,0,269,21,290,290,0,0
43399,2019-11-17,370,0,370,37,407,407,0,0
43400,2019-11-17,370,0,370,37,407,407,0,0
43401,2019-11-17,2534,0,2534,202,2736,2736,0,0
43402,2019-11-17,362,0,362,28,390,390,0,0
43403,2019-11-17,352,0,352,35,387,387,0,0
43404,2019-11-17,352,0,352,35,387,387,0,0
43405,2019-11-17,352,0,352,35,387,387,0,0
43406,2019-11-17,390,0,390,31,421,421,0,0
43407,2019-11-17,944,0,944,94,1038,1038,0,0
43408,2019-11-17,603,0,603,48,651,651,0,0
43409,2019-11-17,492,0,492,39,531,531,0,0
43410,2019-11-17,436,-87,349,27,376,0,0,376
43411,2019-11-17,621,0,621,62,683,0,683,0
43412,2019-11-17,1695,0,1695,169,1864,1864,0,0
43413,2019-11-17,1612,0,1612,161,1773,1773,0,0
43414,2019-11-17,208,0,208,16,224,224,0,0
43415,2019-11-17,593,0,593,59,652,652,0,0
43416,2019-11-17,176,0,176,14,190,190,0,0
43417,2019-11-17,1627,0,1627,130,1757,0,1757,0
43418,2019-11-17,139,0,139,11,150,150,0,0
43419,2019-11-17,362,0,362,28,390,390,0,0
43420,2019-11-17,251,0,251,20,271,271,0,0
43421,2019-11-17,1601,0,1601,160,1761,1761,0,0
43422,2019-11-17,270,0,270,21,291,291,0,0
43423,2019-11-17,984,0,984,78,1062,1062,0,0
43424,2019-11-17,510,0,510,40,550,550,0,0
43425,2019-11-17,1077,0,1077,86,1163,1163,0,0
43426,2019-11-17,891,0,891,89,980,980,0,0
43427,2019-11-17,891,0,891,71,962,962,0,0
43428,2019-11-17,628,0,628,62,690,690,0,0
43429,2019-11-17,251,0,251,25,276,276,0,0
43430,2019-11-17,371,-37,334,26,360,360,0,0
43431,2019-11-17,1177,0,1177,117,1294,1294,0,0
43432,2019-11-17,1299,0,1299,103,1402,1402,0,0
43433,2019-11-17,761,0,761,49,810,810,0,0
43434,2019-11-17,390,0,390,31,421,421,0,0
43435,2019-11-17,773,0,773,77,850,850,0,0
43436,2019-11-17,773,0,773,77,850,0,850,0
43437,2019-11-17,773,0,773,77,850,850,0,0
43438,2019-11-17,773,0,773,77,850,0,0,850
43439,2019-11-17,250,0,250,25,275,275,0,0
43440,2019-11-17,1021,0,1021,81,1102,1102,0,0
43441,2019-11-17,773,0,773,77,850,850,0,0
43442,2019-11-17,446,0,446,35,481,481,0,0
43443,2019-11-17,140,0,140,0,140,140,0,0
43444,2019-11-17,352,0,352,35,387,387,0,0
43445,2019-11-17,334,0,334,26,360,360,0,0
43446,2019-11-17,334,0,334,26,360,360,0,0
43447,2019-11-17,602,0,602,60,662,662,0,0
43448,2019-11-17,595,0,595,47,642,0,0,642
43449,2019-11-17,650,0,650,52,702,702,0,0
43450,2019-11-18,335,0,335,33,368,0,0,368
43451,2019-11-18,399,0,399,39,438,438,0,0
43452,2019-11-18,399,0,399,39,438,438,0,0
43453,2019-11-18,260,0,260,20,280,280,0,0
43454,2019-11-18,112,0,112,11,123,123,0,0
43455,2019-11-18,704,0,704,56,760,760,0,0
43456,2019-11-18,102,0,102,10,112,112,0,0
43457,2019-11-18,918,0,918,73,991,991,0,0
43458,2019-11-18,269,0,269,21,290,290,0,0
43459,2019-11-18,306,0,306,24,330,0,330,0
43460,2019-11-18,1185,0,1185,94,1279,1279,0,0
43461,2019-11-18,1027,0,1027,102,1129,1129,0,0
43462,2019-11-18,740,0,740,74,814,814,0,0
43463,2019-11-18,529,0,529,42,571,571,0,0
43464,2019-11-18,1204,0,1204,120,1324,1324,0,0
43465,2019-11-18,825,0,825,66,891,891,0,0
43466,2019-11-18,1352,0,1352,135,1487,1487,0,0
43467,2019-11-18,620,0,620,62,682,682,0,0
43468,2019-11-18,501,0,501,40,541,541,0,0
43469,2019-11-18,1326,0,1326,106,1432,1432,0,0
43470,2019-11-18,891,0,891,89,980,980,0,0
43471,2019-11-18,288,0,288,28,316,316,0,0
43472,2019-11-18,214,0,214,17,231,0,0,231
43473,2019-11-18,547,0,547,43,590,590,0,0
43474,2019-11-18,391,0,391,31,422,0,422,0
43475,2019-11-18,649,0,649,64,713,713,0,0
43476,2019-11-18,537,0,537,53,590,590,0,0
43477,2019-11-18,352,0,352,28,380,380,0,0
43478,2019-11-18,1102,0,1102,110,1212,1212,0,0
43479,2019-11-18,362,-36,326,26,352,352,0,0
43480,2019-11-18,316,0,316,25,341,341,0,0
43481,2019-11-18,2079,-207,1872,149,2021,2021,0,0
43482,2019-11-18,1149,0,1149,114,1263,1263,0,0
43483,2019-11-18,464,0,464,37,501,501,0,0
43484,2019-11-18,686,0,686,54,740,740,0,0
43485,2019-11-18,676,0,676,67,743,743,0,0
43486,2019-11-18,855,0,855,68,923,0,0,923
43487,2019-11-18,417,0,417,33,450,450,0,0
43488,2019-11-18,389,0,389,31,420,420,0,0
43489,2019-11-18,1501,0,1501,150,1651,1651,0,0
43490,2019-11-18,1558,0,1558,124,1682,1682,0,0
43491,2019-11-18,1141,0,1141,91,1232,1232,0,0
43492,2019-11-18,492,0,492,39,531,531,0,0
43493,2019-11-18,1106,0,1106,88,1194,1194,0,0
43494,2019-11-18,1224,0,1224,97,1321,1321,0,0
43495,2019-11-18,278,0,278,22,300,300,0,0
43496,2019-11-18,260,0,260,20,280,280,0,0
43497,2019-11-18,1563,0,1563,156,1719,1719,0,0
43498,2019-11-18,372,0,372,29,401,401,0,0
43499,2019-11-18,102,0,102,8,110,110,0,0
43500,2019-11-18,335,0,335,26,361,361,0,0
43501,2019-11-18,519,0,519,41,560,560,0,0
43502,2019-11-18,316,0,316,25,341,341,0,0
43503,2019-11-18,929,0,929,74,1003,1003,0,0
43504,2019-11-18,251,0,251,25,276,276,0,0
43505,2019-11-18,288,0,288,23,311,311,0,0
43506,2019-11-18,455,0,455,36,491,0,491,0
43507,2019-11-18,269,0,269,21,290,290,0,0
43508,2019-11-18,779,0,779,62,841,841,0,0
43509,2019-11-18,1782,0,1782,178,1960,0,1960,0
43510,2019-11-18,390,0,390,31,421,421,0,0
43511,2019-11-18,1539,0,1539,123,1662,0,1662,0
43512,2019-11-18,705,0,705,56,761,761,0,0
43513,2019-11-18,390,0,390,39,429,429,0,0
43514,2019-11-18,631,0,631,50,681,681,0,0
43515,2019-11-18,640,0,640,51,691,691,0,0
43516,2019-11-18,773,0,773,77,850,0,850,0
43517,2019-11-18,1546,-154,1392,139,1531,1531,0,0
43518,2019-11-18,3092,0,3092,309,3401,3401,0,0
43519,2019-11-18,186,-37,149,11,160,160,0,0
43520,2019-11-18,818,-163,655,52,707,707,0,0
43521,2019-11-18,168,0,168,13,181,181,0,0
43522,2019-11-18,926,0,926,92,1018,1018,0,0
43523,2019-11-18,873,0,873,69,942,942,0,0
43524,2019-11-18,538,-53,485,38,523,0,523,0
43525,2019-11-18,549,0,549,43,592,592,0,0
43526,2019-11-18,381,0,381,30,411,411,0,0
43527,2019-11-18,576,0,576,46,622,622,0,0
43528,2019-11-18,232,0,232,18,250,250,0,0
43529,2019-11-18,455,0,455,36,491,491,0,0
43530,2019-11-18,853,0,853,85,938,938,0,0
43531,2019-11-18,1133,0,1133,90,1223,1223,0,0
43532,2019-11-18,409,0,409,32,441,441,0,0
43533,2019-11-18,352,0,352,28,380,380,0,0
43534,2019-11-18,232,0,232,18,250,250,0,0
43535,2019-11-18,232,0,232,18,250,250,0,0
43536,2019-11-18,260,0,260,20,280,280,0,0
43537,2019-11-18,605,0,605,48,653,653,0,0
43538,2019-11-18,93,0,93,9,102,102,0,0
43539,2019-11-18,835,-167,668,53,721,721,0,0
43540,2019-11-18,436,0,436,34,470,0,0,470
43541,2019-11-18,139,0,139,11,150,150,0,0
43542,2019-11-18,798,0,798,63,861,861,0,0
43543,2019-11-18,214,0,214,17,231,231,0,0
43544,2019-11-18,492,0,492,49,541,541,0,0
43545,2019-11-18,288,0,288,23,311,311,0,0
43546,2019-11-18,418,0,418,33,451,451,0,0
43547,2019-11-18,1782,0,1782,178,1960,1960,0,0
43548,2019-11-18,742,0,742,59,801,801,0,0
43549,2019-11-18,1393,0,1393,111,1504,0,1504,0
43550,2019-11-18,898,0,898,89,987,0,0,987
43551,2019-11-18,1030,0,1030,82,1112,1112,0,0
43552,2019-11-18,445,0,445,35,480,480,0,0
43553,2019-11-18,891,0,891,89,980,980,0,0
43554,2019-11-18,612,0,612,48,660,660,0,0
43555,2019-11-18,891,0,891,89,980,980,0,0
43556,2019-11-18,612,0,612,48,660,660,0,0
43557,2019-11-18,891,0,891,89,980,980,0,0
43558,2019-11-18,752,0,752,60,812,812,0,0
43559,2019-11-18,779,0,779,62,841,841,0,0
43560,2019-11-18,668,0,668,53,721,721,0,0
43561,2019-11-18,891,0,891,89,980,0,980,0
43562,2019-11-18,408,0,408,32,440,440,0,0
43563,2019-11-18,826,0,826,66,892,892,0,0
43564,2019-11-18,855,0,855,68,923,0,923,0
43565,2019-11-18,1280,0,1280,128,1408,0,1408,0
43566,2019-11-18,427,0,427,34,461,461,0,0
43567,2019-11-18,854,0,854,68,922,922,0,0
43568,2019-11-18,381,0,381,30,411,411,0,0
43569,2019-11-18,308,0,308,24,332,332,0,0
43570,2019-11-18,891,0,891,89,980,980,0,0
43571,2019-11-18,660,0,660,52,712,0,712,0
43572,2019-11-19,547,0,547,43,590,590,0,0
43573,2019-11-19,230,0,230,18,248,0,0,248
43574,2019-11-19,417,0,417,33,450,450,0,0
43575,2019-11-19,326,0,326,26,352,352,0,0
43576,2019-11-19,538,0,538,43,581,0,0,581
43577,2019-11-19,575,0,575,57,632,632,0,0
43578,2019-11-19,445,0,445,35,480,480,0,0
43579,2019-11-19,408,0,408,32,440,440,0,0
43580,2019-11-19,769,0,769,76,845,845,0,0
43581,2019-11-19,334,0,334,26,360,360,0,0
43582,2019-11-19,585,0,585,46,631,631,0,0
43583,2019-11-19,736,0,736,58,794,794,0,0
43584,2019-11-19,195,0,195,15,210,210,0,0
43585,2019-11-19,139,0,139,11,150,150,0,0
43586,2019-11-19,1038,0,1038,103,1141,1141,0,0
43587,2019-11-19,1032,0,1032,82,1114,1114,0,0
43588,2019-11-19,139,0,139,11,150,150,0,0
43589,2019-11-19,1224,0,1224,97,1321,1321,0,0
43590,2019-11-20,916,0,916,91,1007,1007,0,0
43591,2019-11-20,1782,0,1782,178,1960,0,1960,0
43592,2019-11-20,1305,0,1305,130,1435,1435,0,0
43593,2019-11-20,2673,0,2673,267,2940,2940,0,0
43594,2019-11-20,371,0,371,29,400,400,0,0
43595,2019-11-20,669,0,669,53,722,722,0,0
43596,2019-11-20,394,0,394,31,425,425,0,0
43597,2019-11-20,1782,0,1782,178,1960,0,1960,0
43598,2019-11-20,557,0,557,44,601,601,0,0
43599,2019-11-20,167,0,167,13,180,180,0,0
43600,2019-11-20,891,0,891,89,980,980,0,0
43601,2019-11-20,977,0,977,78,1055,1055,0,0
43602,2019-11-20,891,0,891,89,980,980,0,0
43603,2019-11-20,1835,0,1835,146,1981,1981,0,0
43604,2019-11-20,937,0,937,74,1011,1011,0,0
43605,2019-11-20,586,0,586,46,632,0,632,0
43606,2019-11-20,807,0,807,80,887,887,0,0
43607,2019-11-20,149,0,149,11,160,160,0,0
43608,2019-11-20,464,0,464,37,501,501,0,0
43609,2019-11-20,1000,0,1000,100,1100,1100,0,0
43610,2019-11-20,595,0,595,47,642,0,642,0
43611,2019-11-20,891,0,891,89,980,0,980,0
43612,2019-11-20,1782,0,1782,178,1960,1960,0,0
43613,2019-11-20,352,0,352,35,387,387,0,0
43614,2019-11-20,993,0,993,79,1072,1072,0,0
43615,2019-11-20,872,0,872,69,941,941,0,0
43616,2019-11-20,891,0,891,89,980,980,0,0
43617,2019-11-20,139,0,139,11,150,0,0,150
43618,2019-11-20,260,0,260,20,280,280,0,0
43619,2019-11-20,650,0,650,52,702,702,0,0
43620,2019-11-20,688,0,688,55,743,743,0,0
43621,2019-11-20,167,0,167,16,183,183,0,0
43622,2019-11-20,3696,-739,2957,236,3193,3193,0,0
43623,2019-11-20,288,0,288,23,311,311,0,0
43624,2019-11-20,982,0,982,98,1080,1080,0,0
43625,2019-11-20,353,0,353,28,381,381,0,0
43626,2019-11-20,325,0,325,26,351,351,0,0
43627,2019-11-20,352,0,352,35,387,387,0,0
43628,2019-11-20,279,0,279,22,301,301,0,0
43629,2019-11-20,537,0,537,53,590,590,0,0
43630,2019-11-20,715,-500,215,17,232,232,0,0
43631,2019-11-20,269,0,269,21,290,290,0,0
43632,2019-11-20,510,0,510,40,550,0,550,0
43633,2019-11-20,1170,-1000,170,13,183,183,0,0
43634,2019-11-20,436,0,436,34,470,470,0,0
43635,2019-11-20,535,0,535,42,577,577,0,0
43636,2019-11-20,409,0,409,32,441,441,0,0
43637,2019-11-20,222,0,222,17,239,239,0,0
43638,2019-11-20,660,0,660,52,712,712,0,0
43639,2019-11-20,325,0,325,26,351,351,0,0
43640,2019-11-20,612,0,612,48,660,660,0,0
43641,2019-11-20,242,0,242,19,261,261,0,0
43642,2019-11-20,628,0,628,62,690,0,690,0
43643,2019-11-20,491,0,491,49,540,540,0,0
43644,2019-11-20,334,-33,301,24,325,325,0,0
43645,2019-11-20,761,0,761,60,821,821,0,0
43646,2019-11-20,566,0,566,45,611,611,0,0
43647,2019-11-20,733,0,733,58,791,791,0,0
43648,2019-11-20,315,0,315,25,340,340,0,0
43649,2019-11-20,343,0,343,27,370,370,0,0
43650,2019-11-20,622,0,622,49,671,0,0,671
43651,2019-11-20,371,0,371,29,400,400,0,0
43652,2019-11-20,334,0,334,26,360,360,0,0
43653,2019-11-20,769,0,769,61,830,830,0,0
43654,2019-11-20,370,0,370,37,407,407,0,0
43655,2019-11-20,204,0,204,16,220,220,0,0
43656,2019-11-20,593,0,593,47,640,640,0,0
43657,2019-11-20,370,0,370,29,399,399,0,0
43658,2019-11-20,501,0,501,40,541,541,0,0
43659,2019-11-20,130,0,130,10,140,140,0,0
43660,2019-11-20,1179,-117,1062,84,1146,1146,0,0
43661,2019-11-20,371,0,371,29,400,400,0,0
43662,2019-11-20,2714,0,2714,271,2985,2985,0,0
43663,2019-11-20,872,0,872,69,941,0,941,0
43664,2019-11-20,908,0,908,72,980,980,0,0
43665,2019-11-20,278,-27,251,20,271,271,0,0
43666,2019-11-20,1213,0,1213,121,1334,1334,0,0
43667,2019-11-20,1152,0,1152,92,1244,1244,0,0
43668,2019-11-20,837,0,837,66,903,903,0,0
43669,2019-11-20,139,0,139,11,150,150,0,0
43670,2019-11-20,464,0,464,37,501,501,0,0
43671,2019-11-20,455,0,455,45,500,500,0,0
43672,2019-11-20,631,0,631,50,681,681,0,0
43673,2019-11-20,280,0,280,28,308,0,0,308
43674,2019-11-20,279,0,279,22,301,301,0,0
43675,2019-11-20,288,0,288,23,311,311,0,0
43676,2019-11-20,482,-48,434,34,468,468,0,0
43677,2019-11-20,370,0,370,37,407,0,407,0
43678,2019-11-20,808,0,808,64,872,872,0,0
43679,2019-11-20,335,0,335,26,361,361,0,0
43680,2019-11-20,724,0,724,57,781,781,0,0
43681,2019-11-20,742,0,742,59,801,801,0,0
43682,2019-11-20,891,0,891,89,980,980,0,0
43683,2019-11-20,530,0,530,42,572,572,0,0
43684,2019-11-20,640,0,640,64,704,704,0,0
43685,2019-11-20,1123,0,1123,89,1212,1212,0,0
43686,2019-11-20,232,0,232,18,250,250,0,0
43687,2019-11-20,242,0,242,19,261,261,0,0
43688,2019-11-20,789,0,789,63,852,852,0,0
43689,2019-11-20,742,0,742,59,801,801,0,0
43690,2019-11-20,1030,0,1030,82,1112,1112,0,0
43691,2019-11-20,139,-27,112,8,120,120,0,0
43692,2019-11-20,1188,0,1188,95,1283,1283,0,0
43693,2019-11-20,770,0,770,77,847,847,0,0
43694,2019-11-20,826,0,826,66,892,892,0,0
43695,2019-11-20,2183,-218,1965,157,2122,2122,0,0
43696,2019-11-21,316,0,316,25,341,341,0,0
43697,2019-11-21,1421,0,1421,113,1534,1534,0,0
43698,2019-11-21,921,0,921,73,994,994,0,0
43699,2019-11-21,1001,0,1001,100,1101,1101,0,0
43700,2019-11-21,1428,0,1428,114,1542,1542,0,0
43701,2019-11-21,2393,0,2393,191,2584,2584,0,0
43702,2019-11-21,743,0,743,59,802,802,0,0
43703,2019-11-21,909,0,909,72,981,0,981,0
43704,2019-11-21,389,0,389,31,420,420,0,0
43705,2019-11-21,964,0,964,77,1041,0,1041,0
43706,2019-11-21,484,0,484,38,522,522,0,0
43707,2019-11-21,891,0,891,71,962,962,0,0
43708,2019-11-21,1463,0,1463,146,1609,1609,0,0
43709,2019-11-21,891,0,891,89,980,980,0,0
43710,2019-11-21,557,0,557,44,601,601,0,0
43711,2019-11-21,167,0,167,13,180,180,0,0
43712,2019-11-21,362,-72,290,23,313,313,0,0
43713,2019-11-21,1644,0,1644,131,1775,1775,0,0
43714,2019-11-21,891,0,891,89,980,980,0,0
43715,2019-11-21,1269,0,1269,126,1395,1395,0,0
43716,2019-11-21,891,0,891,89,980,980,0,0
43717,2019-11-21,891,0,891,89,980,980,0,0
43718,2019-11-21,1782,0,1782,178,1960,1960,0,0
43719,2019-11-21,891,0,891,89,980,980,0,0
43720,2019-11-21,816,0,816,65,881,881,0,0
43721,2019-11-21,567,0,567,45,612,612,0,0
43722,2019-11-21,482,0,482,48,530,530,0,0
43723,2019-11-21,696,-69,627,50,677,677,0,0
43724,2019-11-21,491,0,491,49,540,540,0,0
43725,2019-11-21,891,0,891,89,980,980,0,0
43726,2019-11-21,566,0,566,45,611,611,0,0
43727,2019-11-21,891,0,891,89,980,980,0,0
43728,2019-11-21,1039,0,1039,83,1122,1122,0,0
43729,2019-11-21,751,0,751,60,811,811,0,0
43730,2019-11-21,500,0,500,50,550,550,0,0
43731,2019-11-21,1456,0,1456,116,1572,1572,0,0
43732,2019-11-21,445,0,445,35,480,480,0,0
43733,2019-11-21,1243,0,1243,99,1342,1342,0,0
43734,2019-11-21,316,0,316,25,341,341,0,0
43735,2019-11-21,482,-48,434,43,477,477,0,0
43736,2019-11-21,464,-46,418,41,459,459,0,0
43737,2019-11-21,669,0,669,53,722,722,0,0
43738,2019-11-21,306,0,306,24,330,330,0,0
43739,2019-11-21,760,0,760,60,820,820,0,0
43740,2019-11-21,381,0,381,30,411,411,0,0
43741,2019-11-21,539,0,539,43,582,582,0,0
43742,2019-11-21,501,-50,451,36,487,487,0,0
43743,2019-11-21,167,-16,151,12,163,163,0,0
43744,2019-11-21,372,0,372,29,401,401,0,0
43745,2019-11-21,325,0,325,32,357,357,0,0
43746,2019-11-21,473,-47,426,34,460,460,0,0
43747,2019-11-21,901,0,901,72,973,973,0,0
43748,2019-11-21,1067,0,1067,85,1152,1152,0,0
43749,2019-11-21,1468,0,1468,117,1585,1585,0,0
43750,2019-11-21,334,0,334,26,360,360,0,0
43751,2019-11-21,334,0,334,26,360,360,0,0
43752,2019-11-21,658,0,658,52,710,710,0,0
43753,2019-11-21,1069,0,1069,85,1154,1154,0,0
43754,2019-11-21,640,0,640,51,691,691,0,0
43755,2019-11-21,1197,0,1197,95,1292,0,0,1292
43756,2019-11-21,232,0,232,18,250,250,0,0
43757,2019-11-21,269,0,269,21,290,290,0,0
43758,2019-11-21,306,0,306,24,330,330,0,0
43759,2019-11-21,696,0,696,55,751,751,0,0
43760,2019-11-21,764,0,764,61,825,825,0,0
43761,2019-11-21,316,0,316,25,341,341,0,0
43762,2019-11-21,204,-40,164,13,177,177,0,0
43763,2019-11-21,400,0,400,32,432,432,0,0
43764,2019-11-21,835,0,835,66,901,901,0,0
43765,2019-11-21,389,0,389,38,427,0,0,427
43766,2019-11-21,1381,0,1381,138,1519,0,0,1519
43767,2019-11-21,1046,0,1046,104,1150,1150,0,0
43768,2019-11-21,584,0,584,46,630,630,0,0
43769,2019-11-21,1363,0,1363,109,1472,0,0,1472
43770,2019-11-21,1046,0,1046,104,1150,1150,0,0
43771,2019-11-21,1046,0,1046,104,1150,1150,0,0
43772,2019-11-21,149,0,149,11,160,160,0,0
43773,2019-11-21,646,0,646,51,697,697,0,0
43774,2019-11-21,646,0,646,51,697,697,0,0
43775,2019-11-21,464,0,464,37,501,501,0,0
43776,2019-11-21,482,-48,434,34,468,0,468,0
43777,2019-11-21,1002,0,1002,80,1082,1082,0,0
43778,2019-11-21,1205,0,1205,120,1325,1325,0,0
43779,2019-11-21,269,-26,243,19,262,262,0,0
43780,2019-11-21,353,0,353,28,381,381,0,0
43781,2019-11-21,668,0,668,53,721,721,0,0
43782,2019-11-21,139,0,139,11,150,150,0,0
43783,2019-11-21,491,0,491,49,540,540,0,0
43784,2019-11-21,370,0,370,37,407,407,0,0
43785,2019-11-21,491,0,491,49,540,540,0,0
43786,2019-11-21,474,0,474,37,511,511,0,0
43787,2019-11-21,269,0,269,21,290,290,0,0
43788,2019-11-21,195,0,195,15,210,210,0,0
43789,2019-11-21,577,0,577,46,623,0,0,623
43790,2019-11-21,594,0,594,47,641,641,0,0
43791,2019-11-21,608,0,608,48,656,656,0,0
43792,2019-11-21,911,0,911,72,983,983,0,0
43793,2019-11-21,519,0,519,41,560,560,0,0
43794,2019-11-21,839,0,839,67,906,906,0,0
43795,2019-11-21,188,0,188,15,203,203,0,0
43796,2019-11-21,260,0,260,20,280,280,0,0
43797,2019-11-21,2617,0,2617,261,2878,2878,0,0
43798,2019-11-21,650,0,650,52,702,702,0,0
43799,2019-11-21,-2617,0,-2617,-261,-2878,-2878,0,0
43800,2019-11-21,732,0,732,58,790,790,0,0
43801,2019-11-21,2617,0,2617,261,2878,2878,0,0
43802,2019-11-21,381,0,381,30,411,411,0,0
43803,2019-11-21,1782,0,1782,178,1960,0,0,1960
43804,2019-11-21,464,0,464,37,501,501,0,0
43805,2019-11-21,307,0,307,30,337,337,0,0
43806,2019-11-21,910,0,910,72,982,982,0,0
43807,2019-11-21,585,0,585,46,631,0,0,631
43808,2019-11-21,584,0,584,46,630,630,0,0
43809,2019-11-21,547,0,547,43,590,590,0,0
43810,2019-11-21,835,0,835,66,901,901,0,0
43811,2019-11-21,372,0,372,29,401,401,0,0
43812,2019-11-21,985,0,985,78,1063,1063,0,0
43813,2019-11-21,2801,0,2801,224,3025,3025,0,0
43814,2019-11-21,773,0,773,77,850,850,0,0
43815,2019-11-21,1320,0,1320,105,1425,1425,0,0
43816,2019-11-21,1546,0,1546,154,1700,1700,0,0
43817,2019-11-21,1046,0,1046,104,1150,1150,0,0
43818,2019-11-21,773,0,773,77,850,850,0,0
43819,2019-11-21,752,0,752,60,812,812,0,0
43820,2019-11-21,789,0,789,63,852,852,0,0
43821,2019-11-21,982,0,982,78,1060,1060,0,0
43822,2019-11-21,603,0,603,48,651,651,0,0
43823,2019-11-21,-982,0,-982,-98,-1080,-1080,0,0
43824,2019-11-21,982,0,982,98,1080,1080,0,0
43825,2019-11-21,1076,0,1076,107,1183,0,1183,0
43826,2019-11-21,696,0,696,55,751,751,0,0
43827,2019-11-21,1806,0,1806,180,1986,1986,0,0
43828,2019-11-21,863,0,863,69,932,932,0,0
43829,2019-11-21,734,0,734,58,792,792,0,0
43830,2019-11-21,2386,0,2386,238,2624,2624,0,0
43831,2019-11-21,300,0,300,24,324,324,0,0
43832,2019-11-22,567,0,567,45,612,612,0,0
43833,2019-11-22,316,0,316,25,341,341,0,0
43834,2019-11-22,575,0,575,46,621,621,0,0
43835,2019-11-22,316,0,316,25,341,341,0,0
43836,2019-11-22,224,0,224,17,241,241,0,0
43837,2019-11-22,770,-77,693,55,748,0,0,748
43838,2019-11-22,474,0,474,37,511,511,0,0
43839,2019-11-22,771,0,771,61,832,832,0,0
43840,2019-11-22,2673,0,2673,267,2940,0,2940,0
43841,2019-11-22,677,0,677,54,731,731,0,0
43842,2019-11-22,482,0,482,38,520,520,0,0
43843,2019-11-22,740,0,740,59,799,799,0,0
43844,2019-11-22,2673,0,2673,267,2940,2940,0,0
43845,2019-11-22,232,0,232,18,250,250,0,0
43846,2019-11-22,410,0,410,32,442,442,0,0
43847,2019-11-22,1334,-133,1201,96,1297,1297,0,0
43848,2019-11-22,1040,0,1040,83,1123,1123,0,0
43849,2019-11-22,1900,0,1900,152,2052,2052,0,0
43850,2019-11-22,1782,0,1782,178,1960,1960,0,0
43851,2019-11-22,622,0,622,62,684,684,0,0
43852,2019-11-22,659,0,659,65,724,724,0,0
43853,2019-11-22,492,0,492,39,531,531,0,0
43854,2019-11-22,650,0,650,65,715,715,0,0
43855,2019-11-22,667,-66,601,48,649,649,0,0
43856,2019-11-22,575,0,575,46,621,621,0,0
43857,2019-11-22,716,0,716,57,773,773,0,0
43858,2019-11-22,1661,-166,1495,119,1614,1614,0,0
43859,2019-11-22,241,0,241,19,260,260,0,0
43860,2019-11-22,464,0,464,46,510,0,510,0
43861,2019-11-22,623,0,623,49,672,672,0,0
43862,2019-11-22,612,0,612,61,673,0,673,0
43863,2019-11-22,251,0,251,20,271,271,0,0
43864,2019-11-22,372,0,372,29,401,401,0,0
43865,2019-11-22,1038,0,1038,103,1141,0,1141,0
43866,2019-11-22,473,0,473,37,510,510,0,0
43867,2019-11-22,1152,0,1152,92,1244,1244,0,0
43868,2019-11-22,362,0,362,28,390,390,0,0
43869,2019-11-22,548,0,548,43,591,591,0,0
43870,2019-11-22,724,0,724,57,781,0,781,0
43871,2019-11-22,167,0,167,16,183,0,183,0
43872,2019-11-22,167,0,167,16,183,183,0,0
43873,2019-11-22,1764,0,1764,141,1905,1905,0,0
43874,2019-11-22,363,0,363,29,392,392,0,0
43875,2019-11-22,232,0,232,18,250,250,0,0
43876,2019-11-22,250,0,250,25,275,275,0,0
43877,2019-11-22,751,0,751,60,811,811,0,0
43878,2019-11-22,1782,0,1782,178,1960,0,1960,0
43879,2019-11-22,1097,0,1097,109,1206,0,1206,0
43880,2019-11-22,1364,0,1364,109,1473,1473,0,0
43881,2019-11-22,149,0,149,14,163,0,0,163
43882,2019-11-22,1115,0,1115,111,1226,1226,0,0
43883,2019-11-22,1782,0,1782,178,1960,1960,0,0
43884,2019-11-22,1542,0,1542,123,1665,1665,0,0
43885,2019-11-22,891,0,891,89,980,980,0,0
43886,2019-11-22,628,0,628,62,690,690,0,0
43887,2019-11-22,1782,0,1782,178,1960,1960,0,0
43888,2019-11-22,612,0,612,48,660,660,0,0
43889,2019-11-22,408,0,408,32,440,440,0,0
43890,2019-11-22,733,0,733,58,791,791,0,0
43891,2019-11-22,716,0,716,57,773,773,0,0
43892,2019-11-22,770,-50,720,57,777,777,0,0
43893,2019-11-22,890,0,890,71,961,961,0,0
43894,2019-11-22,1659,0,1659,165,1824,1824,0,0
43895,2019-11-22,603,-60,543,43,586,586,0,0
43896,2019-11-22,362,-36,326,26,352,352,0,0
43897,2019-11-22,344,0,344,27,371,371,0,0
43898,2019-11-22,1473,0,1473,147,1620,1620,0,0
43899,2019-11-22,306,0,306,24,330,330,0,0
43900,2019-11-22,362,0,362,28,390,390,0,0
43901,2019-11-22,743,0,743,59,802,802,0,0
43902,2019-11-22,261,0,261,20,281,281,0,0
43903,2019-11-22,418,0,418,33,451,451,0,0
43904,2019-11-22,270,0,270,21,291,291,0,0
43905,2019-11-22,299,0,299,23,322,322,0,0
43906,2019-11-22,628,0,628,50,678,0,0,678
43907,2019-11-22,1782,0,1782,178,1960,1960,0,0
43908,2019-11-22,538,0,538,53,591,591,0,0
43909,2019-11-22,584,0,584,46,630,630,0,0
43910,2019-11-22,436,0,436,34,470,470,0,0
43911,2019-11-22,1334,0,1334,133,1467,1467,0,0
43912,2019-11-22,343,0,343,27,370,370,0,0
43913,2019-11-22,514,0,514,51,565,565,0,0
43914,2019-11-22,483,0,483,48,531,531,0,0
43915,2019-11-22,519,0,519,41,560,560,0,0
43916,2019-11-22,584,0,584,46,630,630,0,0
43917,2019-11-22,316,0,316,25,341,341,0,0
43918,2019-11-22,2673,0,2673,267,2940,2940,0,0
43919,2019-11-22,167,0,167,13,180,180,0,0
43920,2019-11-22,1256,0,1256,125,1381,1381,0,0
43921,2019-11-22,256,0,256,20,276,276,0,0
43922,2019-11-22,436,0,436,34,470,470,0,0
43923,2019-11-22,427,0,427,34,461,461,0,0
43924,2019-11-22,724,0,724,57,781,0,0,781
43925,2019-11-22,251,0,251,20,271,271,0,0
43926,2019-11-22,279,0,279,22,301,301,0,0
43927,2019-11-22,1889,0,1889,188,2077,2077,0,0
43928,2019-11-22,1021,0,1021,81,1102,1102,0,0
43929,2019-11-22,475,0,475,47,522,0,0,522
43930,2019-11-22,1903,0,1903,190,2093,2093,0,0
43931,2019-11-22,538,0,538,53,591,591,0,0
43932,2019-11-22,1791,0,1791,179,1970,1970,0,0
43933,2019-11-22,1782,0,1782,178,1960,1960,0,0
43934,2019-11-22,584,0,584,46,630,630,0,0
43935,2019-11-22,872,0,872,69,941,0,0,941
43936,2019-11-22,937,0,937,74,1011,0,0,1011
43937,2019-11-22,556,0,556,44,600,0,0,600
43938,2019-11-22,519,0,519,51,570,570,0,0
43939,2019-11-22,566,0,566,56,622,622,0,0
43940,2019-11-22,437,0,437,43,480,0,0,480
43941,2019-11-22,593,0,593,59,652,652,0,0
43942,2019-11-22,316,0,316,31,347,347,0,0
43943,2019-11-22,621,0,621,49,670,670,0,0
43944,2019-11-22,825,0,825,66,891,891,0,0
43945,2019-11-22,352,0,352,35,387,387,0,0
43946,2019-11-22,1130,0,1130,113,1243,1243,0,0
43947,2019-11-22,288,0,288,23,311,311,0,0
43948,2019-11-22,1546,0,1546,154,1700,1700,0,0
43949,2019-11-22,352,0,352,28,380,380,0,0
43950,2019-11-22,773,0,773,77,850,850,0,0
43951,2019-11-22,352,0,352,35,387,387,0,0
43952,2019-11-22,2092,0,2092,209,2301,2301,0,0
43953,2019-11-22,705,0,705,56,761,761,0,0
43954,2019-11-22,306,0,306,30,336,0,0,336
43955,2019-11-22,269,0,269,26,295,295,0,0
43956,2019-11-22,1260,0,1260,100,1360,1360,0,0
43957,2019-11-22,668,0,668,53,721,721,0,0
43958,2019-11-22,334,0,334,26,360,0,360,0
43959,2019-11-22,741,0,741,74,815,815,0,0
43960,2019-11-22,1546,0,1546,154,1700,1700,0,0
43961,2019-11-22,306,0,306,24,330,330,0,0
43962,2019-11-22,292,0,292,23,315,315,0,0
43963,2019-11-22,1793,0,1793,143,1936,1936,0,0
43964,2019-11-22,891,0,891,71,962,0,962,0
43965,2019-11-22,334,-33,301,24,325,325,0,0
43966,2019-11-22,427,0,427,34,461,461,0,0
43967,2019-11-22,269,-26,243,19,262,0,262,0
43968,2019-11-22,846,0,846,67,913,913,0,0
43969,2019-11-22,1820,-364,1456,116,1572,1572,0,0
43970,2019-11-22,288,0,288,23,311,311,0,0
43971,2019-11-22,278,0,278,27,305,305,0,0
43972,2019-11-22,652,0,652,52,704,704,0,0
43973,2019-11-22,518,0,518,41,559,559,0,0
43974,2019-11-22,640,0,640,51,691,0,691,0
43975,2019-11-22,815,0,815,65,880,880,0,0
43976,2019-11-22,2355,0,2355,188,2543,2543,0,0
43977,2019-11-22,445,0,445,44,489,489,0,0
43978,2019-11-22,773,0,773,77,850,850,0,0
43979,2019-11-22,773,0,773,77,850,850,0,0
43980,2019-11-22,620,0,620,62,682,682,0,0
43981,2019-11-22,797,0,797,79,876,876,0,0
43982,2019-11-22,278,0,278,22,300,300,0,0
43983,2019-11-22,2208,-220,1988,159,2147,0,0,2147
43984,2019-11-22,2188,0,2188,218,2406,0,2406,0
43985,2019-11-22,806,0,806,80,886,886,0,0
43986,2019-11-22,1204,0,1204,120,1324,1324,0,0
43987,2019-11-22,549,0,549,43,592,592,0,0
43988,2019-11-22,631,0,631,50,681,681,0,0
43989,2019-11-22,724,0,724,57,781,781,0,0
43990,2019-11-22,902,0,902,72,974,974,0,0
43991,2019-11-22,473,0,473,47,520,520,0,0
43992,2019-11-22,371,0,371,29,400,400,0,0
43993,2019-11-22,537,0,537,53,590,590,0,0
43994,2019-11-22,1782,0,1782,178,1960,0,1960,0
43995,2019-11-22,668,0,668,66,734,0,734,0
43996,2019-11-22,491,0,491,39,530,530,0,0
43997,2019-11-22,954,0,954,95,1049,0,1049,0
43998,2019-11-22,704,0,704,70,774,774,0,0
43999,2019-11-22,279,0,279,22,301,0,0,301
44000,2019-11-22,760,0,760,76,836,836,0,0
44001,2019-11-22,955,0,955,76,1031,1031,0,0
44002,2019-11-22,1782,0,1782,178,1960,1960,0,0
44003,2019-11-22,1594,0,1594,159,1753,1753,0,0
44004,2019-11-22,1782,0,1782,178,1960,1960,0,0
44005,2019-11-22,807,0,807,64,871,871,0,0
44006,2019-11-22,622,0,622,49,671,671,0,0
44007,2019-11-22,130,0,130,10,140,140,0,0
44008,2019-11-22,695,0,695,69,764,764,0,0
44009,2019-11-22,852,0,852,85,937,937,0,0
44010,2019-11-22,1020,0,1020,102,1122,1122,0,0
44011,2019-11-22,743,0,743,59,802,0,802,0
44012,2019-11-22,773,0,773,77,850,850,0,0
44013,2019-11-22,1910,0,1910,152,2062,2062,0,0
44014,2019-11-22,585,0,585,46,631,631,0,0
44015,2019-11-22,1106,-1000,106,8,114,114,0,0
44016,2019-11-22,773,0,773,77,850,850,0,0
44017,2019-11-22,1005,0,1005,100,1105,1105,0,0
44018,2019-11-22,1264,0,1264,126,1390,1390,0,0
44019,2019-11-22,1046,0,1046,104,1150,1150,0,0
44020,2019-11-22,269,0,269,21,290,290,0,0
44021,2019-11-22,1546,0,1546,154,1700,0,0,1700
44022,2019-11-22,556,0,556,44,600,600,0,0
44023,2019-11-22,1094,0,1094,109,1203,0,1203,0
44024,2019-11-22,881,0,881,70,951,951,0,0
44025,2019-11-22,279,0,279,22,301,301,0,0
44026,2019-11-22,1046,0,1046,104,1150,1150,0,0
44027,2019-11-22,1037,0,1037,103,1140,0,1140,0
44028,2019-11-22,918,0,918,73,991,991,0,0
44029,2019-11-22,-1094,0,-1094,-109,-1203,0,-1203,0
44030,2019-11-22,1546,0,1546,154,1700,1700,0,0
44031,2019-11-22,773,0,773,77,850,850,0,0
44032,2019-11-22,1398,0,1398,139,1537,1537,0,0
44033,2019-11-22,773,0,773,77,850,850,0,0
44034,2019-11-22,446,0,446,35,481,481,0,0
44035,2019-11-22,408,0,408,32,440,440,0,0
44036,2019-11-22,1284,0,1284,128,1412,0,0,1412
44037,2019-11-22,603,0,603,48,651,0,651,0
44038,2019-11-22,232,0,232,18,250,0,250,0
44039,2019-11-23,1159,0,1159,92,1251,0,1251,0
44040,2019-11-23,436,0,436,34,470,470,0,0
44041,2019-11-23,538,0,538,43,581,581,0,0
44042,2019-11-23,2702,0,2702,270,2972,0,2972,0
44043,2019-11-23,1420,0,1420,131,1551,1551,0,0
44044,2019-11-23,1782,0,1782,178,1960,1960,0,0
44045,2019-11-23,315,0,315,25,340,340,0,0
44046,2019-11-23,1209,0,1209,96,1305,1305,0,0
44047,2019-11-23,1038,0,1038,103,1141,1141,0,0
44048,2019-11-23,669,0,669,53,722,722,0,0
44049,2019-11-23,1472,0,1472,147,1619,0,1619,0
44050,2019-11-23,436,0,436,34,470,0,470,0
44051,2019-11-23,418,0,418,33,451,451,0,0
44052,2019-11-23,733,0,733,58,791,791,0,0
44053,2019-11-23,835,0,835,66,901,901,0,0
44054,2019-11-23,918,0,918,73,991,991,0,0
44055,2019-11-23,548,0,548,43,591,591,0,0
44056,2019-11-23,891,0,891,89,980,980,0,0
44057,2019-11-23,668,0,668,53,721,721,0,0
44058,2019-11-23,891,0,891,89,980,980,0,0
44059,2019-11-23,891,-500,391,39,430,430,0,0
44060,2019-11-23,1782,0,1782,178,1960,1960,0,0
44061,2019-11-23,695,0,695,69,764,764,0,0
44062,2019-11-23,548,0,548,43,591,591,0,0
44063,2019-11-23,883,0,883,70,953,953,0,0
44064,2019-11-23,1381,0,1381,138,1519,1519,0,0
44065,2019-11-23,965,0,965,77,1042,1042,0,0
44066,2019-11-23,789,0,789,63,852,852,0,0
44067,2019-11-23,1559,0,1559,124,1683,1683,0,0
44068,2019-11-23,455,0,455,36,491,491,0,0
44069,2019-11-23,1216,0,1216,97,1313,1313,0,0
44070,2019-11-23,464,0,464,37,501,501,0,0
44071,2019-11-23,576,0,576,46,622,622,0,0
44072,2019-11-23,844,0,844,67,911,911,0,0
44073,2019-11-23,891,0,891,89,980,980,0,0
44074,2019-11-23,112,0,112,8,120,120,0,0
44075,2019-11-23,1039,0,1039,83,1122,1122,0,0
44076,2019-11-23,139,0,139,11,150,150,0,0
44077,2019-11-23,769,0,769,76,845,845,0,0
44078,2019-11-23,279,0,279,22,301,301,0,0
44079,2019-11-23,2291,0,2291,229,2520,0,2520,0
44080,2019-11-23,891,0,891,89,980,980,0,0
44081,2019-11-23,891,0,891,89,980,0,980,0
44082,2019-11-23,965,0,965,77,1042,1042,0,0
44083,2019-11-23,530,0,530,53,583,0,0,583
44084,2019-11-23,1752,0,1752,175,1927,1927,0,0
44085,2019-11-23,894,0,894,71,965,965,0,0
44086,2019-11-23,715,0,715,57,772,0,772,0
44087,2019-11-23,1782,0,1782,178,1960,1960,0,0
44088,2019-11-23,585,0,585,46,631,631,0,0
44089,2019-11-23,1028,0,1028,102,1130,1130,0,0
44090,2019-11-23,520,0,520,41,561,561,0,0
44091,2019-11-23,1017,0,1017,101,1118,1118,0,0
44092,2019-11-23,1119,0,1119,111,1230,1230,0,0
44093,2019-11-23,2673,0,2673,267,2940,2940,0,0
44094,2019-11-23,419,-41,378,30,408,408,0,0
44095,2019-11-23,630,0,630,63,693,693,0,0
44096,2019-11-23,298,0,298,23,321,321,0,0
44097,2019-11-23,232,0,232,18,250,250,0,0
44098,2019-11-23,260,0,260,20,280,280,0,0
44099,2019-11-23,371,0,371,29,400,400,0,0
44100,2019-11-23,400,0,400,32,432,432,0,0
44101,2019-11-23,483,0,483,38,521,521,0,0
44102,2019-11-23,1568,0,1568,156,1724,1724,0,0
44103,2019-11-23,260,0,260,20,280,280,0,0
44104,2019-11-23,2031,0,2031,203,2234,0,0,2234
44105,2019-11-23,548,0,548,43,591,591,0,0
44106,2019-11-23,1392,0,1392,139,1531,0,1531,0
44107,2019-11-23,362,0,362,28,390,390,0,0
44108,2019-11-23,1206,0,1206,120,1326,0,1326,0
44109,2019-11-23,2145,0,2145,214,2359,2359,0,0
44110,2019-11-23,605,0,605,48,653,653,0,0
44111,2019-11-23,2156,0,2156,215,2371,2371,0,0
44112,2019-11-23,362,0,362,28,390,390,0,0
44113,2019-11-23,659,0,659,52,711,0,711,0
44114,2019-11-23,1019,0,1019,101,1120,0,1120,0
44115,2019-11-23,529,0,529,42,571,571,0,0
44116,2019-11-23,1512,0,1512,120,1632,1632,0,0
44117,2019-11-23,1512,0,1512,120,1632,1632,0,0
44118,2019-11-23,1782,-178,1604,160,1764,1764,0,0
44119,2019-11-23,278,0,278,22,300,300,0,0
44120,2019-11-23,484,0,484,38,522,522,0,0
44121,2019-11-23,1782,0,1782,178,1960,1960,0,0
44122,2019-11-23,409,0,409,32,441,441,0,0
44123,2019-11-23,1150,0,1150,92,1242,0,1242,0
44124,2019-11-23,325,0,325,26,351,0,351,0
44125,2019-11-23,742,0,742,74,816,816,0,0
44126,2019-11-23,409,0,409,40,449,449,0,0
44127,2019-11-23,528,0,528,52,580,580,0,0
44128,2019-11-23,288,0,288,23,311,311,0,0
44129,2019-11-23,167,0,167,13,180,0,0,180
44130,2019-11-23,1834,0,1834,183,2017,2017,0,0
44131,2019-11-23,844,0,844,84,928,928,0,0
44132,2019-11-23,389,0,389,38,427,427,0,0
44133,2019-11-23,-779,0,-779,-62,-841,-841,0,0
44134,2019-11-23,640,0,640,51,691,691,0,0
44135,2019-11-23,779,0,779,62,841,841,0,0
44136,2019-11-23,1546,0,1546,154,1700,1700,0,0
44137,2019-11-23,773,0,773,77,850,0,0,850
44138,2019-11-23,773,0,773,77,850,0,850,0
44139,2019-11-23,806,0,806,80,886,886,0,0
44140,2019-11-23,1012,0,1012,80,1092,1092,0,0
44141,2019-11-23,773,0,773,77,850,850,0,0
44142,2019-11-23,773,0,773,77,850,0,0,850
44143,2019-11-23,825,0,825,82,907,907,0,0
44144,2019-11-23,400,0,400,40,440,440,0,0
44145,2019-11-23,773,-77,696,69,765,765,0,0
44146,2019-11-23,556,0,556,44,600,600,0,0
44147,2019-11-23,773,0,773,77,850,850,0,0
44148,2019-11-23,1546,0,1546,154,1700,0,0,1700
44149,2019-11-23,1046,0,1046,104,1150,0,0,1150
44150,2019-11-23,1546,0,1546,154,1700,0,1700,0
44151,2019-11-23,1546,0,1546,154,1700,1700,0,0
44152,2019-11-23,273,0,273,27,300,0,0,300
44153,2019-11-23,1546,0,1546,154,1700,1700,0,0
44154,2019-11-23,844,0,844,67,911,911,0,0
44155,2019-11-23,983,0,983,78,1061,0,0,1061
44156,2019-11-23,1639,0,1639,163,1802,0,0,1802
44157,2019-11-23,130,0,130,10,140,140,0,0
44158,2019-11-23,334,0,334,26,360,360,0,0
44159,2019-11-23,1363,0,1363,136,1499,1499,0,0
44160,2019-11-23,1894,0,1894,189,2083,2083,0,0
44161,2019-11-23,232,0,232,18,250,250,0,0
44162,2019-11-23,418,0,418,33,451,451,0,0
44163,2019-11-23,474,0,474,37,511,511,0,0
44164,2019-11-23,529,0,529,42,571,571,0,0
44165,2019-11-23,789,0,789,63,852,852,0,0
44166,2019-11-23,557,0,557,44,601,601,0,0
44167,2019-11-23,520,0,520,41,561,0,0,561
44168,2019-11-23,372,0,372,29,401,401,0,0
44169,2019-11-23,861,0,861,86,947,947,0,0
44170,2019-11-23,529,0,529,42,571,571,0,0
44171,2019-11-23,835,0,835,83,918,918,0,0
44172,2019-11-23,928,0,928,74,1002,1002,0,0
44173,2019-11-23,894,0,894,71,965,0,965,0
44174,2019-11-23,588,0,588,47,635,635,0,0
44175,2019-11-23,809,0,809,64,873,873,0,0
44176,2019-11-23,529,0,529,42,571,0,571,0
44177,2019-11-23,297,-29,268,21,289,289,0,0
44178,2019-11-23,112,0,112,8,120,120,0,0
44179,2019-11-23,807,0,807,64,871,871,0,0
44180,2019-11-23,585,0,585,46,631,631,0,0
44181,2019-11-23,1119,0,1119,111,1230,1230,0,0
44182,2019-11-23,1546,0,1546,154,1700,1700,0,0
44183,2019-11-23,500,0,500,50,550,550,0,0
44184,2019-11-23,483,0,483,38,521,521,0,0
44185,2019-11-23,622,0,622,49,671,671,0,0
44186,2019-11-23,742,0,742,59,801,0,801,0
44187,2019-11-23,1546,0,1546,154,1700,1700,0,0
44188,2019-11-23,714,0,714,57,771,771,0,0
44189,2019-11-23,334,0,334,26,360,360,0,0
44190,2019-11-23,1889,0,1889,188,2077,2077,0,0
44191,2019-11-23,677,0,677,54,731,731,0,0
44192,2019-11-23,1503,0,1503,120,1623,1623,0,0
44193,2019-11-23,445,0,445,35,480,480,0,0
44194,2019-11-23,1575,0,1575,157,1732,1732,0,0
44195,2019-11-23,714,0,714,57,771,771,0,0
44196,2019-11-23,649,0,649,51,700,700,0,0
44197,2019-11-23,50,0,50,5,55,55,0,0
44198,2019-11-23,501,0,501,40,541,541,0,0
44199,2019-11-23,779,0,779,62,841,841,0,0
44200,2019-11-23,603,0,603,48,651,651,0,0
44201,2019-11-23,250,0,250,20,270,0,270,0
44202,2019-11-23,343,0,343,27,370,370,0,0
44203,2019-11-23,779,0,779,62,841,841,0,0
44204,2019-11-23,723,0,723,57,780,780,0,0
44205,2019-11-23,232,0,232,18,250,250,0,0
44206,2019-11-23,1575,0,1575,157,1732,1732,0,0
44207,2019-11-23,612,0,612,48,660,660,0,0
44208,2019-11-23,2319,0,2319,231,2550,2550,0,0
44209,2019-11-23,1546,0,1546,154,1700,1700,0,0
44210,2019-11-23,1870,0,1870,187,2057,2057,0,0
44211,2019-11-23,139,0,139,11,150,150,0,0
44212,2019-11-23,1546,0,1546,154,1700,1700,0,0
44213,2019-11-23,273,0,273,27,300,300,0,0
44214,2019-11-23,2865,0,2865,286,3151,3151,0,0
44215,2019-11-23,204,0,204,16,220,0,0,220
44216,2019-11-23,1546,0,1546,154,1700,1700,0,0
44217,2019-11-23,1261,-126,1135,90,1225,1225,0,0
44218,2019-11-23,353,0,353,28,381,381,0,0
44219,2019-11-23,2194,0,2194,219,2413,2413,0,0
44220,2019-11-23,603,0,603,48,651,0,0,651
44221,2019-11-23,167,0,167,13,180,180,0,0
44222,2019-11-23,862,0,862,68,930,930,0,0
44223,2019-11-23,919,0,919,91,1010,1010,0,0
44224,2019-11-23,370,0,370,37,407,407,0,0
44225,2019-11-23,770,0,770,61,831,831,0,0
44226,2019-11-23,1753,0,1753,175,1928,1928,0,0
44227,2019-11-23,919,0,919,73,992,0,0,992
44228,2019-11-23,130,0,130,13,143,143,0,0
44229,2019-11-23,1546,0,1546,154,1700,1700,0,0
44230,2019-11-23,974,0,974,77,1051,1051,0,0
44231,2019-11-24,547,0,547,43,590,590,0,0
44232,2019-11-24,667,0,667,53,720,720,0,0
44233,2019-11-24,362,0,362,28,390,390,0,0
44234,2019-11-24,806,0,806,64,870,870,0,0
44235,2019-11-24,973,0,973,77,1050,1050,0,0
44236,2019-11-24,260,0,260,20,280,280,0,0
44237,2019-11-24,-667,0,-667,-53,-720,-720,0,0
44238,2019-11-24,1704,0,1704,170,1874,0,0,1874
44239,2019-11-24,667,0,667,66,733,733,0,0
44240,2019-11-24,371,0,371,29,400,400,0,0
44241,2019-11-24,1782,-178,1604,160,1764,1764,0,0
44242,2019-11-24,1281,0,1281,102,1383,1383,0,0
44243,2019-11-24,1782,0,1782,178,1960,1960,0,0
44244,2019-11-24,428,0,428,34,462,462,0,0
44245,2019-11-24,538,0,538,53,591,591,0,0
44246,2019-11-24,857,0,857,68,925,925,0,0
44247,2019-11-24,2384,0,2384,238,2622,2622,0,0
44248,2019-11-24,441,0,441,35,476,476,0,0
44249,2019-11-24,714,0,714,57,771,0,771,0
44250,2019-11-24,1032,0,1032,82,1114,0,1114,0
44251,2019-11-24,789,0,789,63,852,0,852,0
44252,2019-11-24,593,0,593,47,640,0,0,640
44253,2019-11-24,789,0,789,63,852,852,0,0
44254,2019-11-24,1095,0,1095,87,1182,0,1182,0
44255,2019-11-24,188,0,188,15,203,203,0,0
44256,2019-11-24,1615,0,1615,129,1744,0,0,1744
44257,2019-11-24,920,0,920,73,993,993,0,0
44258,2019-11-24,446,0,446,35,481,481,0,0
44259,2019-11-24,946,0,946,75,1021,1021,0,0
44260,2019-11-24,539,0,539,43,582,582,0,0
44261,2019-11-24,465,0,465,37,502,0,0,502
44262,2019-11-24,1782,0,1782,178,1960,1960,0,0
44263,2019-11-24,334,0,334,33,367,367,0,0
44264,2019-11-24,232,0,232,18,250,250,0,0
44265,2019-11-24,1493,0,1493,149,1642,1642,0,0
44266,2019-11-24,946,0,946,75,1021,1021,0,0
44267,2019-11-24,891,0,891,89,980,980,0,0
44268,2019-11-24,391,0,391,31,422,422,0,0
44269,2019-11-24,891,0,891,89,980,980,0,0
44270,2019-11-24,389,0,389,31,420,420,0,0
44271,2019-11-24,567,0,567,45,612,612,0,0
44272,2019-11-24,334,0,334,26,360,360,0,0
44273,2019-11-24,603,0,603,48,651,651,0,0
44274,2019-11-24,640,0,640,51,691,691,0,0
44275,2019-11-24,558,0,558,44,602,602,0,0
44276,2019-11-24,1065,0,1065,106,1171,1171,0,0
44277,2019-11-24,879,0,879,87,966,0,966,0
44278,2019-11-24,491,0,491,49,540,0,540,0
44279,2019-11-24,25,0,25,2,27,27,0,0
44280,2019-11-24,418,-41,377,30,407,407,0,0
44281,2019-11-24,511,-51,460,36,496,0,496,0
44282,2019-11-24,446,0,446,35,481,481,0,0
44283,2019-11-24,501,0,501,40,541,541,0,0
44284,2019-11-24,589,0,589,47,636,636,0,0
44285,2019-11-24,270,0,270,21,291,291,0,0
44286,2019-11-24,798,0,798,63,861,861,0,0
44287,2019-11-24,391,0,391,31,422,422,0,0
44288,2019-11-24,251,0,251,20,271,271,0,0
44289,2019-11-24,602,0,602,60,662,662,0,0
44290,2019-11-24,1938,0,1938,155,2093,0,2093,0
44291,2019-11-24,241,0,241,19,260,260,0,0
44292,2019-11-24,797,0,797,79,876,876,0,0
44293,2019-11-24,983,0,983,98,1081,1081,0,0
44294,2019-11-24,825,0,825,66,891,891,0,0
44295,2019-11-24,686,0,686,54,740,0,0,740
44296,2019-11-24,965,0,965,77,1042,1042,0,0
44297,2019-11-24,612,0,612,48,660,660,0,0
44298,2019-11-24,891,0,891,89,980,980,0,0
44299,2019-11-24,891,0,891,89,980,980,0,0
44300,2019-11-24,251,0,251,20,271,271,0,0
44301,2019-11-24,1187,0,1187,94,1281,1281,0,0
44302,2019-11-24,1093,0,1093,109,1202,0,1202,0
44303,2019-11-24,602,0,602,60,662,662,0,0
44304,2019-11-24,1076,0,1076,86,1162,1162,0,0
44305,2019-11-24,298,0,298,23,321,321,0,0
44306,2019-11-24,752,0,752,60,812,812,0,0
44307,2019-11-24,513,0,513,41,554,554,0,0
44308,2019-11-24,538,0,538,43,581,581,0,0
44309,2019-11-24,311,0,311,24,335,335,0,0
44310,2019-11-24,1546,0,1546,154,1700,1700,0,0
44311,2019-11-24,380,0,380,30,410,410,0,0
44312,2019-11-24,640,0,640,51,691,691,0,0
44313,2019-11-24,1002,0,1002,80,1082,1082,0,0
44314,2019-11-24,773,0,773,77,850,850,0,0
44315,2019-11-24,773,0,773,77,850,850,0,0
44316,2019-11-24,788,0,788,78,866,866,0,0
44317,2019-11-24,-1575,0,-1575,-157,-1732,-1732,0,0
44318,2019-11-24,982,0,982,98,1080,1080,0,0
44319,2019-11-24,566,0,566,45,611,611,0,0
44320,2019-11-24,798,0,798,63,861,861,0,0
44321,2019-11-24,269,0,269,21,290,290,0,0
44322,2019-11-24,139,0,139,11,150,150,0,0
44323,2019-11-24,4241,0,4241,424,4665,4665,0,0
44324,2019-11-24,808,0,808,64,872,872,0,0
44325,2019-11-24,522,0,522,41,563,563,0,0
44326,2019-11-24,1736,0,1736,173,1909,0,1909,0
44327,2019-11-24,594,0,594,47,641,641,0,0
44328,2019-11-24,612,0,612,48,660,660,0,0
44329,2019-11-24,316,0,316,25,341,341,0,0
44330,2019-11-24,269,0,269,21,290,290,0,0
44331,2019-11-24,1152,0,1152,92,1244,0,1244,0
44332,2019-11-24,530,0,530,42,572,572,0,0
44333,2019-11-24,631,-63,568,45,613,613,0,0
44334,2019-11-24,628,0,628,50,678,0,0,678
44335,2019-11-24,538,0,538,43,581,581,0,0
44336,2019-11-24,224,0,224,17,241,241,0,0
44337,2019-11-24,669,0,669,53,722,722,0,0
44338,2019-11-24,1465,0,1465,117,1582,1582,0,0
44339,2019-11-24,510,0,510,40,550,550,0,0
44340,2019-11-24,493,0,493,39,532,532,0,0
44341,2019-11-24,635,0,635,50,685,685,0,0
44342,2019-11-24,343,0,343,34,377,377,0,0
44343,2019-11-24,482,0,482,48,530,0,530,0
44344,2019-11-24,511,0,511,40,551,551,0,0
44345,2019-11-24,751,0,751,60,811,811,0,0
44346,2019-11-24,1002,0,1002,80,1082,0,1082,0
44347,2019-11-24,890,0,890,89,979,0,0,979
44348,2019-11-24,2325,0,2325,232,2557,0,2557,0
44349,2019-11-24,733,0,733,58,791,791,0,0
44350,2019-11-24,278,0,278,22,300,300,0,0
44351,2019-11-24,428,0,428,34,462,462,0,0
44352,2019-11-24,176,0,176,14,190,190,0,0
44353,2019-11-24,251,0,251,20,271,271,0,0
44354,2019-11-24,167,-16,151,12,163,163,0,0
44355,2019-11-24,854,0,854,68,922,0,0,922
44356,2019-11-24,574,0,574,57,631,631,0,0
44357,2019-11-24,390,0,390,31,421,421,0,0
44358,2019-11-24,504,0,504,40,544,544,0,0
44359,2019-11-24,445,0,445,35,480,480,0,0
44360,2019-11-24,773,0,773,77,850,850,0,0
44361,2019-11-24,334,0,334,26,360,360,0,0
44362,2019-11-24,773,0,773,77,850,850,0,0
44363,2019-11-24,149,0,149,11,160,160,0,0
44364,2019-11-24,1546,0,1546,154,1700,1700,0,0
44365,2019-11-24,1456,0,1456,116,1572,1572,0,0
44366,2019-11-24,473,0,473,37,510,0,0,510
44367,2019-11-24,1315,0,1315,131,1446,0,0,1446
44368,2019-11-24,955,0,955,76,1031,0,1031,0
44369,2019-11-24,1670,0,1670,133,1803,1803,0,0
44370,2019-11-24,492,0,492,39,531,531,0,0
44371,2019-11-24,773,0,773,77,850,850,0,0
44372,2019-11-24,1835,0,1835,183,2018,2018,0,0
44373,2019-11-24,1270,0,1270,127,1397,1397,0,0
44374,2019-11-24,47,0,47,3,50,50,0,0
44375,2019-11-24,806,0,806,64,870,870,0,0
44376,2019-11-24,306,0,306,24,330,330,0,0
44377,2019-11-25,139,0,139,13,152,152,0,0
44378,2019-11-25,1714,0,1714,171,1885,1885,0,0
44379,2019-11-25,288,0,288,23,311,311,0,0
44380,2019-11-25,1392,0,1392,111,1503,1503,0,0
44381,2019-11-25,380,0,380,30,410,410,0,0
44382,2019-11-25,949,0,949,75,1024,1024,0,0
44383,2019-11-25,1429,0,1429,114,1543,1543,0,0
44384,2019-11-25,1103,0,1103,88,1191,1191,0,0
44385,2019-11-25,427,-42,385,30,415,415,0,0
44386,2019-11-25,427,0,427,34,461,461,0,0
44387,2019-11-25,705,0,705,56,761,761,0,0
44388,2019-11-25,891,0,891,89,980,0,980,0
44389,2019-11-25,372,0,372,29,401,0,401,0
44390,2019-11-25,494,0,494,39,533,533,0,0
44391,2019-11-25,399,0,399,31,430,0,0,430
44392,2019-11-25,1911,-1691,220,17,237,237,0,0
44393,2019-11-25,809,0,809,64,873,873,0,0
44394,2019-11-25,316,0,316,25,341,341,0,0
44395,2019-11-25,835,0,835,66,901,901,0,0
44396,2019-11-25,2054,0,2054,205,2259,2259,0,0
44397,2019-11-25,306,0,306,24,330,330,0,0
44398,2019-11-25,973,0,973,97,1070,1070,0,0
44399,2019-11-25,584,0,584,46,630,630,0,0
44400,2019-11-25,567,0,567,45,612,0,0,612
44401,2019-11-25,362,0,362,28,390,390,0,0
44402,2019-11-25,525,0,525,42,567,567,0,0
44403,2019-11-25,556,0,556,44,600,600,0,0
44404,2019-11-25,438,0,438,35,473,473,0,0
44405,2019-11-25,47,0,47,4,51,51,0,0
44406,2019-11-25,834,0,834,83,917,917,0,0
44407,2019-11-25,1093,0,1093,109,1202,1202,0,0
44408,2019-11-25,316,0,316,25,341,341,0,0
44409,2019-11-25,139,0,139,11,150,150,0,0
44410,2019-11-25,733,0,733,58,791,791,0,0
44411,2019-11-25,463,0,463,46,509,509,0,0
44412,2019-11-25,408,0,408,32,440,440,0,0
44413,2019-11-25,1090,0,1090,87,1177,1177,0,0
44414,2019-11-25,2673,0,2673,267,2940,2940,0,0
44415,2019-11-25,1593,0,1593,159,1752,1752,0,0
44416,2019-11-25,492,0,492,49,541,0,541,0
44417,2019-11-25,1977,0,1977,158,2135,2135,0,0
44418,2019-11-25,1085,0,1085,86,1171,1171,0,0
44419,2019-11-25,678,0,678,54,732,0,732,0
44420,2019-11-25,834,0,834,66,900,900,0,0
44421,2019-11-25,752,0,752,60,812,812,0,0
44422,2019-11-25,2946,0,2946,294,3240,3240,0,0
44423,2019-11-25,696,0,696,55,751,751,0,0
44424,2019-11-25,1782,0,1782,178,1960,0,0,1960
44425,2019-11-25,900,0,900,72,972,0,972,0
44426,2019-11-25,630,0,630,63,693,693,0,0
44427,2019-11-25,483,0,483,38,521,521,0,0
44428,2019-11-25,993,0,993,79,1072,1072,0,0
44429,2019-11-25,1132,0,1132,113,1245,1245,0,0
44430,2019-11-25,188,0,188,15,203,203,0,0
44431,2019-11-25,631,0,631,50,681,681,0,0
44432,2019-11-25,1899,0,1899,189,2088,2088,0,0
44433,2019-11-25,1546,0,1546,154,1700,1700,0,0
44434,2019-11-25,418,0,418,33,451,451,0,0
44435,2019-11-25,297,0,297,23,320,320,0,0
44436,2019-11-25,370,0,370,37,407,407,0,0
44437,2019-11-25,1546,0,1546,154,1700,0,1700,0
44438,2019-11-25,538,0,538,43,581,581,0,0
44439,2019-11-25,908,-90,818,65,883,883,0,0
44440,2019-11-25,88,0,88,7,95,95,0,0
44441,2019-11-25,426,0,426,34,460,460,0,0
44442,2019-11-25,260,0,260,20,280,280,0,0
44443,2019-11-25,1335,0,1335,133,1468,1468,0,0
44444,2019-11-25,438,0,438,35,473,473,0,0
44445,2019-11-25,1000,0,1000,100,1100,1100,0,0
44446,2019-11-25,807,0,807,64,871,871,0,0
44447,2019-11-25,548,0,548,43,591,591,0,0
44448,2019-11-25,781,0,781,62,843,843,0,0
44449,2019-11-25,1528,0,1528,152,1680,1680,0,0
44450,2019-11-25,550,0,550,44,594,594,0,0
44451,2019-11-25,334,0,334,26,360,360,0,0
44452,2019-11-25,510,0,510,40,550,550,0,0
44453,2019-11-25,408,0,408,32,440,440,0,0
44454,2019-11-25,742,0,742,74,816,0,0,816
44455,2019-11-25,381,0,381,30,411,411,0,0
44456,2019-11-25,235,0,235,18,253,253,0,0
44457,2019-11-25,659,0,659,52,711,711,0,0
44458,2019-11-25,232,0,232,18,250,250,0,0
44459,2019-11-25,687,0,687,54,741,741,0,0
44460,2019-11-25,845,0,845,67,912,912,0,0
44461,2019-11-25,370,0,370,37,407,407,0,0
44462,2019-11-25,501,0,501,40,541,541,0,0
44463,2019-11-25,1256,0,1256,125,1381,1381,0,0
44464,2019-11-25,455,0,455,45,500,500,0,0
44465,2019-11-25,1159,0,1159,92,1251,1251,0,0
44466,2019-11-25,455,0,455,36,491,491,0,0
44467,2019-11-25,353,0,353,28,381,381,0,0
44468,2019-11-25,1114,0,1114,89,1203,1203,0,0
44469,2019-11-25,391,0,391,31,422,422,0,0
44470,2019-11-25,797,0,797,79,876,876,0,0
44471,2019-11-25,538,0,538,43,581,581,0,0
44472,2019-11-25,445,0,445,35,480,480,0,0
44473,2019-11-25,891,0,891,89,980,980,0,0
44474,2019-11-25,1169,0,1169,93,1262,1262,0,0
44475,2019-11-25,176,0,176,17,193,0,0,193
44476,2019-11-25,362,0,362,28,390,390,0,0
44477,2019-11-25,1833,0,1833,183,2016,2016,0,0
44478,2019-11-25,448,0,448,35,483,483,0,0
44479,2019-11-25,1651,0,1651,132,1783,1783,0,0
44480,2019-11-25,269,0,269,21,290,290,0,0
44481,2019-11-25,1782,0,1782,178,1960,1960,0,0
44482,2019-11-25,334,0,334,26,360,360,0,0
44483,2019-11-25,371,-37,334,26,360,360,0,0
44484,2019-11-26,733,0,733,73,806,806,0,0
44485,2019-11-26,929,0,929,92,1021,1021,0,0
44486,2019-11-26,862,0,862,86,948,948,0,0
44487,2019-11-26,705,0,705,56,761,0,761,0
44488,2019-11-26,483,0,483,38,521,521,0,0
44489,2019-11-26,695,0,695,55,750,750,0,0
44490,2019-11-26,965,0,965,77,1042,1042,0,0
44491,2019-11-26,538,0,538,43,581,0,0,581
44492,2019-11-26,261,0,261,20,281,281,0,0
44493,2019-11-26,753,0,753,60,813,813,0,0
44494,2019-11-26,649,0,649,51,700,700,0,0
44495,2019-11-26,288,0,288,23,311,311,0,0
44496,2019-11-26,454,0,454,36,490,490,0,0
44497,2019-11-26,288,0,288,23,311,311,0,0
44498,2019-11-26,408,0,408,32,440,440,0,0
44499,2019-11-26,854,0,854,85,939,939,0,0
44500,2019-11-26,1586,0,1586,126,1712,1712,0,0
44501,2019-11-26,1083,0,1083,108,1191,1191,0,0
44502,2019-11-26,260,0,260,20,280,280,0,0
44503,2019-11-26,381,-76,305,24,329,329,0,0
44504,2019-11-26,260,0,260,20,280,280,0,0
44505,2019-11-26,528,-105,423,33,456,456,0,0
44506,2019-11-26,427,0,427,34,461,461,0,0
44507,2019-11-26,269,0,269,21,290,290,0,0
44508,2019-11-27,353,0,353,35,388,0,0,388
44509,2019-11-27,100,0,100,8,108,108,0,0
44510,2019-11-27,501,0,501,40,541,541,0,0
44511,2019-11-27,334,0,334,26,360,360,0,0
44512,2019-11-27,473,0,473,37,510,510,0,0
44513,2019-11-27,1235,0,1235,123,1358,1358,0,0
44514,2019-11-27,899,0,899,89,988,988,0,0
44515,2019-11-27,445,0,445,44,489,0,489,0
44516,2019-11-27,279,0,279,27,306,306,0,0
44517,2019-11-27,643,0,643,51,694,694,0,0
44518,2019-11-27,818,0,818,65,883,883,0,0
44519,2019-11-27,334,0,334,33,367,367,0,0
44520,2019-11-27,260,0,260,20,280,280,0,0
44521,2019-11-27,797,0,797,79,876,876,0,0
44522,2019-11-27,288,0,288,23,311,311,0,0
44523,2019-11-27,891,0,891,89,980,980,0,0
44524,2019-11-27,269,0,269,21,290,290,0,0
44525,2019-11-27,1782,0,1782,178,1960,1960,0,0
44526,2019-11-27,585,0,585,46,631,631,0,0
44527,2019-11-27,649,0,649,51,700,700,0,0
44528,2019-11-27,223,0,223,22,245,245,0,0
44529,2019-11-27,529,0,529,42,571,571,0,0
44530,2019-11-27,1065,0,1065,106,1171,1171,0,0
44531,2019-11-27,640,0,640,51,691,691,0,0
44532,2019-11-27,1375,0,1375,110,1485,1485,0,0
44533,2019-11-27,706,0,706,56,762,762,0,0
44534,2019-11-27,512,0,512,51,563,563,0,0
44535,2019-11-27,352,0,352,28,380,380,0,0
44536,2019-11-27,306,0,306,24,330,330,0,0
44537,2019-11-27,371,0,371,29,400,400,0,0
44538,2019-11-27,484,0,484,38,522,0,522,0
44539,2019-11-27,141,0,141,11,152,152,0,0
44540,2019-11-27,363,0,363,29,392,392,0,0
44541,2019-11-27,427,0,427,34,461,461,0,0
44542,2019-11-27,1474,0,1474,117,1591,1591,0,0
44543,2019-11-27,603,0,603,48,651,651,0,0
44544,2019-11-27,770,0,770,61,831,831,0,0
44545,2019-11-27,482,0,482,38,520,520,0,0
44546,2019-11-27,149,0,149,11,160,160,0,0
44547,2019-11-27,371,0,371,29,400,400,0,0
44548,2019-11-27,473,0,473,37,510,510,0,0
44549,2019-11-27,260,0,260,20,280,280,0,0
44550,2019-11-27,614,0,614,49,663,663,0,0
44551,2019-11-27,491,-98,393,39,432,432,0,0
44552,2019-11-27,139,0,139,11,150,150,0,0
44553,2019-11-27,2235,0,2235,223,2458,2458,0,0
44554,2019-11-27,899,0,899,89,988,0,988,0
44555,2019-11-27,537,0,537,42,579,579,0,0
44556,2019-11-27,891,0,891,89,980,980,0,0
44557,2019-11-27,891,0,891,89,980,980,0,0
44558,2019-11-27,891,0,891,89,980,980,0,0
44559,2019-11-27,882,0,882,70,952,952,0,0
44560,2019-11-27,1213,0,1213,121,1334,1334,0,0
44561,2019-11-27,1011,-101,910,72,982,982,0,0
44562,2019-11-27,675,-135,540,43,583,0,583,0
44563,2019-11-27,1253,0,1253,125,1378,0,1378,0
44564,2019-11-27,1613,0,1613,161,1774,0,1774,0
44565,2019-11-27,464,0,464,37,501,501,0,0
44566,2019-11-27,1484,0,1484,118,1602,1602,0,0
44567,2019-11-27,728,0,728,58,786,786,0,0
44568,2019-11-27,1085,0,1085,86,1171,1171,0,0
44569,2019-11-27,622,0,622,49,671,671,0,0
44570,2019-11-27,817,0,817,65,882,882,0,0
44571,2019-11-27,2252,0,2252,225,2477,2477,0,0
44572,2019-11-27,773,0,773,77,850,850,0,0
44573,2019-11-27,1546,0,1546,154,1700,1700,0,0
44574,2019-11-27,1810,0,1810,181,1991,1991,0,0
44575,2019-11-27,250,0,250,20,270,270,0,0
44576,2019-11-27,1546,0,1546,154,1700,1700,0,0
44577,2019-11-27,965,0,965,77,1042,1042,0,0
44578,2019-11-27,668,0,668,53,721,721,0,0
44579,2019-11-27,798,0,798,63,861,0,0,861
44580,2019-11-27,1929,0,1929,154,2083,2083,0,0
44581,2019-11-27,891,0,891,89,980,0,980,0
44582,2019-11-27,619,0,619,49,668,668,0,0
44583,2019-11-27,547,0,547,43,590,0,590,0
44584,2019-11-27,540,0,540,43,583,583,0,0
44585,2019-11-27,1335,0,1335,133,1468,1468,0,0
44586,2019-11-27,891,0,891,89,980,980,0,0
44587,2019-11-27,501,0,501,40,541,541,0,0
44588,2019-11-27,733,-73,660,52,712,0,712,0
44589,2019-11-27,566,0,566,45,611,611,0,0
44590,2019-11-27,965,0,965,77,1042,1042,0,0
44591,2019-11-27,918,0,918,73,991,991,0,0
44592,2019-11-27,1513,-151,1362,108,1470,0,0,1470
44593,2019-11-27,446,0,446,35,481,481,0,0
44594,2019-11-27,891,0,891,89,980,980,0,0
44595,2019-11-27,891,0,891,89,980,980,0,0
44596,2019-11-27,1837,0,1837,146,1983,1983,0,0
44597,2019-11-27,891,0,891,89,980,980,0,0
44598,2019-11-27,512,-500,12,0,12,12,0,0
44599,2019-11-27,1567,0,1567,125,1692,1692,0,0
44600,2019-11-27,900,-180,720,57,777,777,0,0
44601,2019-11-27,427,0,427,34,461,0,0,461
44602,2019-11-27,1031,0,1031,82,1113,1113,0,0
44603,2019-11-28,390,0,390,31,421,421,0,0
44604,2019-11-28,575,0,575,46,621,621,0,0
44605,2019-11-28,576,0,576,46,622,0,622,0
44606,2019-11-28,1782,0,1782,178,1960,0,0,1960
44607,2019-11-28,3051,0,3051,305,3356,3356,0,0
44608,2019-11-28,872,0,872,69,941,0,941,0
44609,2019-11-28,613,0,613,49,662,662,0,0
44610,2019-11-28,298,0,298,23,321,321,0,0
44611,2019-11-28,390,0,390,31,421,421,0,0
44612,2019-11-28,1782,0,1782,178,1960,1960,0,0
44613,2019-11-28,1310,0,1310,104,1414,0,0,1414
44614,2019-11-28,751,0,751,75,826,826,0,0
44615,2019-11-28,753,0,753,60,813,0,813,0
44616,2019-11-28,512,0,512,40,552,552,0,0
44617,2019-11-28,391,0,391,31,422,422,0,0
44618,2019-11-28,529,-52,477,38,515,515,0,0
44619,2019-11-28,464,0,464,46,510,510,0,0
44620,2019-11-28,446,0,446,35,481,481,0,0
44621,2019-11-28,891,0,891,89,980,980,0,0
44622,2019-11-28,891,0,891,89,980,980,0,0
44623,2019-11-28,853,0,853,85,938,938,0,0
44624,2019-11-28,297,0,297,23,320,320,0,0
44625,2019-11-28,529,0,529,42,571,571,0,0
44626,2019-11-28,492,0,492,39,531,0,0,531
44627,2019-11-28,316,-31,285,22,307,307,0,0
44628,2019-11-28,408,0,408,32,440,440,0,0
44629,2019-11-28,751,0,751,75,826,826,0,0
44630,2019-11-28,343,0,343,27,370,370,0,0
44631,2019-11-28,316,0,316,25,341,341,0,0
44632,2019-11-28,759,0,759,75,834,834,0,0
44633,2019-11-28,269,0,269,21,290,290,0,0
44634,2019-11-28,1094,0,1094,87,1181,1181,0,0
44635,2019-11-28,630,0,630,50,680,680,0,0
44636,2019-11-28,389,0,389,31,420,420,0,0
44637,2019-11-28,475,0,475,38,513,0,0,513
44638,2019-11-28,798,0,798,63,861,861,0,0
44639,2019-11-28,538,0,538,53,591,591,0,0
44640,2019-11-28,269,0,269,21,290,290,0,0
44641,2019-11-28,538,0,538,43,581,581,0,0
44642,2019-11-28,668,-66,602,48,650,650,0,0
44643,2019-11-28,492,0,492,49,541,541,0,0
44644,2019-11-28,1782,0,1782,178,1960,1960,0,0
44645,2019-11-28,520,0,520,41,561,0,561,0
44646,2019-11-28,1113,0,1113,89,1202,1202,0,0
44647,2019-11-28,677,0,677,54,731,731,0,0
44648,2019-11-28,1186,0,1186,118,1304,1304,0,0
44649,2019-11-28,827,0,827,66,893,893,0,0
44650,2019-11-28,2799,0,2799,279,3078,3078,0,0
44651,2019-11-28,1565,0,1565,156,1721,1721,0,0
44652,2019-11-28,307,0,307,24,331,331,0,0
44653,2019-11-28,121,0,121,9,130,130,0,0
44654,2019-11-28,584,0,584,58,642,642,0,0
44655,2019-11-28,715,0,715,57,772,772,0,0
44656,2019-11-28,732,0,732,73,805,805,0,0
44657,2019-11-28,297,0,297,23,320,320,0,0
44658,2019-11-28,1194,0,1194,119,1313,1313,0,0
44659,2019-11-28,260,0,260,20,280,280,0,0
44660,2019-11-28,1017,0,1017,101,1118,1118,0,0
44661,2019-11-28,436,0,436,34,470,470,0,0
44662,2019-11-28,817,0,817,65,882,882,0,0
44663,2019-11-28,232,0,232,18,250,250,0,0
44664,2019-11-28,1132,0,1132,90,1222,1222,0,0
44665,2019-11-28,891,0,891,89,980,0,980,0
44666,2019-11-28,370,0,370,37,407,407,0,0
44667,2019-11-28,3185,0,3185,318,3503,0,3503,0
44668,2019-11-28,742,0,742,59,801,801,0,0
44669,2019-11-28,1224,0,1224,122,1346,1346,0,0
44670,2019-11-28,1085,0,1085,86,1171,1171,0,0
44671,2019-11-28,500,0,500,40,540,540,0,0
44672,2019-11-28,1198,0,1198,95,1293,1293,0,0
44673,2019-11-28,362,0,362,28,390,0,0,390
44674,2019-11-28,808,0,808,64,872,872,0,0
44675,2019-11-28,232,0,232,18,250,250,0,0
44676,2019-11-28,844,0,844,67,911,911,0,0
44677,2019-11-28,773,0,773,77,850,850,0,0
44678,2019-11-28,1546,0,1546,154,1700,1700,0,0
44679,2019-11-28,297,0,297,23,320,320,0,0
44680,2019-11-28,807,0,807,64,871,871,0,0
44681,2019-11-28,306,0,306,24,330,330,0,0
44682,2019-11-28,2534,0,2534,202,2736,2736,0,0
44683,2019-11-28,529,0,529,52,581,581,0,0
44684,2019-11-28,844,0,844,67,911,911,0,0
44685,2019-11-28,931,-93,838,67,905,0,905,0
44686,2019-11-28,631,0,631,63,694,694,0,0
44687,2019-11-28,658,0,658,65,723,723,0,0
44688,2019-11-28,399,0,399,31,430,430,0,0
44689,2019-11-28,149,0,149,11,160,160,0,0
44690,2019-11-28,908,0,908,72,980,980,0,0
44691,2019-11-28,442,0,442,35,477,0,477,0
44692,2019-11-28,279,0,279,22,301,301,0,0
44693,2019-11-28,288,0,288,23,311,0,311,0
44694,2019-11-28,1898,0,1898,189,2087,2087,0,0
44695,2019-11-28,482,0,482,48,530,530,0,0
44696,2019-11-28,889,0,889,88,977,977,0,0
44697,2019-11-28,139,0,139,13,152,152,0,0
44698,2019-11-28,1010,0,1010,101,1111,1111,0,0
44699,2019-11-28,427,0,427,34,461,461,0,0
44700,2019-11-28,269,0,269,21,290,290,0,0
44701,2019-11-28,260,0,260,20,280,280,0,0
44702,2019-11-28,529,0,529,42,571,571,0,0
44703,2019-11-28,807,0,807,64,871,871,0,0
44704,2019-11-28,1188,0,1188,118,1306,1306,0,0
44705,2019-11-28,761,0,761,60,821,821,0,0
44706,2019-11-28,780,0,780,62,842,842,0,0
44707,2019-11-28,773,0,773,77,850,850,0,0
44708,2019-11-28,1539,0,1539,123,1662,1662,0,0
44709,2019-11-28,650,0,650,52,702,702,0,0
44710,2019-11-28,556,0,556,44,600,600,0,0
44711,2019-11-28,891,0,891,89,980,980,0,0
44712,2019-11-28,3206,0,3206,320,3526,3526,0,0
44713,2019-11-28,112,0,112,8,120,120,0,0
44714,2019-11-28,743,0,743,59,802,802,0,0
44715,2019-11-28,780,0,780,62,842,842,0,0
44716,2019-11-28,595,0,595,47,642,642,0,0
44717,2019-11-28,445,0,445,35,480,480,0,0
44718,2019-11-28,807,0,807,64,871,871,0,0
44719,2019-11-28,658,-65,593,47,640,640,0,0
44720,2019-11-28,269,0,269,21,290,290,0,0
44721,2019-11-28,1002,0,1002,80,1082,1082,0,0
44722,2019-11-28,269,0,269,21,290,290,0,0
44723,2019-11-28,282,0,282,22,304,304,0,0
44724,2019-11-28,556,0,556,44,600,600,0,0
44725,2019-11-28,1546,-154,1392,139,1531,0,1531,0
44726,2019-11-28,1697,0,1697,135,1832,0,1832,0
44727,2019-11-28,1140,0,1140,114,1254,1254,0,0
44728,2019-11-28,1621,0,1621,162,1783,0,0,1783
44729,2019-11-28,891,0,891,71,962,962,0,0
44730,2019-11-28,603,-500,103,8,111,111,0,0
44731,2019-11-28,613,0,613,49,662,662,0,0
44732,2019-11-28,677,0,677,54,731,0,0,731
44733,2019-11-28,334,0,334,26,360,360,0,0
44734,2019-11-28,853,0,853,68,921,0,921,0
44735,2019-11-28,1010,0,1010,80,1090,1090,0,0
44736,2019-11-28,909,0,909,72,981,981,0,0
44737,2019-11-29,1782,0,1782,178,1960,1960,0,0
44738,2019-11-29,2410,0,2410,241,2651,2651,0,0
44739,2019-11-29,845,0,845,67,912,912,0,0
44740,2019-11-29,891,-89,802,80,882,882,0,0
44741,2019-11-29,576,0,576,46,622,622,0,0
44742,2019-11-29,1782,0,1782,178,1960,1960,0,0
44743,2019-11-29,1782,0,1782,178,1960,1960,0,0
44744,2019-11-29,334,0,334,26,360,360,0,0
44745,2019-11-29,928,0,928,74,1002,0,0,1002
44746,2019-11-29,334,0,334,26,360,360,0,0
44747,2019-11-29,630,0,630,63,693,693,0,0
44748,2019-11-29,928,0,928,74,1002,1002,0,0
44749,2019-11-29,539,0,539,43,582,582,0,0
44750,2019-11-29,1057,0,1057,84,1141,1141,0,0
44751,2019-11-29,613,0,613,49,662,662,0,0
44752,2019-11-29,1066,0,1066,85,1151,1151,0,0
44753,2019-11-29,1826,0,1826,182,2008,2008,0,0
44754,2019-11-29,604,0,604,48,652,0,652,0
44755,2019-11-29,1782,0,1782,178,1960,1960,0,0
44756,2019-11-29,1782,0,1782,178,1960,1960,0,0
44757,2019-11-29,269,0,269,21,290,290,0,0
44758,2019-11-29,713,0,713,71,784,784,0,0
44759,2019-11-29,1097,0,1097,87,1184,1184,0,0
44760,2019-11-29,1076,0,1076,86,1162,0,1162,0
44761,2019-11-29,695,0,695,55,750,750,0,0
44762,2019-11-29,1328,0,1328,106,1434,1434,0,0
44763,2019-11-29,1782,0,1782,178,1960,1960,0,0
44764,2019-11-29,1003,0,1003,80,1083,1083,0,0
44765,2019-11-29,370,0,370,37,407,407,0,0
44766,2019-11-29,352,0,352,35,387,387,0,0
44767,2019-11-29,352,0,352,35,387,0,387,0
44768,2019-11-29,352,0,352,35,387,0,387,0
44769,2019-11-29,603,0,603,48,651,651,0,0
44770,2019-11-29,3051,0,3051,305,3356,3356,0,0
44771,2019-11-29,557,0,557,44,601,601,0,0
44772,2019-11-29,891,0,891,89,980,980,0,0
44773,2019-11-29,3564,0,3564,356,3920,3920,0,0
44774,2019-11-29,1546,0,1546,154,1700,1700,0,0
44775,2019-11-29,816,0,816,81,897,897,0,0
44776,2019-11-29,781,0,781,78,859,859,0,0
44777,2019-11-29,139,0,139,13,152,152,0,0
44778,2019-11-29,130,0,130,10,140,140,0,0
44779,2019-11-29,696,0,696,69,765,765,0,0
44780,2019-11-29,269,0,269,21,290,290,0,0
44781,2019-11-29,139,0,139,11,150,150,0,0
44782,2019-11-29,558,0,558,44,602,602,0,0
44783,2019-11-29,604,0,604,48,652,652,0,0
44784,2019-11-29,1013,0,1013,81,1094,1094,0,0
44785,2019-11-29,362,0,362,28,390,390,0,0
44786,2019-11-29,269,0,269,21,290,290,0,0
44787,2019-11-29,574,0,574,57,631,631,0,0
44788,2019-11-29,455,0,455,36,491,491,0,0
44789,2019-11-29,1966,-196,1770,177,1947,0,0,1947
44790,2019-11-29,1466,-146,1320,105,1425,1425,0,0
44791,2019-11-29,863,0,863,69,932,932,0,0
44792,2019-11-29,4455,0,4455,445,4900,4900,0,0
44793,2019-11-29,427,0,427,34,461,461,0,0
44794,2019-11-29,1058,0,1058,84,1142,1142,0,0
44795,2019-11-29,565,0,565,56,621,621,0,0
44796,2019-11-29,695,0,695,69,764,764,0,0
44797,2019-11-29,1519,0,1519,151,1670,1670,0,0
44798,2019-11-29,704,0,704,70,774,774,0,0
44799,2019-11-29,-1519,0,-1519,-151,-1670,-1670,0,0
44800,2019-11-29,1519,-151,1368,136,1504,1504,0,0
44801,2019-11-29,891,0,891,89,980,980,0,0
44802,2019-11-29,1691,0,1691,135,1826,1826,0,0
44803,2019-11-29,891,0,891,89,980,980,0,0
44804,2019-11-29,158,0,158,12,170,170,0,0
44805,2019-11-29,1511,0,1511,151,1662,1662,0,0
44806,2019-11-29,1511,0,1511,151,1662,1662,0,0
44807,2019-11-29,-1511,0,-1511,-151,-1662,-1662,0,0
44808,2019-11-29,622,0,622,49,671,671,0,0
44809,2019-11-29,2033,0,2033,162,2195,2195,0,0
44810,2019-11-29,843,0,843,84,927,927,0,0
44811,2019-11-29,1782,0,1782,178,1960,0,0,1960
44812,2019-11-29,696,0,696,55,751,751,0,0
44813,2019-11-29,928,0,928,74,1002,1002,0,0
44814,2019-11-29,548,0,548,43,591,591,0,0
44815,2019-11-29,445,0,445,35,480,480,0,0
44816,2019-11-29,1546,0,1546,154,1700,1700,0,0
44817,2019-11-29,995,0,995,79,1074,1074,0,0
44818,2019-11-29,454,0,454,36,490,490,0,0
44819,2019-11-29,1237,0,1237,98,1335,1335,0,0
44820,2019-11-29,1355,0,1355,108,1463,1463,0,0
44821,2019-11-29,773,0,773,77,850,0,0,850
44822,2019-11-29,1546,0,1546,154,1700,0,0,1700
44823,2019-11-29,1011,0,1011,101,1112,1112,0,0
44824,2019-11-29,677,0,677,67,744,744,0,0
44825,2019-11-29,724,0,724,57,781,781,0,0
44826,2019-11-29,1797,0,1797,179,1976,1976,0,0
44827,2019-11-29,3365,0,3365,336,3701,3701,0,0
44828,2019-11-29,695,0,695,69,764,0,0,764
44829,2019-11-29,706,0,706,56,762,0,0,762
44830,2019-11-29,-93,0,-93,-7,-100,-100,0,0
44831,2019-11-29,93,0,93,7,100,100,0,0
44832,2019-11-29,139,0,139,11,150,150,0,0
44833,2019-11-29,548,0,548,43,591,591,0,0
44834,2019-11-29,1058,0,1058,105,1163,0,0,1163
44835,2019-11-29,928,0,928,74,1002,1002,0,0
44836,2019-11-29,916,0,916,91,1007,1007,0,0
44837,2019-11-29,494,0,494,39,533,0,0,533
44838,2019-11-29,547,0,547,43,590,590,0,0
44839,2019-11-29,834,0,834,83,917,917,0,0
44840,2019-11-29,485,0,485,38,523,523,0,0
44841,2019-11-29,548,0,548,43,591,591,0,0
44842,2019-11-29,1373,0,1373,109,1482,1482,0,0
44843,2019-11-29,149,0,149,11,160,160,0,0
44844,2019-11-29,270,0,270,21,291,291,0,0
44845,2019-11-29,871,0,871,87,958,958,0,0
44846,2019-11-29,603,0,603,48,651,0,0,651
44847,2019-11-29,260,0,260,20,280,280,0,0
44848,2019-11-29,251,0,251,20,271,0,0,271
44849,2019-11-29,408,0,408,32,440,440,0,0
44850,2019-11-29,631,0,631,50,681,681,0,0
44851,2019-11-29,640,0,640,64,704,704,0,0
44852,2019-11-29,56,0,56,4,60,60,0,0
44853,2019-11-29,547,-54,493,39,532,532,0,0
44854,2019-11-29,316,0,316,25,341,341,0,0
44855,2019-11-29,873,0,873,69,942,942,0,0
44856,2019-11-29,2603,0,2603,260,2863,2863,0,0
44857,2019-11-29,2199,0,2199,219,2418,2418,0,0
44858,2019-11-29,1385,0,1385,110,1495,1495,0,0
44859,2019-11-29,2092,0,2092,209,2301,2301,0,0
44860,2019-11-29,1234,0,1234,98,1332,0,1332,0
44861,2019-11-29,937,0,937,74,1011,1011,0,0
44862,2019-11-29,1481,0,1481,148,1629,1629,0,0
44863,2019-11-29,576,0,576,46,622,622,0,0
44864,2019-11-29,676,0,676,67,743,0,0,743
44865,2019-11-29,306,0,306,24,330,0,0,330
44866,2019-11-29,686,0,686,68,754,754,0,0
44867,2019-11-29,773,0,773,77,850,850,0,0
44868,2019-11-29,260,0,260,20,280,280,0,0
44869,2019-11-29,501,0,501,40,541,541,0,0
44870,2019-11-29,773,0,773,77,850,850,0,0
44871,2019-11-29,1800,0,1800,180,1980,0,1980,0
44872,2019-11-29,825,0,825,66,891,891,0,0
44873,2019-11-29,1020,0,1020,81,1101,1101,0,0
44874,2019-11-29,773,0,773,77,850,850,0,0
44875,2019-11-29,773,0,773,77,850,850,0,0
44876,2019-11-29,1546,0,1546,154,1700,1700,0,0
44877,2019-11-29,809,0,809,64,873,873,0,0
44878,2019-11-29,280,0,280,22,302,302,0,0
44879,2019-11-29,974,0,974,77,1051,0,1051,0
44880,2019-11-29,1168,0,1168,93,1261,1261,0,0
44881,2019-11-29,1546,0,1546,154,1700,1700,0,0
44882,2019-11-29,185,0,185,14,199,199,0,0
44883,2019-11-29,1990,0,1990,199,2189,0,2189,0
44884,2019-11-29,1123,0,1123,89,1212,0,1212,0
44885,2019-11-29,250,0,250,20,270,270,0,0
44886,2019-11-29,882,0,882,70,952,952,0,0
44887,2019-11-29,343,0,343,27,370,370,0,0
44888,2019-11-29,1048,0,1048,83,1131,1131,0,0
44889,2019-11-29,1546,0,1546,154,1700,1700,0,0
44890,2019-11-30,631,0,631,50,681,0,0,681
44891,2019-11-30,827,0,827,66,893,0,893,0
44892,2019-11-30,1375,0,1375,110,1485,1485,0,0
44893,2019-11-30,844,-84,760,60,820,0,820,0
44894,2019-11-30,677,0,677,54,731,0,731,0
44895,2019-11-30,612,0,612,48,660,660,0,0
44896,2019-11-30,121,0,121,9,130,130,0,0
44897,2019-11-30,557,0,557,44,601,601,0,0
44898,2019-11-30,1150,0,1150,92,1242,1242,0,0
44899,2019-11-30,1088,0,1088,87,1175,1175,0,0
44900,2019-11-30,455,0,455,36,491,491,0,0
44901,2019-11-30,1437,0,1437,143,1580,1580,0,0
44902,2019-11-30,650,0,650,52,702,702,0,0
44903,2019-11-30,603,0,603,48,651,651,0,0
44904,2019-11-30,1224,0,1224,97,1321,1321,0,0
44905,2019-11-30,483,0,483,38,521,521,0,0
44906,2019-11-30,47,-4,43,3,46,0,0,46
44907,2019-11-30,686,0,686,54,740,740,0,0
44908,2019-11-30,576,0,576,46,622,0,622,0
44909,2019-11-30,742,0,742,74,816,816,0,0
44910,2019-11-30,752,0,752,60,812,0,0,812
44911,2019-11-30,1166,0,1166,116,1282,1282,0,0
44912,2019-11-30,623,0,623,49,672,672,0,0
44913,2019-11-30,566,0,566,56,622,622,0,0
44914,2019-11-30,621,0,621,49,670,670,0,0
44915,2019-11-30,298,0,298,23,321,0,0,321
44916,2019-11-30,1279,0,1279,127,1406,0,0,1406
44917,2019-11-30,798,0,798,79,877,877,0,0
44918,2019-11-30,687,0,687,54,741,741,0,0
44919,2019-11-30,1782,0,1782,178,1960,1960,0,0
44920,2019-11-30,631,0,631,63,694,694,0,0
44921,2019-11-30,1529,0,1529,152,1681,1681,0,0
44922,2019-11-30,417,0,417,33,450,450,0,0
44923,2019-11-30,250,0,250,20,270,270,0,0
44924,2019-11-30,1467,0,1467,117,1584,1584,0,0
44925,2019-11-30,1178,0,1178,94,1272,1272,0,0
44926,2019-11-30,139,0,139,11,150,150,0,0
44927,2019-11-30,1094,0,1094,87,1181,0,1181,0
44928,2019-11-30,306,0,306,24,330,0,0,330
44929,2019-11-30,464,0,464,37,501,501,0,0
44930,2019-11-30,892,0,892,71,963,963,0,0
44931,2019-11-30,380,0,380,38,418,418,0,0
44932,2019-11-30,594,0,594,47,641,641,0,0
44933,2019-11-30,260,0,260,20,280,280,0,0
44934,2019-11-30,740,0,740,74,814,814,0,0
44935,2019-11-30,740,0,740,74,814,814,0,0
44936,2019-11-30,1537,0,1537,153,1690,1690,0,0
44937,2019-11-30,103,0,103,10,113,113,0,0
44938,2019-11-30,316,0,316,25,341,341,0,0
44939,2019-11-30,437,0,437,34,471,471,0,0
44940,2019-11-30,770,0,770,61,831,831,0,0
44941,2019-11-30,2151,0,2151,215,2366,2366,0,0
44942,2019-11-30,659,0,659,52,711,0,711,0
44943,2019-11-30,1003,0,1003,80,1083,1083,0,0
44944,2019-11-30,1149,0,1149,114,1263,1263,0,0
44945,2019-11-30,93,0,93,7,100,100,0,0
44946,2019-11-30,418,0,418,33,451,451,0,0
44947,2019-11-30,381,0,381,30,411,0,0,411
44948,2019-11-30,446,0,446,35,481,481,0,0
44949,2019-11-30,343,0,343,27,370,370,0,0
44950,2019-11-30,482,0,482,38,520,520,0,0
44951,2019-11-30,779,0,779,62,841,841,0,0
44952,2019-11-30,853,0,853,68,921,921,0,0
44953,2019-11-30,343,0,343,27,370,370,0,0
44954,2019-11-30,176,0,176,14,190,190,0,0
44955,2019-11-30,1782,0,1782,178,1960,1960,0,0
44956,2019-11-30,1782,0,1782,178,1960,1960,0,0
44957,2019-11-30,1243,0,1243,124,1367,1367,0,0
44958,2019-11-30,603,0,603,48,651,651,0,0
44959,2019-11-30,2421,0,2421,193,2614,2614,0,0
44960,2019-11-30,1029,0,1029,82,1111,1111,0,0
44961,2019-11-30,2978,0,2978,297,3275,0,3275,0
44962,2019-11-30,1445,0,1445,144,1589,1589,0,0
44963,2019-11-30,345,0,345,27,372,372,0,0
44964,2019-11-30,538,0,538,53,591,591,0,0
44965,2019-11-30,632,0,632,50,682,682,0,0
44966,2019-11-30,686,0,686,68,754,754,0,0
44967,2019-11-30,214,0,214,17,231,0,0,231
44968,2019-11-30,455,0,455,36,491,491,0,0
44969,2019-11-30,1782,0,1782,178,1960,1960,0,0
44970,2019-11-30,520,0,520,41,561,561,0,0
44971,2019-11-30,473,0,473,37,510,510,0,0
44972,2019-11-30,224,0,224,17,241,241,0,0
44973,2019-11-30,343,0,343,27,370,370,0,0
44974,2019-11-30,882,0,882,70,952,0,952,0
44975,2019-11-30,1123,0,1123,89,1212,1212,0,0
44976,2019-11-30,316,0,316,25,341,341,0,0
44977,2019-11-30,891,0,891,89,980,980,0,0
44978,2019-11-30,260,-26,234,18,252,252,0,0
44979,2019-11-30,679,0,679,54,733,733,0,0
44980,2019-11-30,1178,0,1178,94,1272,1272,0,0
44981,2019-11-30,770,0,770,61,831,831,0,0
44982,2019-11-30,861,-86,775,77,852,0,852,0
44983,2019-11-30,308,0,308,24,332,0,332,0
44984,2019-11-30,679,0,679,54,733,733,0,0
44985,2019-11-30,204,0,204,16,220,220,0,0
44986,2019-11-30,585,0,585,46,631,631,0,0
44987,2019-11-30,716,0,716,57,773,773,0,0
44988,2019-11-30,250,0,250,20,270,270,0,0
44989,2019-11-30,773,-77,696,69,765,765,0,0
44990,2019-11-30,773,0,773,77,850,850,0,0
44991,2019-11-30,773,0,773,77,850,850,0,0
44992,2019-11-30,773,0,773,77,850,0,0,850
44993,2019-11-30,844,0,844,67,911,911,0,0
44994,2019-11-30,2092,0,2092,209,2301,2301,0,0
44995,2019-11-30,2519,0,2519,251,2770,2770,0,0
44996,2019-11-30,807,0,807,64,871,871,0,0
44997,2019-11-30,621,0,621,49,670,670,0,0
44998,2019-11-30,510,0,510,40,550,0,550,0
44999,2019-11-30,853,0,853,68,921,0,921,0
45000,2019-11-30,1782,0,1782,178,1960,1960,0,0
45001,2019-11-30,920,0,920,73,993,0,0,993
45002,2019-11-30,2817,0,2817,281,3098,3098,0,0
45003,2019-11-30,1688,0,1688,168,1856,1856,0,0
45004,2019-11-30,1454,0,1454,145,1599,1599,0,0
45005,2019-11-30,520,-52,468,37,505,505,0,0
45006,2019-11-30,1085,0,1085,108,1193,1193,0,0
45007,2019-11-30,1069,0,1069,85,1154,1154,0,0
45008,2019-11-30,317,0,317,25,342,342,0,0
45009,2019-11-30,566,0,566,45,611,611,0,0
45010,2019-11-30,2315,0,2315,185,2500,2500,0,0
45011,2019-11-30,751,0,751,75,826,826,0,0
45012,2019-11-30,1383,0,1383,110,1493,1493,0,0
45013,2019-11-30,667,0,667,66,733,733,0,0
45014,2019-11-30,1677,0,1677,167,1844,1844,0,0
45015,2019-11-30,704,0,704,70,774,774,0,0
45016,2019-11-30,1343,0,1343,134,1477,1477,0,0
45017,2019-11-30,715,0,715,57,772,0,772,0
45018,2019-11-30,232,0,232,18,250,250,0,0
45019,2019-11-30,715,0,715,57,772,772,0,0
45020,2019-11-30,464,-46,418,33,451,0,0,451
45021,2019-11-30,306,0,306,24,330,330,0,0
45022,2019-11-30,260,0,260,20,280,280,0,0
45023,2019-11-30,2277,0,2277,227,2504,2504,0,0
45024,2019-11-30,935,0,935,93,1028,1028,0,0
45025,2019-11-30,167,0,167,13,180,180,0,0
45026,2019-11-30,510,0,510,40,550,550,0,0
45027,2019-11-30,1076,0,1076,86,1162,0,1162,0
45028,2019-11-30,1546,0,1546,154,1700,1700,0,0
45029,2019-11-30,1245,0,1245,99,1344,0,1344,0
45030,2019-11-30,2319,0,2319,231,2550,2550,0,0
45031,2019-11-30,1198,0,1198,95,1293,1293,0,0
45032,2019-11-30,880,0,880,88,968,968,0,0
45033,2019-11-30,520,0,520,41,561,561,0,0
45034,2019-11-30,538,0,538,43,581,581,0,0
45035,2019-11-30,223,0,223,17,240,0,0,240
45036,2019-11-30,253,0,253,20,273,273,0,0
45037,2019-11-30,891,0,891,71,962,962,0,0
45038,2019-11-30,537,0,537,42,579,579,0,0
45039,2019-11-30,389,0,389,31,420,420,0,0
45040,2019-11-30,1005,0,1005,80,1085,1085,0,0
45041,2019-11-30,1592,0,1592,159,1751,0,0,1751
45042,2019-11-30,1252,0,1252,100,1352,1352,0,0
45043,2019-11-30,1037,0,1037,103,1140,1140,0,0
45044,2019-11-30,1401,0,1401,140,1541,0,0,1541
45045,2019-11-30,1546,-309,1237,123,1360,1360,0,0
45046,2019-11-30,1546,0,1546,154,1700,0,0,1700
45047,2019-11-30,510,0,510,40,550,0,550,0
45048,2019-11-30,1122,0,1122,89,1211,0,1211,0
45049,2019-11-30,621,0,621,62,683,683,0,0
45050,2019-11-30,593,0,593,47,640,640,0,0
45051,2019-11-30,918,0,918,73,991,991,0,0
45052,2019-11-30,1546,0,1546,154,1700,1700,0,0
45053,2019-11-30,773,0,773,77,850,0,850,0
45054,2019-11-30,641,0,641,51,692,692,0,0
45055,2019-11-30,1234,0,1234,98,1332,1332,0,0
45056,2019-11-30,1104,0,1104,88,1192,0,0,1192
45057,2019-11-30,1718,0,1718,137,1855,0,1855,0
45058,2019-11-30,1334,0,1334,133,1467,1467,0,0
45059,2019-11-30,473,0,473,37,510,510,0,0
45060,2019-11-30,501,0,501,40,541,541,0,0
45061,2019-11-30,1546,0,1546,154,1700,1700,0,0
45062,2019-11-30,649,0,649,51,700,700,0,0
45063,2019-12-01,891,0,891,89,980,980,0,0
45064,2019-12-01,891,0,891,89,980,980,0,0
45065,2019-12-01,891,0,891,89,980,980,0,0
45066,2019-12-01,891,0,891,89,980,0,980,0
45067,2019-12-01,232,0,232,18,250,250,0,0
45068,2019-12-01,510,0,510,40,550,550,0,0
45069,2019-12-01,713,0,713,71,784,784,0,0
45070,2019-12-01,668,0,668,66,734,734,0,0
45071,2019-12-01,1241,0,1241,124,1365,1365,0,0
45072,2019-12-01,2318,0,2318,185,2503,2503,0,0
45073,2019-12-01,557,0,557,44,601,601,0,0
45074,2019-12-01,761,-76,685,54,739,739,0,0
45075,2019-12-01,352,0,352,35,387,387,0,0
45076,2019-12-01,891,0,891,89,980,980,0,0
45077,2019-12-01,176,0,176,14,190,190,0,0
45078,2019-12-01,418,0,418,33,451,451,0,0
45079,2019-12-01,353,0,353,35,388,388,0,0
45080,2019-12-01,724,0,724,72,796,796,0,0
45081,2019-12-01,269,0,269,21,290,290,0,0
45082,2019-12-01,698,0,698,55,753,753,0,0
45083,2019-12-01,844,0,844,67,911,0,911,0
45084,2019-12-01,1029,0,1029,82,1111,1111,0,0
45085,2019-12-01,1918,0,1918,191,2109,2109,0,0
45086,2019-12-01,139,0,139,11,150,150,0,0
45087,2019-12-01,139,0,139,11,150,150,0,0
45088,2019-12-01,1781,0,1781,178,1959,1959,0,0
45089,2019-12-01,269,0,269,21,290,290,0,0
45090,2019-12-01,447,0,447,35,482,0,482,0
45091,2019-12-01,593,0,593,59,652,0,652,0
45092,2019-12-01,3193,0,3193,255,3448,3448,0,0
45093,2019-12-01,242,0,242,19,261,261,0,0
45094,2019-12-01,343,0,343,27,370,370,0,0
45095,2019-12-01,946,0,946,75,1021,1021,0,0
45096,2019-12-01,982,0,982,78,1060,1060,0,0
45097,2019-12-01,927,0,927,74,1001,1001,0,0
45098,2019-12-01,900,0,900,72,972,972,0,0
45099,2019-12-01,370,0,370,37,407,407,0,0
45100,2019-12-01,491,0,491,49,540,540,0,0
45101,2019-12-01,1928,0,1928,154,2082,2082,0,0
45102,2019-12-01,983,0,983,78,1061,1061,0,0
45103,2019-12-01,300,0,300,24,324,324,0,0
45104,2019-12-01,1762,0,1762,140,1902,1902,0,0
45105,2019-12-01,834,0,834,83,917,917,0,0
45106,2019-12-01,501,0,501,40,541,541,0,0
45107,2019-12-01,613,0,613,49,662,662,0,0
45108,2019-12-01,418,0,418,33,451,0,0,451
45109,2019-12-01,232,0,232,18,250,250,0,0
45110,2019-12-01,548,0,548,43,591,591,0,0
45111,2019-12-01,517,0,517,41,558,558,0,0
45112,2019-12-01,112,0,112,11,123,123,0,0
45113,2019-12-01,167,0,167,16,183,183,0,0
45114,2019-12-01,278,0,278,22,300,300,0,0
45115,2019-12-01,167,0,167,13,180,180,0,0
45116,2019-12-01,751,0,751,60,811,811,0,0
45117,2019-12-01,149,0,149,11,160,0,160,0
45118,2019-12-01,278,0,278,22,300,300,0,0
45119,2019-12-01,770,0,770,61,831,0,831,0
45120,2019-12-01,1021,0,1021,102,1123,0,1123,0
45121,2019-12-01,780,0,780,62,842,0,0,842
45122,2019-12-01,483,0,483,48,531,531,0,0
45123,2019-12-01,650,0,650,65,715,715,0,0
45124,2019-12-01,139,0,139,11,150,150,0,0
45125,2019-12-01,955,0,955,76,1031,1031,0,0
45126,2019-12-01,1047,0,1047,83,1130,1130,0,0
45127,2019-12-01,455,0,455,36,491,491,0,0
45128,2019-12-01,1492,0,1492,149,1641,1641,0,0
45129,2019-12-01,773,0,773,77,850,850,0,0
45130,2019-12-01,1256,0,1256,125,1381,1381,0,0
45131,2019-12-01,528,0,528,42,570,0,570,0
45132,2019-12-01,584,-58,526,42,568,568,0,0
45133,2019-12-01,835,0,835,66,901,901,0,0
45134,2019-12-01,770,0,770,61,831,831,0,0
45135,2019-12-01,891,0,891,89,980,980,0,0
45136,2019-12-01,1030,0,1030,82,1112,1112,0,0
45137,2019-12-01,1632,0,1632,112,1744,1744,0,0
45138,2019-12-01,937,0,937,74,1011,1011,0,0
45139,2019-12-01,470,0,470,37,507,507,0,0
45140,2019-12-01,1715,0,1715,171,1886,1886,0,0
45141,2019-12-01,899,0,899,71,970,970,0,0
45142,2019-12-01,773,0,773,77,850,850,0,0
45143,2019-12-01,1546,-154,1392,139,1531,0,1531,0
45144,2019-12-01,594,0,594,47,641,641,0,0
45145,2019-12-01,297,0,297,23,320,320,0,0
45146,2019-12-01,519,0,519,41,560,560,0,0
45147,2019-12-01,473,0,473,37,510,510,0,0
45148,2019-12-01,773,0,773,77,850,850,0,0
45149,2019-12-02,1782,-178,1604,160,1764,1764,0,0
45150,2019-12-02,195,0,195,15,210,210,0,0
45151,2019-12-02,1782,0,1782,178,1960,1960,0,0
45152,2019-12-02,1782,0,1782,178,1960,0,1960,0
45153,2019-12-02,492,0,492,39,531,531,0,0
45154,2019-12-02,289,0,289,23,312,312,0,0
45155,2019-12-02,1817,0,1817,145,1962,1962,0,0
45156,2019-12-02,269,0,269,21,290,290,0,0
45157,2019-12-02,575,0,575,46,621,621,0,0
45158,2019-12-02,725,0,725,58,783,783,0,0
45159,2019-12-02,139,0,139,11,150,150,0,0
45160,2019-12-02,891,0,891,89,980,980,0,0
45161,2019-12-02,649,-64,585,58,643,643,0,0
45162,2019-12-02,891,0,891,89,980,980,0,0
45163,2019-12-02,974,0,974,77,1051,1051,0,0
45164,2019-12-02,205,0,205,16,221,0,0,221
45165,2019-12-02,371,0,371,29,400,400,0,0
45166,2019-12-02,1921,0,1921,192,2113,2113,0,0
45167,2019-12-02,1189,-118,1071,85,1156,1156,0,0
45168,2019-12-02,1782,0,1782,178,1960,1960,0,0
45169,2019-12-02,584,0,584,46,630,630,0,0
45170,2019-12-02,1020,0,1020,102,1122,1122,0,0
45171,2019-12-02,760,0,760,76,836,836,0,0
45172,2019-12-02,241,0,241,19,260,260,0,0
45173,2019-12-02,482,0,482,48,530,530,0,0
45174,2019-12-02,251,0,251,20,271,271,0,0
45175,2019-12-02,826,0,826,82,908,0,908,0
45176,2019-12-02,1789,0,1789,178,1967,1967,0,0
45177,2019-12-02,918,0,918,73,991,991,0,0
45178,2019-12-02,343,0,343,27,370,370,0,0
45179,2019-12-02,713,0,713,71,784,784,0,0
45180,2019-12-02,520,0,520,41,561,561,0,0
45181,2019-12-02,558,0,558,44,602,602,0,0
45182,2019-12-02,372,0,372,29,401,401,0,0
45183,2019-12-02,779,0,779,62,841,841,0,0
45184,2019-12-02,186,0,186,14,200,0,200,0
45185,2019-12-02,740,0,740,74,814,814,0,0
45186,2019-12-02,1335,0,1335,106,1441,1441,0,0
45187,2019-12-02,603,0,603,48,651,651,0,0
45188,2019-12-02,363,0,363,36,399,399,0,0
45189,2019-12-02,705,0,705,70,775,775,0,0
45190,2019-12-02,1272,0,1272,101,1373,1373,0,0
45191,2019-12-02,547,0,547,43,590,590,0,0
45192,2019-12-02,1030,0,1030,82,1112,1112,0,0
45193,2019-12-02,269,0,269,21,290,290,0,0
45194,2019-12-02,752,0,752,60,812,812,0,0
45195,2019-12-02,1365,0,1365,136,1501,1501,0,0
45196,2019-12-02,918,0,918,73,991,991,0,0
45197,2019-12-02,502,0,502,40,542,542,0,0
45198,2019-12-02,612,0,612,61,673,673,0,0
45199,2019-12-02,455,0,455,36,491,491,0,0
45200,2019-12-02,1012,0,1012,80,1092,1092,0,0
45201,2019-12-02,1168,0,1168,93,1261,1261,0,0
45202,2019-12-02,835,0,835,66,901,901,0,0
45203,2019-12-02,510,0,510,40,550,550,0,0
45204,2019-12-02,773,0,773,77,850,850,0,0
45205,2019-12-02,1880,0,1880,188,2068,2068,0,0
45206,2019-12-02,1546,-1000,546,54,600,600,0,0
45207,2019-12-02,2092,0,2092,197,2289,2289,0,0
45208,2019-12-02,854,0,854,68,922,922,0,0
45209,2019-12-02,278,0,278,22,300,0,300,0
45210,2019-12-02,176,0,176,14,190,190,0,0
45211,2019-12-02,773,0,773,77,850,850,0,0
45212,2019-12-02,149,0,149,11,160,160,0,0
45213,2019-12-02,612,0,612,48,660,660,0,0
45214,2019-12-02,167,0,167,16,183,183,0,0
45215,2019-12-02,946,0,946,75,1021,1021,0,0
45216,2019-12-02,510,0,510,40,550,550,0,0
45217,2019-12-02,788,0,788,63,851,851,0,0
45218,2019-12-02,816,0,816,65,881,881,0,0
45219,2019-12-02,912,0,912,72,984,984,0,0
45220,2019-12-02,668,0,668,53,721,721,0,0
45221,2019-12-02,307,0,307,24,331,331,0,0
45222,2019-12-02,917,0,917,91,1008,1008,0,0
45223,2019-12-02,409,0,409,32,441,441,0,0
45224,2019-12-02,773,0,773,77,850,850,0,0
45225,2019-12-02,195,0,195,19,214,214,0,0
45226,2019-12-02,788,0,788,63,851,851,0,0
45227,2019-12-02,667,0,667,53,720,720,0,0
45228,2019-12-02,315,0,315,25,340,0,340,0
45229,2019-12-02,706,0,706,56,762,762,0,0
45230,2019-12-02,798,0,798,63,861,861,0,0
45231,2019-12-02,1021,0,1021,81,1102,1102,0,0
45232,2019-12-02,1741,0,1741,139,1880,1880,0,0
45233,2019-12-02,918,0,918,73,991,991,0,0
45234,2019-12-02,1546,0,1546,154,1700,1700,0,0
45235,2019-12-02,891,0,891,89,980,980,0,0
45236,2019-12-02,445,0,445,35,480,480,0,0
45237,2019-12-02,669,0,669,53,722,722,0,0
45238,2019-12-02,1067,0,1067,85,1152,1152,0,0
45239,2019-12-02,1782,0,1782,178,1960,1960,0,0
45240,2019-12-02,707,0,707,56,763,763,0,0
45241,2019-12-02,510,0,510,40,550,550,0,0
45242,2019-12-02,1076,0,1076,86,1162,1162,0,0
45243,2019-12-02,1546,0,1546,154,1700,1700,0,0
45244,2019-12-02,519,0,519,41,560,560,0,0
45245,2019-12-02,807,0,807,64,871,871,0,0
45246,2019-12-02,1130,0,1130,113,1243,1243,0,0
45247,2019-12-02,957,0,957,76,1033,1033,0,0
45248,2019-12-02,278,0,278,22,300,300,0,0
45249,2019-12-02,613,0,613,49,662,662,0,0
45250,2019-12-02,1040,0,1040,83,1123,1123,0,0
45251,2019-12-03,558,0,558,44,602,0,0,602
45252,2019-12-03,1014,-1000,14,1,15,15,0,0
45253,2019-12-03,292,0,292,23,315,315,0,0
45254,2019-12-03,538,-107,431,34,465,465,0,0
45255,2019-12-03,436,0,436,34,470,470,0,0
45256,2019-12-03,242,0,242,19,261,261,0,0
45257,2019-12-03,1158,0,1158,92,1250,1250,0,0
45258,2019-12-03,1039,0,1039,83,1122,1122,0,0
45259,2019-12-03,1996,0,1996,199,2195,2195,0,0
45260,2019-12-03,446,0,446,35,481,481,0,0
45261,2019-12-03,806,0,806,80,886,886,0,0
45262,2019-12-03,986,0,986,78,1064,1064,0,0
45263,2019-12-03,241,0,241,19,260,260,0,0
45264,2019-12-03,371,0,371,29,400,400,0,0
45265,2019-12-03,594,0,594,47,641,641,0,0
45266,2019-12-03,269,0,269,21,290,290,0,0
45267,2019-12-03,889,0,889,88,977,977,0,0
45268,2019-12-03,232,0,232,18,250,0,250,0
45269,2019-12-03,269,0,269,21,290,0,0,290
45270,2019-12-03,427,0,427,34,461,461,0,0
45271,2019-12-03,167,0,167,13,180,180,0,0
45272,2019-12-04,891,0,891,89,980,980,0,0
45273,2019-12-04,354,0,354,28,382,382,0,0
45274,2019-12-04,482,-482,0,0,0,0,0,0
45275,2019-12-04,901,0,901,72,973,973,0,0
45276,2019-12-04,788,0,788,63,851,851,0,0
45277,2019-12-04,483,0,483,38,521,521,0,0
45278,2019-12-04,621,0,621,62,683,0,683,0
45279,2019-12-04,176,0,176,14,190,190,0,0
45280,2019-12-04,901,0,901,72,973,973,0,0
45281,2019-12-04,408,0,408,32,440,0,0,440
45282,2019-12-04,761,-76,685,54,739,739,0,0
45283,2019-12-04,250,0,250,20,270,270,0,0
45284,2019-12-04,705,0,705,56,761,761,0,0
45285,2019-12-04,427,0,427,34,461,0,461,0
45286,2019-12-04,630,0,630,63,693,693,0,0
45287,2019-12-04,1047,0,1047,104,1151,1151,0,0
45288,2019-12-04,491,-49,442,44,486,486,0,0
45289,2019-12-04,139,-13,126,10,136,136,0,0
45290,2019-12-04,567,-556,11,1,12,12,0,0
45291,2019-12-04,948,0,948,75,1023,1023,0,0
45292,2019-12-04,721,0,721,72,793,0,0,793
45293,2019-12-04,891,0,891,89,980,0,0,980
45294,2019-12-04,389,0,389,38,427,0,0,427
45295,2019-12-04,510,-51,459,45,504,504,0,0
45296,2019-12-04,298,0,298,23,321,321,0,0
45297,2019-12-04,658,0,658,65,723,723,0,0
45298,2019-12-04,491,0,491,49,540,540,0,0
45299,2019-12-04,260,0,260,20,280,280,0,0
45300,2019-12-04,354,0,354,28,382,382,0,0
45301,2019-12-04,288,0,288,23,311,311,0,0
45302,2019-12-04,679,0,679,54,733,733,0,0
45303,2019-12-04,889,0,889,88,977,977,0,0
45304,2019-12-04,11575,0,11575,926,12501,12501,0,0
45305,2019-12-04,668,0,668,53,721,721,0,0
45306,2019-12-04,539,0,539,43,582,582,0,0
45307,2019-12-04,622,0,622,49,671,671,0,0
45308,2019-12-04,612,0,612,48,660,660,0,0
45309,2019-12-04,557,0,557,44,601,601,0,0
45310,2019-12-04,882,0,882,70,952,952,0,0
45311,2019-12-04,362,0,362,28,390,390,0,0
45312,2019-12-04,353,0,353,28,381,381,0,0
45313,2019-12-04,584,0,584,46,630,630,0,0
45314,2019-12-04,501,0,501,40,541,541,0,0
45315,2019-12-04,538,0,538,43,581,0,0,581
45316,2019-12-04,575,0,575,46,621,621,0,0
45317,2019-12-04,344,-34,310,24,334,334,0,0
45318,2019-12-04,474,0,474,37,511,0,511,0
45319,2019-12-04,891,-89,802,80,882,882,0,0
45320,2019-12-04,1455,0,1455,145,1600,1600,0,0
45321,2019-12-04,760,0,760,60,820,820,0,0
45322,2019-12-04,408,0,408,32,440,440,0,0
45323,2019-12-04,945,0,945,75,1020,1020,0,0
45324,2019-12-04,176,0,176,14,190,190,0,0
45325,2019-12-04,640,0,640,51,691,691,0,0
45326,2019-12-04,773,-154,619,61,680,680,0,0
45327,2019-12-04,1104,0,1104,88,1192,1192,0,0
45328,2019-12-04,491,0,491,49,540,540,0,0
45329,2019-12-04,242,0,242,19,261,261,0,0
45330,2019-12-04,1546,-1500,46,4,50,50,0,0
45331,2019-12-04,891,0,891,89,980,980,0,0
45332,2019-12-04,408,0,408,32,440,440,0,0
45333,2019-12-04,974,0,974,77,1051,1051,0,0
45334,2019-12-04,1325,0,1325,106,1431,1431,0,0
45335,2019-12-04,491,0,491,49,540,540,0,0
45336,2019-12-04,528,0,528,42,570,570,0,0
45337,2019-12-04,1141,0,1141,91,1232,0,1232,0
45338,2019-12-04,1049,0,1049,83,1132,1132,0,0
45339,2019-12-04,3092,0,3092,309,3401,0,0,3401
45340,2019-12-04,501,0,501,40,541,541,0,0
45341,2019-12-04,2115,0,2115,169,2284,0,2284,0
45342,2019-12-04,773,0,773,77,850,850,0,0
45343,2019-12-04,362,0,362,28,390,390,0,0
45344,2019-12-04,696,0,696,55,751,751,0,0
45345,2019-12-04,641,0,641,51,692,692,0,0
45346,2019-12-04,593,0,593,47,640,640,0,0
45347,2019-12-04,891,0,891,71,962,962,0,0
45348,2019-12-04,891,0,891,89,980,980,0,0
45349,2019-12-04,408,0,408,32,440,440,0,0
45350,2019-12-04,261,0,261,20,281,281,0,0
45351,2019-12-04,1457,0,1457,116,1573,1573,0,0
45352,2019-12-04,716,0,716,57,773,773,0,0
45353,2019-12-04,520,0,520,41,561,561,0,0
45354,2019-12-04,872,0,872,69,941,941,0,0
45355,2019-12-04,713,0,713,71,784,784,0,0
45356,2019-12-04,519,0,519,41,560,560,0,0
45357,2019-12-04,946,0,946,94,1040,1040,0,0
45358,2019-12-04,957,-95,862,68,930,930,0,0
45359,2019-12-04,464,0,464,37,501,501,0,0
45360,2019-12-04,1037,0,1037,103,1140,1140,0,0
45361,2019-12-04,752,0,752,60,812,812,0,0
45362,2019-12-04,1420,0,1420,113,1533,1533,0,0
45363,2019-12-04,752,0,752,60,812,812,0,0
45364,2019-12-05,455,0,455,36,491,491,0,0
45365,2019-12-05,1782,0,1782,178,1960,1960,0,0
45366,2019-12-05,891,0,891,71,962,0,962,0
45367,2019-12-05,1438,-143,1295,103,1398,0,1398,0
45368,2019-12-05,1131,0,1131,90,1221,1221,0,0
45369,2019-12-05,686,0,686,68,754,754,0,0
45370,2019-12-05,437,0,437,34,471,471,0,0
45371,2019-12-05,455,0,455,36,491,491,0,0
45372,2019-12-05,427,0,427,34,461,461,0,0
45373,2019-12-05,306,0,306,24,330,0,0,330
45374,2019-12-05,343,0,343,27,370,370,0,0
45375,2019-12-05,445,0,445,35,480,480,0,0
45376,2019-12-05,1158,0,1158,92,1250,1250,0,0
45377,2019-12-05,1652,0,1652,132,1784,1784,0,0
45378,2019-12-05,547,0,547,43,590,590,0,0
45379,2019-12-05,809,0,809,64,873,873,0,0
45380,2019-12-05,678,0,678,54,732,732,0,0
45381,2019-12-05,455,0,455,36,491,0,491,0
45382,2019-12-05,891,0,891,89,980,980,0,0
45383,2019-12-05,891,0,891,89,980,0,0,980
45384,2019-12-05,1299,-129,1170,93,1263,0,1263,0
45385,2019-12-05,363,0,363,36,399,399,0,0
45386,2019-12-05,1092,0,1092,109,1201,1201,0,0
45387,2019-12-05,705,0,705,56,761,761,0,0
45388,2019-12-05,391,0,391,31,422,422,0,0
45389,2019-12-05,965,0,965,77,1042,1042,0,0
45390,2019-12-05,363,0,363,29,392,0,0,392
45391,2019-12-05,288,0,288,23,311,311,0,0
45392,2019-12-05,232,0,232,18,250,250,0,0
45393,2019-12-05,3473,0,3473,277,3750,3750,0,0
45394,2019-12-05,567,0,567,45,612,612,0,0
45395,2019-12-05,421,0,421,33,454,454,0,0
45396,2019-12-05,1040,0,1040,83,1123,1123,0,0
45397,2019-12-05,482,0,482,38,520,520,0,0
45398,2019-12-05,343,0,343,27,370,370,0,0
45399,2019-12-05,594,0,594,47,641,641,0,0
45400,2019-12-05,139,0,139,11,150,150,0,0
45401,2019-12-05,1077,0,1077,86,1163,0,1163,0
45402,2019-12-05,297,0,297,23,320,320,0,0
45403,2019-12-05,483,0,483,38,521,521,0,0
45404,2019-12-05,345,0,345,27,372,372,0,0
45405,2019-12-05,335,0,335,26,361,361,0,0
45406,2019-12-05,478,0,478,38,516,516,0,0
45407,2019-12-05,715,0,715,57,772,772,0,0
45408,2019-12-05,445,0,445,35,480,480,0,0
45409,2019-12-05,873,0,873,69,942,942,0,0
45410,2019-12-05,473,0,473,37,510,510,0,0
45411,2019-12-05,343,0,343,27,370,370,0,0
45412,2019-12-05,418,0,418,33,451,451,0,0
45413,2019-12-05,975,0,975,78,1053,0,0,1053
45414,2019-12-05,491,0,491,49,540,540,0,0
45415,2019-12-05,1096,0,1096,87,1183,0,1183,0
45416,2019-12-05,373,0,373,29,402,402,0,0
45417,2019-12-05,603,0,603,48,651,651,0,0
45418,2019-12-05,353,0,353,28,381,381,0,0
45419,2019-12-05,543,-54,489,39,528,528,0,0
45420,2019-12-05,261,0,261,20,281,281,0,0
45421,2019-12-05,1162,0,1162,92,1254,0,0,1254
45422,2019-12-05,891,0,891,89,980,980,0,0
45423,2019-12-05,1074,0,1074,107,1181,1181,0,0
45424,2019-12-05,297,0,297,23,320,320,0,0
45425,2019-12-05,1733,0,1733,173,1906,1906,0,0
45426,2019-12-05,1390,0,1390,139,1529,1529,0,0
45427,2019-12-05,584,0,584,46,630,630,0,0
45428,2019-12-05,426,0,426,34,460,460,0,0
45429,2019-12-05,297,0,297,23,320,320,0,0
45430,2019-12-05,436,0,436,34,470,470,0,0
45431,2019-12-05,3064,0,3064,245,3309,3309,0,0
45432,2019-12-05,343,0,343,27,370,370,0,0
45433,2019-12-05,811,0,811,64,875,875,0,0
45434,2019-12-05,1417,0,1417,141,1558,1558,0,0
45435,2019-12-05,260,0,260,20,280,280,0,0
45436,2019-12-05,797,0,797,63,860,860,0,0
45437,2019-12-05,1562,0,1562,156,1718,1718,0,0
45438,2019-12-05,909,0,909,90,999,999,0,0
45439,2019-12-05,594,0,594,47,641,641,0,0
45440,2019-12-05,408,0,408,32,440,0,0,440
45441,2019-12-05,1085,0,1085,86,1171,1171,0,0
45442,2019-12-05,853,0,853,68,921,921,0,0
45443,2019-12-05,472,0,472,47,519,519,0,0
45444,2019-12-05,279,0,279,22,301,301,0,0
45445,2019-12-05,1407,0,1407,140,1547,1547,0,0
45446,2019-12-05,1380,0,1380,138,1518,1518,0,0
45447,2019-12-05,392,0,392,31,423,423,0,0
45448,2019-12-05,439,0,439,35,474,474,0,0
45449,2019-12-05,149,0,149,11,160,160,0,0
45450,2019-12-05,399,0,399,31,430,430,0,0
45451,2019-12-05,659,0,659,52,711,711,0,0
45452,2019-12-05,436,0,436,34,470,0,470,0
45453,2019-12-05,297,0,297,23,320,320,0,0
45454,2019-12-05,918,0,918,73,991,991,0,0
45455,2019-12-05,771,0,771,61,832,832,0,0
45456,2019-12-05,1002,0,1002,80,1082,1082,0,0
45457,2019-12-05,204,0,204,16,220,220,0,0
45458,2019-12-05,929,0,929,74,1003,0,0,1003
45459,2019-12-05,250,0,250,20,270,270,0,0
45460,2019-12-05,550,0,550,44,594,594,0,0
45461,2019-12-05,557,0,557,44,601,0,0,601
45462,2019-12-05,798,0,798,63,861,861,0,0
45463,2019-12-05,176,0,176,14,190,190,0,0
45464,2019-12-05,325,0,325,26,351,351,0,0
45465,2019-12-05,1180,0,1180,94,1274,1274,0,0
45466,2019-12-05,206,0,206,16,222,222,0,0
45467,2019-12-05,809,0,809,64,873,873,0,0
45468,2019-12-05,436,0,436,34,470,470,0,0
45469,2019-12-05,353,0,353,28,381,381,0,0
45470,2019-12-05,519,0,519,41,560,560,0,0
45471,2019-12-05,880,0,880,70,950,950,0,0
45472,2019-12-05,510,0,510,40,550,550,0,0
45473,2019-12-05,250,0,250,20,270,270,0,0
45474,2019-12-05,473,0,473,37,510,510,0,0
45475,2019-12-05,1233,0,1233,98,1331,1331,0,0
45476,2019-12-05,691,0,691,55,746,746,0,0
45477,2019-12-05,807,0,807,64,871,871,0,0
45478,2019-12-05,918,0,918,73,991,991,0,0
45479,2019-12-05,926,0,926,92,1018,1018,0,0
45480,2019-12-05,773,0,773,77,850,0,850,0
45481,2019-12-05,891,0,891,89,980,980,0,0
45482,2019-12-05,825,0,825,66,891,891,0,0
45483,2019-12-05,278,0,278,27,305,305,0,0
45484,2019-12-05,1104,0,1104,88,1192,1192,0,0
45485,2019-12-05,370,0,370,37,407,407,0,0
45486,2019-12-05,1317,0,1317,105,1422,1422,0,0
45487,2019-12-05,370,0,370,37,407,407,0,0
45488,2019-12-06,1086,0,1086,86,1172,1172,0,0
45489,2019-12-06,389,0,389,31,420,420,0,0
45490,2019-12-06,529,0,529,42,571,571,0,0
45491,2019-12-06,3564,0,3564,356,3920,0,3920,0
45492,2019-12-06,1878,0,1878,187,2065,0,2065,0
45493,2019-12-06,269,0,269,21,290,290,0,0
45494,2019-12-06,1402,0,1402,112,1514,1514,0,0
45495,2019-12-06,483,0,483,38,521,521,0,0
45496,2019-12-06,576,0,576,46,622,622,0,0
45497,2019-12-06,1695,0,1695,169,1864,0,1864,0
45498,2019-12-06,521,0,521,41,562,562,0,0
45499,2019-12-06,641,0,641,51,692,692,0,0
45500,2019-12-06,1029,0,1029,82,1111,1111,0,0
45501,2019-12-06,2673,0,2673,267,2940,2940,0,0
45502,2019-12-06,631,0,631,50,681,681,0,0
45503,2019-12-06,307,0,307,24,331,331,0,0
45504,2019-12-06,445,0,445,44,489,489,0,0
45505,2019-12-06,1216,0,1216,97,1313,1313,0,0
45506,2019-12-06,492,0,492,39,531,0,531,0
45507,2019-12-06,891,0,891,89,980,980,0,0
45508,2019-12-06,705,0,705,70,775,775,0,0
45509,2019-12-06,891,0,891,89,980,980,0,0
45510,2019-12-06,233,0,233,18,251,251,0,0
45511,2019-12-06,1273,0,1273,127,1400,0,1400,0
45512,2019-12-06,1782,0,1782,178,1960,1960,0,0
45513,2019-12-06,241,0,241,19,260,0,0,260
45514,2019-12-06,1354,0,1354,108,1462,1462,0,0
45515,2019-12-06,2317,0,2317,185,2502,2502,0,0
45516,2019-12-06,1430,0,1430,114,1544,1544,0,0
45517,2019-12-06,1131,0,1131,113,1244,1244,0,0
45518,2019-12-06,984,0,984,78,1062,1062,0,0
45519,2019-12-06,641,0,641,51,692,692,0,0
45520,2019-12-06,1986,0,1986,198,2184,2184,0,0
45521,2019-12-06,891,0,891,89,980,980,0,0
45522,2019-12-06,502,0,502,40,542,542,0,0
45523,2019-12-06,1782,0,1782,178,1960,1960,0,0
45524,2019-12-06,370,0,370,37,407,407,0,0
45525,2019-12-06,483,0,483,38,521,521,0,0
45526,2019-12-06,474,0,474,37,511,0,511,0
45527,2019-12-06,612,0,612,48,660,660,0,0
45528,2019-12-06,528,0,528,42,570,570,0,0
45529,2019-12-06,1075,0,1075,86,1161,1161,0,0
45530,2019-12-06,519,0,519,51,570,570,0,0
45531,2019-12-06,1027,0,1027,102,1129,1129,0,0
45532,2019-12-06,594,0,594,47,641,641,0,0
45533,2019-12-06,1289,0,1289,103,1392,1392,0,0
45534,2019-12-06,714,0,714,57,771,771,0,0
45535,2019-12-06,530,0,530,42,572,572,0,0
45536,2019-12-06,827,0,827,66,893,893,0,0
45537,2019-12-06,297,0,297,23,320,320,0,0
45538,2019-12-06,844,0,844,84,928,928,0,0
45539,2019-12-06,1101,0,1101,110,1211,1211,0,0
45540,2019-12-06,546,0,546,54,600,600,0,0
45541,2019-12-06,-546,0,-546,-54,-600,-600,0,0
45542,2019-12-06,985,0,985,78,1063,1063,0,0
45543,2019-12-06,352,0,352,35,387,387,0,0
45544,2019-12-06,455,0,455,36,491,491,0,0
45545,2019-12-06,251,0,251,20,271,271,0,0
45546,2019-12-06,622,0,622,49,671,671,0,0
45547,2019-12-06,186,0,186,14,200,0,0,200
45548,2019-12-06,418,-41,377,30,407,407,0,0
45549,2019-12-06,139,0,139,11,150,150,0,0
45550,2019-12-06,511,0,511,40,551,551,0,0
45551,2019-12-06,2560,0,2560,256,2816,2816,0,0
45552,2019-12-06,2673,0,2673,267,2940,0,2940,0
45553,2019-12-06,1003,0,1003,80,1083,1083,0,0
45554,2019-12-06,668,-66,602,48,650,0,650,0
45555,2019-12-06,12964,0,12964,1037,14001,14001,0,0
45556,2019-12-06,1901,0,1901,190,2091,0,2091,0
45557,2019-12-06,288,0,288,23,311,311,0,0
45558,2019-12-06,102,0,102,8,110,110,0,0
45559,2019-12-06,3028,0,3028,302,3330,3330,0,0
45560,2019-12-06,139,0,139,11,150,0,0,150
45561,2019-12-06,288,0,288,23,311,311,0,0
45562,2019-12-06,1278,0,1278,127,1405,1405,0,0
45563,2019-12-06,667,0,667,66,733,0,0,733
45564,2019-12-06,658,0,658,65,723,723,0,0
45565,2019-12-06,1539,0,1539,123,1662,1662,0,0
45566,2019-12-06,297,0,297,29,326,0,0,326
45567,2019-12-06,520,0,520,41,561,561,0,0
45568,2019-12-06,752,0,752,60,812,812,0,0
45569,2019-12-06,2673,0,2673,267,2940,2940,0,0
45570,2019-12-06,872,0,872,69,941,941,0,0
45571,2019-12-06,1030,0,1030,82,1112,1112,0,0
45572,2019-12-06,773,0,773,77,850,850,0,0
45573,2019-12-06,1046,0,1046,104,1150,1150,0,0
45574,2019-12-06,773,0,773,77,850,850,0,0
45575,2019-12-06,773,0,773,77,850,850,0,0
45576,2019-12-06,773,0,773,77,850,850,0,0
45577,2019-12-06,408,-81,327,26,353,353,0,0
45578,2019-12-06,1546,0,1546,154,1700,1700,0,0
45579,2019-12-06,1106,0,1106,88,1194,0,1194,0
45580,2019-12-06,807,-80,727,58,785,785,0,0
45581,2019-12-06,773,0,773,77,850,850,0,0
45582,2019-12-06,1546,0,1546,154,1700,0,0,1700
45583,2019-12-06,628,0,628,62,690,0,690,0
45584,2019-12-06,1426,0,1426,142,1568,1568,0,0
45585,2019-12-06,473,0,473,37,510,510,0,0
45586,2019-12-06,1546,0,1546,154,1700,0,1700,0
45587,2019-12-06,399,0,399,31,430,430,0,0
45588,2019-12-06,269,0,269,21,290,290,0,0
45589,2019-12-06,1165,0,1165,116,1281,1281,0,0
45590,2019-12-06,687,0,687,54,741,741,0,0
45591,2019-12-06,260,0,260,20,280,280,0,0
45592,2019-12-06,2170,0,2170,173,2343,2343,0,0
45593,2019-12-06,1360,0,1360,108,1468,1468,0,0
45594,2019-12-06,315,0,315,25,340,340,0,0
45595,2019-12-06,834,0,834,83,917,917,0,0
45596,2019-12-06,575,0,575,46,621,621,0,0
45597,2019-12-06,389,0,389,38,427,427,0,0
45598,2019-12-06,352,0,352,35,387,387,0,0
45599,2019-12-06,705,0,705,70,775,775,0,0
45600,2019-12-06,447,0,447,35,482,0,0,482
45601,2019-12-06,1242,0,1242,124,1366,1366,0,0
45602,2019-12-06,1202,0,1202,96,1298,0,0,1298
45603,2019-12-06,740,0,740,74,814,814,0,0
45604,2019-12-06,594,0,594,47,641,641,0,0
45605,2019-12-06,640,0,640,51,691,691,0,0
45606,2019-12-06,269,0,269,21,290,290,0,0
45607,2019-12-06,243,0,243,19,262,262,0,0
45608,2019-12-06,345,0,345,27,372,372,0,0
45609,2019-12-06,260,0,260,20,280,280,0,0
45610,2019-12-06,1890,0,1890,189,2079,0,2079,0
45611,2019-12-06,2341,0,2341,234,2575,2575,0,0
45612,2019-12-06,362,0,362,28,390,390,0,0
45613,2019-12-06,1095,0,1095,87,1182,1182,0,0
45614,2019-12-06,659,0,659,52,711,711,0,0
45615,2019-12-06,1623,0,1623,129,1752,1752,0,0
45616,2019-12-06,491,0,491,39,530,530,0,0
45617,2019-12-06,891,0,891,89,980,980,0,0
45618,2019-12-06,891,-89,802,80,882,882,0,0
45619,2019-12-06,-891,0,-891,-89,-980,-980,0,0
45620,2019-12-06,631,0,631,50,681,0,681,0
45621,2019-12-06,1158,0,1158,92,1250,1250,0,0
45622,2019-12-06,427,0,427,34,461,461,0,0
45623,2019-12-06,306,0,306,24,330,330,0,0
45624,2019-12-06,780,0,780,62,842,842,0,0
45625,2019-12-06,2673,0,2673,267,2940,2940,0,0
45626,2019-12-06,273,0,273,27,300,0,0,300
45627,2019-12-06,269,0,269,21,290,290,0,0
45628,2019-12-06,937,0,937,74,1011,1011,0,0
45629,2019-12-06,1546,0,1546,154,1700,1700,0,0
45630,2019-12-06,465,0,465,37,502,0,502,0
45631,2019-12-06,2319,0,2319,231,2550,2550,0,0
45632,2019-12-06,1957,0,1957,156,2113,2113,0,0
45633,2019-12-06,269,0,269,21,290,290,0,0
45634,2019-12-06,705,0,705,56,761,761,0,0
45635,2019-12-06,892,0,892,71,963,963,0,0
45636,2019-12-06,773,0,773,77,850,0,0,850
45637,2019-12-06,1464,0,1464,146,1610,1610,0,0
45638,2019-12-06,1436,0,1436,143,1579,1579,0,0
45639,2019-12-06,2319,0,2319,231,2550,2550,0,0
45640,2019-12-06,2319,-231,2088,208,2296,0,2296,0
45641,2019-12-06,668,0,668,53,721,0,0,721
45642,2019-12-06,297,0,297,23,320,0,320,0
45643,2019-12-06,2093,0,2093,209,2302,2302,0,0
45644,2019-12-06,1243,0,1243,99,1342,1342,0,0
45645,2019-12-06,167,0,167,16,183,183,0,0
45646,2019-12-06,426,0,426,42,468,468,0,0
45647,2019-12-06,1546,0,1546,154,1700,1700,0,0
45648,2019-12-06,697,0,697,55,752,752,0,0
45649,2019-12-06,704,0,704,56,760,760,0,0
45650,2019-12-07,2243,0,2243,197,2440,0,2440,0
45651,2019-12-07,1067,0,1067,85,1152,0,0,1152
45652,2019-12-07,1782,0,1782,178,1960,1960,0,0
45653,2019-12-07,1347,0,1347,107,1454,1454,0,0
45654,2019-12-07,575,0,575,46,621,621,0,0
45655,2019-12-07,417,0,417,33,450,450,0,0
45656,2019-12-07,678,0,678,54,732,732,0,0
45657,2019-12-07,1188,0,1188,118,1306,1306,0,0
45658,2019-12-07,1150,0,1150,92,1242,0,1242,0
45659,2019-12-07,1256,0,1256,125,1381,1381,0,0
45660,2019-12-07,-1782,0,-1782,-178,-1960,-1960,0,0
45661,2019-12-07,1215,0,1215,97,1312,1312,0,0
45662,2019-12-07,1115,0,1115,89,1204,1204,0,0
45663,2019-12-07,1932,0,1932,154,2086,0,2086,0
45664,2019-12-07,316,0,316,25,341,0,0,341
45665,2019-12-07,-316,0,-316,-25,-341,0,0,-341
45666,2019-12-07,482,-48,434,34,468,0,468,0
45667,2019-12-07,316,-31,285,22,307,0,0,307
45668,2019-12-07,3798,0,3798,379,4177,4177,0,0
45669,2019-12-07,251,0,251,20,271,271,0,0
45670,2019-12-07,501,0,501,40,541,541,0,0
45671,2019-12-07,482,0,482,38,520,520,0,0
45672,2019-12-07,1225,0,1225,98,1323,1323,0,0
45673,2019-12-07,1104,0,1104,110,1214,1214,0,0
45674,2019-12-07,891,0,891,89,980,980,0,0
45675,2019-12-07,418,0,418,33,451,0,451,0
45676,2019-12-07,668,0,668,66,734,734,0,0
45677,2019-12-07,881,0,881,70,951,951,0,0
45678,2019-12-07,1782,0,1782,178,1960,0,1960,0
45679,2019-12-07,846,0,846,67,913,913,0,0
45680,2019-12-07,1495,0,1495,119,1614,1614,0,0
45681,2019-12-07,343,-34,309,24,333,333,0,0
45682,2019-12-07,232,0,232,18,250,250,0,0
45683,2019-12-07,1596,0,1596,127,1723,1723,0,0
45684,2019-12-07,401,0,401,32,433,0,433,0
45685,2019-12-07,261,-26,235,18,253,0,253,0
45686,2019-12-07,1782,0,1782,178,1960,1960,0,0
45687,2019-12-07,1306,0,1306,130,1436,0,1436,0
45688,2019-12-07,-1306,0,-1306,-130,-1436,0,-1436,0
45689,2019-12-07,1306,-130,1176,117,1293,0,1293,0
45690,2019-12-07,1112,0,1112,88,1200,1200,0,0
45691,2019-12-07,2077,0,2077,166,2243,2243,0,0
45692,2019-12-07,1225,0,1225,98,1323,0,1323,0
45693,2019-12-07,891,0,891,89,980,980,0,0
45694,2019-12-07,891,0,891,89,980,980,0,0
45695,2019-12-07,1782,0,1782,178,1960,1960,0,0
45696,2019-12-07,325,0,325,26,351,351,0,0
45697,2019-12-07,251,0,251,20,271,0,0,271
45698,2019-12-07,418,0,418,33,451,451,0,0
45699,2019-12-07,399,0,399,39,438,438,0,0
45700,2019-12-07,260,0,260,20,280,280,0,0
45701,2019-12-07,641,0,641,51,692,0,692,0
45702,2019-12-07,861,0,861,86,947,947,0,0
45703,2019-12-07,298,0,298,23,321,321,0,0
45704,2019-12-07,334,0,334,26,360,0,0,360
45705,2019-12-07,740,0,740,59,799,799,0,0
45706,2019-12-07,769,0,769,76,845,845,0,0
45707,2019-12-07,1074,0,1074,107,1181,0,1181,0
45708,2019-12-07,298,0,298,23,321,0,0,321
45709,2019-12-07,2401,0,2401,240,2641,0,2641,0
45710,2019-12-07,1364,0,1364,109,1473,0,1473,0
45711,2019-12-07,835,0,835,66,901,901,0,0
45712,2019-12-07,139,0,139,11,150,150,0,0
45713,2019-12-07,297,0,297,23,320,320,0,0
45714,2019-12-07,1011,0,1011,80,1091,1091,0,0
45715,2019-12-07,594,0,594,47,641,641,0,0
45716,2019-12-07,538,0,538,43,581,581,0,0
45717,2019-12-07,186,0,186,14,200,200,0,0
45718,2019-12-07,176,0,176,14,190,190,0,0
45719,2019-12-07,269,0,269,21,290,0,0,290
45720,2019-12-07,1677,0,1677,167,1844,1844,0,0
45721,2019-12-07,668,0,668,53,721,721,0,0
45722,2019-12-07,343,0,343,27,370,0,0,370
45723,2019-12-07,464,0,464,37,501,501,0,0
45724,2019-12-07,1782,0,1782,178,1960,1960,0,0
45725,2019-12-07,205,0,205,16,221,221,0,0
45726,2019-12-07,260,0,260,20,280,280,0,0
45727,2019-12-07,2673,0,2673,267,2940,0,2940,0
45728,2019-12-07,325,0,325,32,357,357,0,0
45729,2019-12-07,1566,0,1566,156,1722,1722,0,0
45730,2019-12-07,2010,0,2010,201,2211,2211,0,0
45731,2019-12-07,149,0,149,11,160,0,0,160
45732,2019-12-07,260,0,260,20,280,280,0,0
45733,2019-12-07,47,0,47,3,50,50,0,0
45734,2019-12-07,1716,0,1716,171,1887,0,1887,0
45735,2019-12-07,548,0,548,54,602,602,0,0
45736,2019-12-07,232,0,232,18,250,250,0,0
45737,2019-12-07,891,0,891,71,962,962,0,0
45738,2019-12-07,668,0,668,53,721,721,0,0
45739,2019-12-07,408,0,408,32,440,440,0,0
45740,2019-12-07,660,0,660,66,726,0,0,726
45741,2019-12-07,389,0,389,38,427,0,0,427
45742,2019-12-07,742,0,742,59,801,801,0,0
45743,2019-12-07,381,0,381,30,411,411,0,0
45744,2019-12-07,520,0,520,41,561,561,0,0
45745,2019-12-07,315,0,315,25,340,340,0,0
45746,2019-12-07,2067,0,2067,165,2232,2232,0,0
45747,2019-12-07,270,0,270,21,291,291,0,0
45748,2019-12-07,311,-31,280,22,302,302,0,0
45749,2019-12-07,689,0,689,55,744,744,0,0
45750,2019-12-07,437,0,437,34,471,471,0,0
45751,2019-12-07,204,0,204,20,224,224,0,0
45752,2019-12-07,1913,0,1913,153,2066,2066,0,0
45753,2019-12-07,-1546,0,-1546,-154,-1700,-1700,0,0
45754,2019-12-07,585,0,585,46,631,631,0,0
45755,2019-12-07,945,0,945,94,1039,1039,0,0
45756,2019-12-07,241,0,241,24,265,265,0,0
45757,2019-12-07,269,0,269,21,290,290,0,0
45758,2019-12-07,1599,0,1599,159,1758,1758,0,0
45759,2019-12-07,1671,-334,1337,106,1443,0,1443,0
45760,2019-12-07,269,0,269,21,290,290,0,0
45761,2019-12-07,408,0,408,32,440,440,0,0
45762,2019-12-07,242,0,242,19,261,261,0,0
45763,2019-12-07,112,0,112,8,120,120,0,0
45764,2019-12-07,1546,0,1546,154,1700,1700,0,0
45765,2019-12-07,797,0,797,79,876,876,0,0
45766,2019-12-07,1546,0,1546,154,1700,1700,0,0
45767,2019-12-07,1546,0,1546,154,1700,0,0,1700
45768,2019-12-07,1546,0,1546,154,1700,1700,0,0
45769,2019-12-07,1287,0,1287,128,1415,1415,0,0
45770,2019-12-07,315,0,315,25,340,340,0,0
45771,2019-12-07,1546,0,1546,154,1700,1700,0,0
45772,2019-12-07,773,0,773,77,850,850,0,0
45773,2019-12-07,773,0,773,77,850,0,0,850
45774,2019-12-07,181,0,181,14,195,195,0,0
45775,2019-12-07,557,0,557,44,601,601,0,0
45776,2019-12-07,2319,0,2319,231,2550,0,2550,0
45777,2019-12-07,1546,0,1546,154,1700,1700,0,0
45778,2019-12-07,1826,0,1826,182,2008,2008,0,0
45779,2019-12-07,912,0,912,72,984,0,0,984
45780,2019-12-07,613,0,613,49,662,0,662,0
45781,2019-12-07,278,0,278,22,300,300,0,0
45782,2019-12-07,399,0,399,31,430,0,0,430
45783,2019-12-07,520,0,520,41,561,561,0,0
45784,2019-12-07,436,0,436,34,470,470,0,0
45785,2019-12-07,861,0,861,86,947,947,0,0
45786,2019-12-07,334,0,334,33,367,367,0,0
45787,2019-12-07,389,0,389,38,427,427,0,0
45788,2019-12-07,1058,0,1058,84,1142,1142,0,0
45789,2019-12-07,1521,0,1521,152,1673,1673,0,0
45790,2019-12-07,419,0,419,33,452,452,0,0
45791,2019-12-07,773,0,773,61,834,834,0,0
45792,2019-12-07,983,0,983,78,1061,0,1061,0
45793,2019-12-07,1438,0,1438,143,1581,1581,0,0
45794,2019-12-07,798,-79,719,57,776,776,0,0
45795,2019-12-07,362,0,362,28,390,390,0,0
45796,2019-12-07,317,0,317,25,342,342,0,0
45797,2019-12-07,742,0,742,59,801,801,0,0
45798,2019-12-07,399,0,399,39,438,438,0,0
45799,2019-12-07,519,0,519,51,570,570,0,0
45800,2019-12-07,335,0,335,26,361,0,0,361
45801,2019-12-07,205,0,205,16,221,0,221,0
45802,2019-12-07,491,0,491,49,540,0,540,0
45803,2019-12-07,279,0,279,22,301,301,0,0
45804,2019-12-07,935,0,935,74,1009,1009,0,0
45805,2019-12-07,362,0,362,28,390,0,390,0
45806,2019-12-07,195,0,195,15,210,210,0,0
45807,2019-12-07,2444,0,2444,244,2688,0,2688,0
45808,2019-12-07,705,0,705,56,761,761,0,0
45809,2019-12-07,1546,0,1546,154,1700,1700,0,0
45810,2019-12-07,464,0,464,37,501,501,0,0
45811,2019-12-07,483,0,483,38,521,521,0,0
45812,2019-12-07,2272,0,2272,181,2453,0,2453,0
45813,2019-12-07,343,0,343,27,370,370,0,0
45814,2019-12-07,556,0,556,44,600,600,0,0
45815,2019-12-07,729,0,729,58,787,787,0,0
45816,2019-12-07,773,0,773,77,850,850,0,0
45817,2019-12-07,909,0,909,72,981,981,0,0
45818,2019-12-07,1546,0,1546,154,1700,1700,0,0
45819,2019-12-07,306,0,306,24,330,330,0,0
45820,2019-12-07,1002,0,1002,80,1082,1082,0,0
45821,2019-12-07,446,0,446,44,490,0,0,490
45822,2019-12-07,269,0,269,21,290,290,0,0
45823,2019-12-07,650,0,650,52,702,702,0,0
45824,2019-12-07,1920,-192,1728,138,1866,0,1866,0
45825,2019-12-07,1546,0,1546,154,1700,1700,0,0
45826,2019-12-07,1133,0,1133,90,1223,1223,0,0
45827,2019-12-07,1123,0,1123,89,1212,0,1212,0
45828,2019-12-07,510,0,510,40,550,0,550,0
45829,2019-12-07,1546,0,1546,154,1700,1700,0,0
45830,2019-12-07,773,0,773,77,850,850,0,0
45831,2019-12-07,3092,0,3092,309,3401,3401,0,0
45832,2019-12-07,218,0,218,17,235,235,0,0
45833,2019-12-07,773,0,773,77,850,850,0,0
45834,2019-12-07,278,0,278,22,300,300,0,0
45835,2019-12-07,612,0,612,48,660,0,0,660
45836,2019-12-07,773,0,773,77,850,0,0,850
45837,2019-12-07,491,0,491,39,530,530,0,0
45838,2019-12-07,1546,0,1546,154,1700,0,1700,0
45839,2019-12-07,825,0,825,66,891,891,0,0
45840,2019-12-07,773,0,773,77,850,0,0,850
45841,2019-12-07,1546,0,1546,154,1700,1700,0,0
45842,2019-12-07,454,0,454,36,490,490,0,0
45843,2019-12-07,139,0,139,11,150,150,0,0
45844,2019-12-07,1546,0,1546,154,1700,1700,0,0
45845,2019-12-07,594,0,594,59,653,653,0,0
45846,2019-12-07,1039,0,1039,83,1122,0,1122,0
45847,2019-12-07,1039,0,1039,83,1122,0,1122,0
45848,2019-12-07,353,0,353,28,381,0,0,381
45849,2019-12-07,1170,0,1170,93,1263,1263,0,0
45850,2019-12-07,417,0,417,41,458,458,0,0
45851,2019-12-07,2319,-231,2088,208,2296,2296,0,0
45852,2019-12-07,773,0,773,77,850,850,0,0
45853,2019-12-07,400,0,400,32,432,432,0,0
45854,2019-12-07,260,0,260,20,280,0,0,280
45855,2019-12-07,232,0,232,18,250,250,0,0
45856,2019-12-07,3092,0,3092,309,3401,3401,0,0
45857,2019-12-08,628,0,628,62,690,690,0,0
45858,2019-12-08,-556,0,-556,-55,-611,-611,0,0
45859,2019-12-08,1782,0,1782,178,1960,1960,0,0
45860,2019-12-08,306,0,306,30,336,336,0,0
45861,2019-12-08,556,-500,56,5,61,61,0,0
45862,2019-12-08,436,0,436,34,470,470,0,0
45863,2019-12-08,269,0,269,21,290,290,0,0
45864,2019-12-08,891,0,891,89,980,980,0,0
45865,2019-12-08,464,0,464,37,501,501,0,0
45866,2019-12-08,455,0,455,45,500,500,0,0
45867,2019-12-08,910,0,910,91,1001,1001,0,0
45868,2019-12-08,745,0,745,59,804,804,0,0
45869,2019-12-08,501,0,501,40,541,0,0,541
45870,2019-12-08,667,0,667,66,733,733,0,0
45871,2019-12-08,891,0,891,89,980,0,980,0
45872,2019-12-08,891,0,891,89,980,980,0,0
45873,2019-12-08,890,0,890,71,961,961,0,0
45874,2019-12-08,556,0,556,55,611,611,0,0
45875,2019-12-08,1039,0,1039,83,1122,1122,0,0
45876,2019-12-08,548,0,548,43,591,591,0,0
45877,2019-12-08,269,0,269,21,290,290,0,0
45878,2019-12-08,1364,0,1364,109,1473,1473,0,0
45879,2019-12-08,957,0,957,76,1033,1033,0,0
45880,2019-12-08,428,0,428,34,462,0,462,0
45881,2019-12-08,891,0,891,89,980,980,0,0
45882,2019-12-08,520,0,520,41,561,561,0,0
45883,2019-12-08,761,0,761,60,821,821,0,0
45884,2019-12-08,686,0,686,54,740,740,0,0
45885,2019-12-08,483,-48,435,34,469,469,0,0
45886,2019-12-08,1305,0,1305,130,1435,1435,0,0
45887,2019-12-08,1305,0,1305,130,1435,0,1435,0
45888,2019-12-08,603,0,603,48,651,651,0,0
45889,2019-12-08,93,0,93,7,100,0,0,100
45890,2019-12-08,521,0,521,41,562,562,0,0
45891,2019-12-08,603,0,603,48,651,651,0,0
45892,2019-12-08,556,0,556,55,611,611,0,0
45893,2019-12-08,260,0,260,20,280,280,0,0
45894,2019-12-08,668,0,668,53,721,721,0,0
45895,2019-12-08,761,-76,685,54,739,0,739,0
45896,2019-12-08,1168,0,1168,116,1284,1284,0,0
45897,2019-12-08,343,0,343,27,370,370,0,0
45898,2019-12-08,529,0,529,42,571,0,571,0
45899,2019-12-08,854,0,854,68,922,0,922,0
45900,2019-12-08,224,0,224,17,241,241,0,0
45901,2019-12-08,760,0,760,76,836,836,0,0
45902,2019-12-08,761,0,761,60,821,821,0,0
45903,2019-12-08,1439,-143,1296,103,1399,1399,0,0
45904,2019-12-08,891,0,891,89,980,0,980,0
45905,2019-12-08,945,0,945,94,1039,1039,0,0
45906,2019-12-08,390,0,390,31,421,421,0,0
45907,2019-12-08,427,0,427,34,461,461,0,0
45908,2019-12-08,891,0,891,89,980,980,0,0
45909,2019-12-08,519,0,519,41,560,560,0,0
45910,2019-12-08,603,0,603,60,663,663,0,0
45911,2019-12-08,510,0,510,40,550,550,0,0
45912,2019-12-08,1039,0,1039,83,1122,0,0,1122
45913,2019-12-08,790,0,790,63,853,853,0,0
45914,2019-12-08,585,0,585,46,631,631,0,0
45915,2019-12-08,863,0,863,69,932,932,0,0
45916,2019-12-08,343,0,343,27,370,0,0,370
45917,2019-12-08,298,0,298,23,321,0,0,321
45918,2019-12-08,168,0,168,13,181,181,0,0
45919,2019-12-08,835,0,835,66,901,0,901,0
45920,2019-12-08,1578,0,1578,126,1704,0,0,1704
45921,2019-12-08,705,0,705,70,775,775,0,0
45922,2019-12-08,1412,0,1412,112,1524,0,1524,0
45923,2019-12-08,733,0,733,58,791,791,0,0
45924,2019-12-08,567,0,567,45,612,612,0,0
45925,2019-12-08,900,0,900,72,972,972,0,0
45926,2019-12-08,232,0,232,18,250,250,0,0
45927,2019-12-08,1648,0,1648,164,1812,1812,0,0
45928,2019-12-08,972,0,972,97,1069,1069,0,0
45929,2019-12-08,491,0,491,39,530,530,0,0
45930,2019-12-08,269,0,269,21,290,290,0,0
45931,2019-12-08,167,0,167,13,180,180,0,0
45932,2019-12-08,260,0,260,20,280,280,0,0
45933,2019-12-08,982,0,982,98,1080,1080,0,0
45934,2019-12-08,181,0,181,14,195,195,0,0
45935,2019-12-08,465,0,465,37,502,502,0,0
45936,2019-12-08,773,0,773,77,850,850,0,0
45937,2019-12-08,316,0,316,25,341,0,0,341
45938,2019-12-08,773,0,773,77,850,850,0,0
45939,2019-12-08,93,0,93,7,100,100,0,0
45940,2019-12-08,306,0,306,24,330,330,0,0
45941,2019-12-08,446,0,446,35,481,481,0,0
45942,2019-12-08,1059,0,1059,84,1143,1143,0,0
45943,2019-12-08,2281,0,2281,228,2509,2509,0,0
45944,2019-12-08,408,0,408,32,440,440,0,0
45945,2019-12-08,269,0,269,21,290,290,0,0
45946,2019-12-08,343,-34,309,24,333,333,0,0
45947,2019-12-08,807,0,807,64,871,871,0,0
45948,2019-12-08,640,0,640,64,704,704,0,0
45949,2019-12-08,937,0,937,93,1030,0,1030,0
45950,2019-12-08,389,0,389,31,420,420,0,0
45951,2019-12-08,269,0,269,21,290,0,0,290
45952,2019-12-08,881,0,881,88,969,969,0,0
45953,2019-12-08,362,0,362,28,390,390,0,0
45954,2019-12-08,141,0,141,11,152,152,0,0
45955,2019-12-08,872,0,872,69,941,941,0,0
45956,2019-12-08,399,0,399,39,438,438,0,0
45957,2019-12-08,297,0,297,23,320,320,0,0
45958,2019-12-08,325,0,325,26,351,351,0,0
45959,2019-12-08,2798,0,2798,223,3021,3021,0,0
45960,2019-12-08,409,0,409,32,441,441,0,0
45961,2019-12-08,47,0,47,4,51,51,0,0
45962,2019-12-08,1546,0,1546,154,1700,1700,0,0
45963,2019-12-08,650,0,650,52,702,0,702,0
45964,2019-12-08,1087,0,1087,86,1173,0,1173,0
45965,2019-12-08,188,0,188,15,203,203,0,0
45966,2019-12-08,445,0,445,44,489,489,0,0
45967,2019-12-08,994,0,994,79,1073,1073,0,0
45968,2019-12-08,-445,0,-445,-44,-489,-489,0,0
45969,2019-12-08,1076,0,1076,86,1162,1162,0,0
45970,2019-12-08,381,0,381,30,411,411,0,0
45971,2019-12-08,-381,0,-381,-30,-411,-411,0,0
45972,2019-12-08,381,0,381,38,419,419,0,0
45973,2019-12-08,1142,0,1142,91,1233,1233,0,0
45974,2019-12-08,916,0,916,91,1007,1007,0,0
45975,2019-12-08,919,0,919,73,992,992,0,0
45976,2019-12-08,1011,0,1011,101,1112,1112,0,0
45977,2019-12-08,510,0,510,40,550,550,0,0
45978,2019-12-08,436,-87,349,27,376,376,0,0
45979,2019-12-08,584,0,584,46,630,630,0,0
45980,2019-12-08,773,0,773,77,850,850,0,0
45981,2019-12-08,773,0,773,77,850,850,0,0
45982,2019-12-08,1046,0,1046,98,1144,1144,0,0
45983,2019-12-08,362,0,362,28,390,390,0,0
45984,2019-12-08,773,0,773,77,850,850,0,0
45985,2019-12-08,1668,0,1668,133,1801,1801,0,0
45986,2019-12-08,807,0,807,64,871,871,0,0
45987,2019-12-08,525,0,525,42,567,567,0,0
45988,2019-12-08,-1046,0,-1046,-98,-1144,-1144,0,0
45989,2019-12-08,279,0,279,22,301,301,0,0
45990,2019-12-08,900,0,900,72,972,972,0,0
45991,2019-12-08,-900,0,-900,-72,-972,-972,0,0
45992,2019-12-08,853,0,853,68,921,921,0,0
45993,2019-12-08,658,0,658,52,710,710,0,0
45994,2019-12-08,773,0,773,77,850,850,0,0
45995,2019-12-09,575,0,575,46,621,621,0,0
45996,2019-12-09,724,0,724,57,781,781,0,0
45997,2019-12-09,250,0,250,25,275,275,0,0
45998,2019-12-09,1805,0,1805,180,1985,0,0,1985
45999,2019-12-09,891,0,891,89,980,980,0,0
46000,2019-12-09,204,0,204,16,220,220,0,0
46001,2019-12-09,390,0,390,31,421,421,0,0
46002,2019-12-09,279,0,279,22,301,301,0,0
46003,2019-12-09,418,0,418,41,459,0,459,0
46004,2019-12-09,631,0,631,50,681,681,0,0
46005,2019-12-09,428,0,428,42,470,0,470,0
46006,2019-12-09,409,0,409,32,441,441,0,0
46007,2019-12-09,492,0,492,39,531,531,0,0
46008,2019-12-09,510,0,510,40,550,0,0,550
46009,2019-12-09,891,0,891,89,980,980,0,0
46010,2019-12-09,501,0,501,40,541,541,0,0
46011,2019-12-09,1114,0,1114,89,1203,1203,0,0
46012,2019-12-09,632,0,632,50,682,682,0,0
46013,2019-12-09,1484,0,1484,118,1602,1602,0,0
46014,2019-12-09,1391,0,1391,139,1530,1530,0,0
46015,2019-12-09,628,0,628,62,690,0,690,0
46016,2019-12-09,613,0,613,49,662,0,662,0
46017,2019-12-09,1010,-101,909,72,981,981,0,0
46018,2019-12-09,630,0,630,63,693,693,0,0
46019,2019-12-09,343,0,343,27,370,0,370,0
46020,2019-12-09,186,0,186,14,200,200,0,0
46021,2019-12-09,807,0,807,64,871,871,0,0
46022,2019-12-09,2406,0,2406,192,2598,0,0,2598
46023,2019-12-09,288,0,288,23,311,311,0,0
46024,2019-12-09,288,0,288,23,311,311,0,0
46025,2019-12-09,352,0,352,28,380,380,0,0
46026,2019-12-09,861,0,861,86,947,947,0,0
46027,2019-12-09,473,0,473,37,510,510,0,0
46028,2019-12-09,260,0,260,20,280,280,0,0
46029,2019-12-09,613,0,613,49,662,662,0,0
46030,2019-12-09,306,0,306,24,330,330,0,0
46031,2019-12-09,891,0,891,89,980,980,0,0
46032,2019-12-09,261,0,261,20,281,281,0,0
46033,2019-12-09,789,0,789,63,852,852,0,0
46034,2019-12-09,770,0,770,61,831,831,0,0
46035,2019-12-09,372,0,372,29,401,401,0,0
46036,2019-12-09,139,0,139,11,150,150,0,0
46037,2019-12-09,1782,0,1782,178,1960,1960,0,0
46038,2019-12-09,530,0,530,42,572,572,0,0
46039,2019-12-09,1383,0,1383,110,1493,1493,0,0
46040,2019-12-09,371,0,371,29,400,0,0,400
46041,2019-12-09,380,0,380,30,410,410,0,0
46042,2019-12-09,706,0,706,56,762,762,0,0
46043,2019-12-09,1782,0,1782,178,1960,0,0,1960
46044,2019-12-09,891,0,891,89,980,0,0,980
46045,2019-12-09,836,0,836,66,902,0,0,902
46046,2019-12-09,149,0,149,11,160,160,0,0
46047,2019-12-09,973,0,973,77,1050,1050,0,0
46048,2019-12-09,891,0,891,89,980,980,0,0
46049,2019-12-09,631,0,631,50,681,0,0,681
46050,2019-12-09,242,0,242,19,261,261,0,0
46051,2019-12-09,773,0,773,77,850,850,0,0
46052,2019-12-09,1546,0,1546,154,1700,1700,0,0
46053,2019-12-09,537,0,537,53,590,590,0,0
46054,2019-12-09,3331,0,3331,333,3664,3664,0,0
46055,2019-12-09,974,0,974,77,1051,0,0,1051
46056,2019-12-09,417,0,417,33,450,450,0,0
46057,2019-12-09,732,0,732,58,790,790,0,0
46058,2019-12-09,1094,0,1094,87,1181,1181,0,0
46059,2019-12-09,315,0,315,25,340,340,0,0
46060,2019-12-09,260,0,260,20,280,280,0,0
46061,2019-12-09,139,0,139,11,150,150,0,0
46062,2019-12-09,250,0,250,20,270,270,0,0
46063,2019-12-09,538,0,538,43,581,581,0,0
46064,2019-12-09,540,0,540,43,583,583,0,0
46065,2019-12-09,365,-36,329,26,355,355,0,0
46066,2019-12-09,687,0,687,54,741,741,0,0
46067,2019-12-09,1158,0,1158,92,1250,1250,0,0
46068,2019-12-09,139,0,139,11,150,150,0,0
46069,2019-12-09,509,0,509,50,559,559,0,0
46070,2019-12-09,947,0,947,75,1022,1022,0,0
46071,2019-12-09,482,0,482,38,520,520,0,0
46072,2019-12-09,427,0,427,34,461,461,0,0
46073,2019-12-09,1038,0,1038,83,1121,1121,0,0
46074,2019-12-09,269,0,269,21,290,290,0,0
46075,2019-12-09,650,0,650,52,702,702,0,0
46076,2019-12-09,695,0,695,69,764,764,0,0
46077,2019-12-09,1142,0,1142,91,1233,1233,0,0
46078,2019-12-09,686,0,686,54,740,0,740,0
46079,2019-12-09,141,0,141,11,152,0,0,152
46080,2019-12-09,639,0,639,63,702,702,0,0
46081,2019-12-09,454,0,454,36,490,490,0,0
46082,2019-12-09,565,0,565,45,610,610,0,0
46083,2019-12-09,1188,0,1188,95,1283,1283,0,0
46084,2019-12-09,752,0,752,60,812,0,812,0
46085,2019-12-09,760,0,760,60,820,820,0,0
46086,2019-12-09,2315,0,2315,185,2500,2500,0,0
46087,2019-12-09,1049,0,1049,83,1132,1132,0,0
46088,2019-12-09,419,0,419,33,452,452,0,0
46089,2019-12-09,513,0,513,41,554,554,0,0
46090,2019-12-09,1546,0,1546,154,1700,1700,0,0
46091,2019-12-09,1546,0,1546,154,1700,0,0,1700
46092,2019-12-09,214,0,214,17,231,231,0,0
46093,2019-12-09,167,0,167,13,180,180,0,0
46094,2019-12-09,705,0,705,56,761,761,0,0
46095,2019-12-09,362,0,362,28,390,390,0,0
46096,2019-12-09,1245,0,1245,99,1344,1344,0,0
46097,2019-12-09,167,0,167,13,180,180,0,0
46098,2019-12-09,1046,0,1046,104,1150,1150,0,0
46099,2019-12-09,1046,0,1046,104,1150,1150,0,0
46100,2019-12-09,251,0,251,20,271,0,271,0
46101,2019-12-09,445,0,445,35,480,480,0,0
46102,2019-12-09,2365,0,2365,189,2554,2554,0,0
46103,2019-12-09,983,0,983,78,1061,1061,0,0
46104,2019-12-09,315,0,315,31,346,0,346,0
46105,2019-12-09,1354,0,1354,108,1462,1462,0,0
46106,2019-12-10,660,-66,594,47,641,641,0,0
46107,2019-12-10,269,0,269,21,290,290,0,0
46108,2019-12-10,1808,0,1808,144,1952,1952,0,0
46109,2019-12-10,643,0,643,51,694,694,0,0
46110,2019-12-10,399,0,399,31,430,430,0,0
46111,2019-12-10,186,0,186,14,200,200,0,0
46112,2019-12-10,428,0,428,34,462,462,0,0
46113,2019-12-10,640,0,640,51,691,691,0,0
46114,2019-12-10,649,0,649,51,700,700,0,0
46115,2019-12-10,269,0,269,21,290,290,0,0
46116,2019-12-10,491,0,491,49,540,540,0,0
46117,2019-12-10,492,0,492,39,531,531,0,0
46118,2019-12-10,695,0,695,69,764,764,0,0
46119,2019-12-10,1168,0,1168,93,1261,1261,0,0
46120,2019-12-10,892,0,892,71,963,963,0,0
46121,2019-12-10,834,0,834,83,917,917,0,0
46122,2019-12-10,371,0,371,29,400,0,0,400
46123,2019-12-10,306,0,306,24,330,0,0,330
46124,2019-12-10,233,0,233,18,251,251,0,0
46125,2019-12-10,139,0,139,11,150,150,0,0
46126,2019-12-10,612,0,612,48,660,660,0,0
46127,2019-12-10,576,0,576,46,622,622,0,0
46128,2019-12-10,1096,0,1096,87,1183,1183,0,0
46129,2019-12-11,945,0,945,75,1020,1020,0,0
46130,2019-12-11,826,0,826,66,892,0,892,0
46131,2019-12-11,437,0,437,34,471,471,0,0
46132,2019-12-11,1485,0,1485,118,1603,1603,0,0
46133,2019-12-11,882,0,882,70,952,952,0,0
46134,2019-12-11,483,0,483,38,521,521,0,0
46135,2019-12-11,335,0,335,26,361,361,0,0
46136,2019-12-11,520,0,520,41,561,561,0,0
46137,2019-12-11,538,0,538,43,581,581,0,0
46138,2019-12-11,891,0,891,89,980,980,0,0
46139,2019-12-11,511,0,511,40,551,551,0,0
46140,2019-12-11,891,0,891,89,980,980,0,0
46141,2019-12-11,735,0,735,58,793,793,0,0
46142,2019-12-11,891,0,891,89,980,980,0,0
46143,2019-12-11,1280,0,1280,102,1382,0,0,1382
46144,2019-12-11,473,0,473,37,510,510,0,0
46145,2019-12-11,891,0,891,89,980,980,0,0
46146,2019-12-11,1780,-178,1602,128,1730,1730,0,0
46147,2019-12-11,1539,0,1539,123,1662,1662,0,0
46148,2019-12-11,46,0,46,4,50,50,0,0
46149,2019-12-11,46,0,46,4,50,50,0,0
46150,2019-12-11,47,0,47,3,50,50,0,0
46151,2019-12-11,891,0,891,89,980,980,0,0
46152,2019-12-11,891,0,891,89,980,980,0,0
46153,2019-12-11,455,0,455,36,491,0,491,0
46154,2019-12-11,605,0,605,48,653,653,0,0
46155,2019-12-11,640,0,640,51,691,691,0,0
46156,2019-12-11,844,-500,344,27,371,371,0,0
46157,2019-12-11,732,0,732,73,805,805,0,0
46158,2019-12-11,895,0,895,71,966,966,0,0
46159,2019-12-11,438,0,438,35,473,473,0,0
46160,2019-12-11,1250,0,1250,125,1375,0,1375,0
46161,2019-12-11,334,0,334,26,360,360,0,0
46162,2019-12-11,475,0,475,38,513,513,0,0
46163,2019-12-11,810,0,810,64,874,874,0,0
46164,2019-12-11,891,0,891,89,980,0,980,0
46165,2019-12-11,891,0,891,89,980,0,980,0
46166,2019-12-11,519,0,519,41,560,560,0,0
46167,2019-12-11,955,0,955,95,1050,1050,0,0
46168,2019-12-11,269,0,269,21,290,290,0,0
46169,2019-12-11,186,0,186,14,200,200,0,0
46170,2019-12-11,520,0,520,41,561,561,0,0
46171,2019-12-11,204,0,204,16,220,0,220,0
46172,2019-12-11,1330,0,1330,106,1436,0,1436,0
46173,2019-12-11,260,0,260,20,280,280,0,0
46174,2019-12-11,527,0,527,42,569,569,0,0
46175,2019-12-11,1030,0,1030,82,1112,1112,0,0
46176,2019-12-11,269,0,269,21,290,290,0,0
46177,2019-12-11,2328,-465,1863,186,2049,2049,0,0
46178,2019-12-11,559,0,559,44,603,603,0,0
46179,2019-12-11,269,0,269,21,290,290,0,0
46180,2019-12-11,734,0,734,58,792,792,0,0
46181,2019-12-11,510,0,510,40,550,550,0,0
46182,2019-12-11,1299,0,1299,103,1402,1402,0,0
46183,2019-12-11,493,0,493,39,532,532,0,0
46184,2019-12-11,464,0,464,37,501,0,0,501
46185,2019-12-11,1519,0,1519,151,1670,1670,0,0
46186,2019-12-11,556,0,556,44,600,600,0,0
46187,2019-12-11,306,0,306,24,330,330,0,0
46188,2019-12-11,760,0,760,60,820,820,0,0
46189,2019-12-11,334,0,334,26,360,360,0,0
46190,2019-12-11,741,0,741,59,800,800,0,0
46191,2019-12-11,796,0,796,79,875,875,0,0
46192,2019-12-11,751,0,751,60,811,811,0,0
46193,2019-12-11,297,0,297,23,320,320,0,0
46194,2019-12-11,2160,0,2160,172,2332,2332,0,0
46195,2019-12-11,1428,0,1428,114,1542,1542,0,0
46196,2019-12-11,1447,0,1447,115,1562,1562,0,0
46197,2019-12-11,779,0,779,62,841,841,0,0
46198,2019-12-11,278,0,278,22,300,300,0,0
46199,2019-12-11,770,0,770,61,831,831,0,0
46200,2019-12-11,773,-77,696,69,765,765,0,0
46201,2019-12-11,732,0,732,58,790,0,790,0
46202,2019-12-11,858,0,858,68,926,926,0,0
46203,2019-12-11,639,0,639,63,702,702,0,0
46204,2019-12-11,773,0,773,77,850,0,0,850
46205,2019-12-11,557,0,557,44,601,601,0,0
46206,2019-12-11,773,0,773,77,850,850,0,0
46207,2019-12-11,1046,0,1046,104,1150,0,0,1150
46208,2019-12-11,773,0,773,77,850,850,0,0
46209,2019-12-11,1519,0,1519,151,1670,0,0,1670
46210,2019-12-11,773,0,773,77,850,850,0,0
46211,2019-12-11,362,0,362,28,390,390,0,0
46212,2019-12-11,371,0,371,29,400,400,0,0
46213,2019-12-11,640,0,640,51,691,691,0,0
46214,2019-12-11,269,0,269,21,290,290,0,0
46215,2019-12-11,455,0,455,36,491,491,0,0
46216,2019-12-11,556,0,556,44,600,600,0,0
46217,2019-12-11,603,0,603,48,651,651,0,0
46218,2019-12-11,519,0,519,41,560,560,0,0
46219,2019-12-11,297,0,297,23,320,320,0,0
46220,2019-12-11,371,0,371,29,400,400,0,0
46221,2019-12-11,343,0,343,27,370,370,0,0
46222,2019-12-11,891,0,891,89,980,980,0,0
46223,2019-12-11,445,0,445,35,480,480,0,0
46224,2019-12-11,891,-89,802,80,882,882,0,0
46225,2019-12-11,557,-55,502,40,542,542,0,0
46226,2019-12-11,306,0,306,24,330,330,0,0
46227,2019-12-11,585,0,585,46,631,631,0,0
46228,2019-12-11,891,0,891,89,980,980,0,0
46229,2019-12-11,436,0,436,34,470,470,0,0
46230,2019-12-11,658,0,658,52,710,0,710,0
46231,2019-12-11,1046,0,1046,104,1150,1150,0,0
46232,2019-12-11,754,0,754,60,814,814,0,0
46233,2019-12-11,593,0,593,47,640,640,0,0
46234,2019-12-11,773,0,773,77,850,850,0,0
46235,2019-12-11,753,0,753,60,813,813,0,0
46236,2019-12-11,603,0,603,48,651,651,0,0
46237,2019-12-11,466,0,466,37,503,503,0,0
46238,2019-12-11,884,0,884,70,954,954,0,0
46239,2019-12-11,167,0,167,13,180,180,0,0
46240,2019-12-11,167,0,167,13,180,180,0,0
46241,2019-12-12,825,0,825,82,907,907,0,0
46242,2019-12-12,537,0,537,53,590,590,0,0
46243,2019-12-12,650,0,650,52,702,702,0,0
46244,2019-12-12,168,0,168,13,181,181,0,0
46245,2019-12-12,520,0,520,41,561,561,0,0
46246,2019-12-12,628,0,628,62,690,690,0,0
46247,2019-12-12,734,0,734,58,792,792,0,0
46248,2019-12-12,93,0,93,7,100,0,0,100
46249,2019-12-12,510,0,510,40,550,550,0,0
46250,2019-12-12,585,0,585,46,631,631,0,0
46251,2019-12-12,843,0,843,84,927,927,0,0
46252,2019-12-12,622,0,622,49,671,671,0,0
46253,2019-12-12,1029,0,1029,102,1131,1131,0,0
46254,2019-12-12,762,0,762,60,822,822,0,0
46255,2019-12-12,1382,-138,1244,99,1343,1343,0,0
46256,2019-12-12,445,0,445,35,480,480,0,0
46257,2019-12-12,779,0,779,62,841,841,0,0
46258,2019-12-12,278,0,278,22,300,300,0,0
46259,2019-12-12,334,0,334,26,360,360,0,0
46260,2019-12-12,491,0,491,39,530,530,0,0
46261,2019-12-12,993,0,993,79,1072,1072,0,0
46262,2019-12-12,204,0,204,16,220,220,0,0
46263,2019-12-12,510,0,510,40,550,550,0,0
46264,2019-12-12,204,0,204,16,220,220,0,0
46265,2019-12-12,510,0,510,40,550,550,0,0
46266,2019-12-12,891,0,891,71,962,962,0,0
46267,2019-12-12,918,-918,0,0,0,0,0,0
46268,2019-12-12,530,-53,477,38,515,515,0,0
46269,2019-12-12,474,0,474,37,511,511,0,0
46270,2019-12-12,445,0,445,35,480,480,0,0
46271,2019-12-12,752,0,752,60,812,812,0,0
46272,2019-12-12,751,0,751,75,826,826,0,0
46273,2019-12-12,919,0,919,73,992,992,0,0
46274,2019-12-12,734,0,734,58,792,792,0,0
46275,2019-12-12,836,-167,669,53,722,722,0,0
46276,2019-12-12,237,0,237,18,255,255,0,0
46277,2019-12-12,362,0,362,36,398,0,0,398
46278,2019-12-12,181,0,181,14,195,195,0,0
46279,2019-12-12,752,0,752,60,812,812,0,0
46280,2019-12-12,584,0,584,58,642,642,0,0
46281,2019-12-12,650,0,650,52,702,0,702,0
46282,2019-12-12,628,0,628,62,690,690,0,0
46283,2019-12-12,463,0,463,46,509,509,0,0
46284,2019-12-12,705,0,705,56,761,761,0,0
46285,2019-12-12,399,0,399,31,430,430,0,0
46286,2019-12-12,1354,0,1354,108,1462,0,1462,0
46287,2019-12-12,835,0,835,66,901,901,0,0
46288,2019-12-12,427,0,427,34,461,461,0,0
46289,2019-12-12,2045,0,2045,204,2249,0,2249,0
46290,2019-12-12,427,0,427,34,461,461,0,0
46291,2019-12-12,732,0,732,58,790,790,0,0
46292,2019-12-12,640,0,640,51,691,0,691,0
46293,2019-12-12,1047,0,1047,83,1130,0,1130,0
46294,2019-12-12,520,0,520,41,561,561,0,0
46295,2019-12-12,1782,0,1782,178,1960,0,0,1960
46296,2019-12-12,669,0,669,53,722,722,0,0
46297,2019-12-12,362,0,362,28,390,390,0,0
46298,2019-12-12,891,0,891,89,980,980,0,0
46299,2019-12-12,519,0,519,41,560,560,0,0
46300,2019-12-12,-94,0,-94,-7,-101,0,-101,0
46301,2019-12-12,94,0,94,7,101,0,101,0
46302,2019-12-12,686,0,686,54,740,0,0,740
46303,2019-12-12,816,0,816,65,881,881,0,0
46304,2019-12-12,501,0,501,50,551,551,0,0
46305,2019-12-12,306,0,306,24,330,330,0,0
46306,2019-12-12,-46,0,-46,-4,-50,-50,0,0
46307,2019-12-12,-46,0,-46,-4,-50,-50,0,0
46308,2019-12-12,-47,0,-47,-3,-50,-50,0,0
46309,2019-12-12,1243,0,1243,99,1342,1342,0,0
46310,2019-12-12,335,0,335,26,361,361,0,0
46311,2019-12-12,1150,0,1150,92,1242,1242,0,0
46312,2019-12-12,1864,0,1864,149,2013,2013,0,0
46313,2019-12-12,631,0,631,50,681,681,0,0
46314,2019-12-12,188,0,188,15,203,203,0,0
46315,2019-12-12,463,0,463,46,509,509,0,0
46316,2019-12-12,335,0,335,26,361,361,0,0
46317,2019-12-12,2142,0,2142,171,2313,2313,0,0
46318,2019-12-12,232,0,232,18,250,250,0,0
46319,2019-12-12,-416,0,-416,-41,-457,-457,0,0
46320,2019-12-12,592,0,592,58,650,650,0,0
46321,2019-12-12,417,0,417,32,449,449,0,0
46322,2019-12-12,416,0,416,41,457,457,0,0
46323,2019-12-12,149,0,149,14,163,163,0,0
46324,2019-12-12,1131,0,1131,90,1221,1221,0,0
46325,2019-12-12,789,0,789,63,852,852,0,0
46326,2019-12-12,522,0,522,41,563,563,0,0
46327,2019-12-12,260,0,260,20,280,280,0,0
46328,2019-12-12,141,0,141,11,152,152,0,0
46329,2019-12-12,539,0,539,43,582,582,0,0
46330,2019-12-12,1180,0,1180,94,1274,0,1274,0
46331,2019-12-12,149,0,149,11,160,160,0,0
46332,2019-12-12,417,0,417,33,450,450,0,0
46333,2019-12-12,1001,0,1001,80,1081,1081,0,0
46334,2019-12-12,593,0,593,57,650,650,0,0
46335,2019-12-12,-417,0,-417,-32,-449,-449,0,0
46336,2019-12-12,102,0,102,10,112,0,112,0
46337,2019-12-12,-592,0,-592,-58,-650,-650,0,0
46338,2019-12-12,1038,0,1038,83,1121,1121,0,0
46339,2019-12-12,-593,0,-593,-57,-650,-650,0,0
46340,2019-12-12,556,0,556,44,600,600,0,0
46341,2019-12-12,761,0,761,60,821,821,0,0
46342,2019-12-12,306,0,306,24,330,330,0,0
46343,2019-12-12,176,0,176,14,190,190,0,0
46344,2019-12-12,1121,0,1121,112,1233,0,1233,0
46345,2019-12-12,696,-69,627,50,677,677,0,0
46346,2019-12-12,1373,0,1373,109,1482,1482,0,0
46347,2019-12-12,1521,0,1521,121,1642,1642,0,0
46348,2019-12-12,773,0,773,77,850,850,0,0
46349,2019-12-12,1046,0,1046,104,1150,1150,0,0
46350,2019-12-12,1295,0,1295,129,1424,1424,0,0
46351,2019-12-12,474,0,474,37,511,511,0,0
46352,2019-12-12,548,0,548,43,591,591,0,0
46353,2019-12-12,334,0,334,26,360,360,0,0
46354,2019-12-12,773,0,773,77,850,850,0,0
46355,2019-12-12,1401,0,1401,140,1541,1541,0,0
46356,2019-12-12,501,0,501,40,541,541,0,0
46357,2019-12-12,1493,0,1493,149,1642,1642,0,0
46358,2019-12-12,1002,0,1002,80,1082,1082,0,0
46359,2019-12-12,139,0,139,13,152,152,0,0
46360,2019-12-12,501,0,501,40,541,541,0,0
46361,2019-12-12,773,0,773,77,850,850,0,0
46362,2019-12-12,1660,0,1660,132,1792,1792,0,0
46363,2019-12-12,741,0,741,59,800,800,0,0
46364,2019-12-12,250,0,250,25,275,275,0,0
46365,2019-12-12,417,0,417,33,450,450,0,0
46366,2019-12-12,176,0,176,14,190,190,0,0
46367,2019-12-12,1159,0,1159,92,1251,1251,0,0
46368,2019-12-13,2257,0,2257,180,2437,2437,0,0
46369,2019-12-13,1782,0,1782,178,1960,1960,0,0
46370,2019-12-13,1782,0,1782,178,1960,1960,0,0
46371,2019-12-13,195,0,195,15,210,210,0,0
46372,2019-12-13,1677,0,1677,167,1844,0,1844,0
46373,2019-12-13,1235,0,1235,98,1333,1333,0,0
46374,2019-12-13,1225,0,1225,98,1323,1323,0,0
46375,2019-12-13,167,0,167,13,180,180,0,0
46376,2019-12-13,-1115,0,-1115,-89,-1204,-1204,0,0
46377,2019-12-13,575,0,575,46,621,621,0,0
46378,2019-12-13,1659,0,1659,132,1791,1791,0,0
46379,2019-12-13,1115,0,1115,89,1204,1204,0,0
46380,2019-12-13,1115,0,1115,89,1204,0,0,1204
46381,2019-12-13,1978,0,1978,158,2136,0,0,2136
46382,2019-12-13,1782,0,1782,178,1960,1960,0,0
46383,2019-12-13,891,0,891,89,980,980,0,0
46384,2019-12-13,167,0,167,13,180,180,0,0
46385,2019-12-13,436,0,436,34,470,470,0,0
46386,2019-12-13,389,0,389,31,420,420,0,0
46387,2019-12-13,501,0,501,40,541,541,0,0
46388,2019-12-13,760,0,760,60,820,820,0,0
46389,2019-12-13,529,0,529,42,571,571,0,0
46390,2019-12-13,910,0,910,72,982,982,0,0
46391,2019-12-13,139,0,139,13,152,152,0,0
46392,2019-12-13,603,0,603,48,651,651,0,0
46393,2019-12-13,1782,0,1782,178,1960,1960,0,0
46394,2019-12-13,668,0,668,53,721,721,0,0
46395,2019-12-13,769,0,769,61,830,830,0,0
46396,2019-12-13,232,0,232,18,250,250,0,0
46397,2019-12-13,269,0,269,21,290,290,0,0
46398,2019-12-13,1793,0,1793,143,1936,1936,0,0
46399,2019-12-13,557,0,557,44,601,0,601,0
46400,2019-12-13,1244,0,1244,99,1343,1343,0,0
46401,2019-12-13,4042,0,4042,323,4365,4365,0,0
46402,2019-12-13,1040,0,1040,83,1123,1123,0,0
46403,2019-12-13,278,0,278,22,300,0,300,0
46404,2019-12-13,529,0,529,42,571,571,0,0
46405,2019-12-13,725,0,725,72,797,797,0,0
46406,2019-12-13,1124,0,1124,112,1236,0,1236,0
46407,2019-12-13,306,0,306,24,330,330,0,0
46408,2019-12-13,1782,0,1782,178,1960,1960,0,0
46409,2019-12-13,382,0,382,30,412,412,0,0
46410,2019-12-13,574,0,574,57,631,631,0,0
46411,2019-12-13,1782,0,1782,178,1960,0,1960,0
46412,2019-12-13,1076,0,1076,86,1162,1162,0,0
46413,2019-12-13,298,0,298,23,321,321,0,0
46414,2019-12-13,446,0,446,35,481,481,0,0
46415,2019-12-13,1002,0,1002,80,1082,1082,0,0
46416,2019-12-13,459,0,459,36,495,495,0,0
46417,2019-12-13,334,0,334,26,360,360,0,0
46418,2019-12-13,734,0,734,58,792,0,0,792
46419,2019-12-13,446,0,446,35,481,0,0,481
46420,2019-12-13,740,0,740,59,799,799,0,0
46421,2019-12-13,2113,0,2113,211,2324,2324,0,0
46422,2019-12-13,1622,0,1622,129,1751,1751,0,0
46423,2019-12-13,686,0,686,68,754,754,0,0
46424,2019-12-13,510,0,510,40,550,550,0,0
46425,2019-12-13,297,0,297,23,320,320,0,0
46426,2019-12-13,1531,0,1531,122,1653,1653,0,0
46427,2019-12-13,1660,0,1660,132,1792,1792,0,0
46428,2019-12-13,806,0,806,64,870,0,0,870
46429,2019-12-13,724,0,724,57,781,0,781,0
46430,2019-12-13,641,0,641,51,692,692,0,0
46431,2019-12-13,1122,0,1122,89,1211,0,1211,0
46432,2019-12-13,1467,0,1467,117,1584,0,0,1584
46433,2019-12-13,677,0,677,54,731,731,0,0
46434,2019-12-13,483,0,483,38,521,521,0,0
46435,2019-12-13,566,0,566,45,611,611,0,0
46436,2019-12-13,780,0,780,62,842,842,0,0
46437,2019-12-13,1587,0,1587,126,1713,1713,0,0
46438,2019-12-13,740,0,740,74,814,814,0,0
46439,2019-12-13,861,0,861,68,929,929,0,0
46440,2019-12-13,1439,0,1439,115,1554,0,0,1554
46441,2019-12-13,139,0,139,11,150,150,0,0
46442,2019-12-13,628,0,628,62,690,690,0,0
46443,2019-12-13,891,0,891,89,980,980,0,0
46444,2019-12-13,167,0,167,13,180,180,0,0
46445,2019-12-13,891,0,891,89,980,980,0,0
46446,2019-12-13,546,0,546,54,600,600,0,0
46447,2019-12-13,2921,0,2921,292,3213,3213,0,0
46448,2019-12-13,622,0,622,49,671,671,0,0
46449,2019-12-13,956,0,956,76,1032,1032,0,0
46450,2019-12-13,806,0,806,80,886,886,0,0
46451,2019-12-13,750,0,750,60,810,810,0,0
46452,2019-12-13,1158,0,1158,92,1250,1250,0,0
46453,2019-12-13,-891,0,-891,-89,-980,-980,0,0
46454,2019-12-13,-1546,0,-1546,-154,-1700,-1700,0,0
46455,2019-12-13,1546,0,1546,154,1700,0,0,1700
46456,2019-12-13,1546,0,1546,154,1700,1700,0,0
46457,2019-12-13,1251,0,1251,125,1376,1376,0,0
46458,2019-12-13,1049,0,1049,83,1132,1132,0,0
46459,2019-12-13,1252,0,1252,125,1377,1377,0,0
46460,2019-12-13,1046,0,1046,104,1150,1150,0,0
46461,2019-12-13,773,0,773,77,850,850,0,0
46462,2019-12-13,937,0,937,74,1011,1011,0,0
46463,2019-12-13,519,0,519,51,570,570,0,0
46464,2019-12-13,593,0,593,47,640,0,0,640
46465,2019-12-13,612,0,612,48,660,660,0,0
46466,2019-12-13,973,0,973,77,1050,1050,0,0
46467,2019-12-13,546,0,546,54,600,600,0,0
46468,2019-12-13,1546,0,1546,154,1700,0,1700,0
46469,2019-12-13,273,0,273,27,300,300,0,0
46470,2019-12-13,1611,0,1611,128,1739,1739,0,0
46471,2019-12-13,881,0,881,70,951,951,0,0
46472,2019-12-13,1546,0,1546,154,1700,0,0,1700
46473,2019-12-13,1546,0,1546,154,1700,1700,0,0
46474,2019-12-13,2319,0,2319,231,2550,2550,0,0
46475,2019-12-13,1782,0,1782,178,1960,1960,0,0
46476,2019-12-13,759,0,759,75,834,834,0,0
46477,2019-12-13,538,0,538,43,581,581,0,0
46478,2019-12-13,2675,0,2675,214,2889,2889,0,0
46479,2019-12-13,872,0,872,69,941,941,0,0
46480,2019-12-13,650,0,650,52,702,702,0,0
46481,2019-12-13,448,0,448,35,483,483,0,0
46482,2019-12-13,613,0,613,49,662,0,662,0
46483,2019-12-13,773,-77,696,69,765,765,0,0
46484,2019-12-13,445,0,445,35,480,480,0,0
46485,2019-12-13,278,0,278,22,300,300,0,0
46486,2019-12-13,594,0,594,47,641,641,0,0
46487,2019-12-13,269,0,269,21,290,0,0,290
46488,2019-12-13,269,0,269,21,290,290,0,0
46489,2019-12-13,437,0,437,34,471,471,0,0
46490,2019-12-13,260,0,260,20,280,280,0,0
46491,2019-12-13,483,0,483,38,521,521,0,0
46492,2019-12-13,1011,0,1011,80,1091,0,1091,0
46493,2019-12-13,770,0,770,61,831,831,0,0
46494,2019-12-13,603,0,603,48,651,651,0,0
46495,2019-12-13,520,0,520,41,561,561,0,0
46496,2019-12-13,686,0,686,54,740,740,0,0
46497,2019-12-13,316,0,316,31,347,347,0,0
46498,2019-12-13,400,0,400,32,432,432,0,0
46499,2019-12-13,623,0,623,49,672,672,0,0
46500,2019-12-13,464,0,464,37,501,501,0,0
46501,2019-12-13,2538,0,2538,253,2791,0,0,2791
46502,2019-12-13,918,0,918,73,991,991,0,0
46503,2019-12-13,306,0,306,24,330,330,0,0
46504,2019-12-13,1782,0,1782,178,1960,1960,0,0
46505,2019-12-13,298,0,298,29,327,327,0,0
46506,2019-12-13,419,0,419,33,452,452,0,0
46507,2019-12-13,891,0,891,89,980,980,0,0
46508,2019-12-13,891,0,891,89,980,980,0,0
46509,2019-12-13,891,0,891,89,980,980,0,0
46510,2019-12-13,1782,0,1782,178,1960,1960,0,0
46511,2019-12-13,269,0,269,21,290,290,0,0
46512,2019-12-13,1020,0,1020,81,1101,1101,0,0
46513,2019-12-13,798,0,798,79,877,877,0,0
46514,2019-12-13,511,0,511,40,551,551,0,0
46515,2019-12-13,1159,0,1159,92,1251,0,0,1251
46516,2019-12-13,799,0,799,63,862,0,0,862
46517,2019-12-13,473,0,473,37,510,510,0,0
46518,2019-12-13,539,0,539,43,582,582,0,0
46519,2019-12-13,639,0,639,63,702,0,702,0
46520,2019-12-13,-539,0,-539,-43,-582,0,0,-582
46521,2019-12-13,139,0,139,11,150,0,150,0
46522,2019-12-13,269,0,269,21,290,290,0,0
46523,2019-12-13,2319,0,2319,231,2550,2550,0,0
46524,2019-12-13,1151,0,1151,92,1243,1243,0,0
46525,2019-12-13,1046,0,1046,104,1150,1150,0,0
46526,2019-12-13,649,-64,585,46,631,631,0,0
46527,2019-12-13,621,0,621,49,670,670,0,0
46528,2019-12-13,773,0,773,77,850,850,0,0
46529,2019-12-13,464,0,464,37,501,501,0,0
46530,2019-12-13,992,0,992,79,1071,1071,0,0
46531,2019-12-13,2140,0,2140,214,2354,0,0,2354
46532,2019-12-13,816,-81,735,58,793,793,0,0
46533,2019-12-13,797,0,797,63,860,860,0,0
46534,2019-12-13,1521,0,1521,121,1642,1642,0,0
46535,2019-12-13,288,0,288,28,316,316,0,0
46536,2019-12-13,881,0,881,88,969,969,0,0
46537,2019-12-13,539,0,539,43,582,0,0,582
46538,2019-12-14,974,0,974,77,1051,1051,0,0
46539,2019-12-14,473,0,473,37,510,0,510,0
46540,2019-12-14,891,0,891,89,980,980,0,0
46541,2019-12-14,1011,0,1011,80,1091,1091,0,0
46542,2019-12-14,1022,0,1022,102,1124,0,1124,0
46543,2019-12-14,2014,0,2014,201,2215,2215,0,0
46544,2019-12-14,3365,0,3365,336,3701,3701,0,0
46545,2019-12-14,1253,0,1253,100,1353,1353,0,0
46546,2019-12-14,241,0,241,19,260,260,0,0
46547,2019-12-14,687,0,687,68,755,755,0,0
46548,2019-12-14,1058,0,1058,84,1142,0,1142,0
46549,2019-12-14,2468,0,2468,246,2714,0,2714,0
46550,2019-12-14,891,0,891,89,980,980,0,0
46551,2019-12-14,1948,0,1948,155,2103,2103,0,0
46552,2019-12-14,139,0,139,11,150,150,0,0
46553,2019-12-14,1766,0,1766,141,1907,0,0,1907
46554,2019-12-14,1067,0,1067,85,1152,1152,0,0
46555,2019-12-14,1782,0,1782,178,1960,1960,0,0
46556,2019-12-14,891,0,891,89,980,980,0,0
46557,2019-12-14,167,0,167,16,183,0,0,183
46558,2019-12-14,603,0,603,48,651,651,0,0
46559,2019-12-14,788,0,788,78,866,866,0,0
46560,2019-12-14,594,0,594,47,641,641,0,0
46561,2019-12-14,891,0,891,89,980,980,0,0
46562,2019-12-14,622,0,622,49,671,671,0,0
46563,2019-12-14,1643,0,1643,164,1807,1807,0,0
46564,2019-12-14,380,0,380,38,418,0,418,0
46565,2019-12-14,1085,0,1085,86,1171,1171,0,0
46566,2019-12-14,751,0,751,60,811,811,0,0
46567,2019-12-14,659,0,659,52,711,711,0,0
46568,2019-12-14,409,0,409,32,441,441,0,0
46569,2019-12-14,1782,0,1782,178,1960,1960,0,0
46570,2019-12-14,770,0,770,77,847,847,0,0
46571,2019-12-14,510,0,510,51,561,561,0,0
46572,2019-12-14,1067,0,1067,85,1152,1152,0,0
46573,2019-12-14,612,0,612,61,673,673,0,0
46574,2019-12-14,891,0,891,89,980,980,0,0
46575,2019-12-14,636,0,636,50,686,686,0,0
46576,2019-12-14,482,0,482,38,520,520,0,0
46577,2019-12-14,836,0,836,66,902,902,0,0
46578,2019-12-14,224,0,224,17,241,241,0,0
46579,2019-12-14,3301,-330,2971,297,3268,3268,0,0
46580,2019-12-14,1782,0,1782,178,1960,1960,0,0
46581,2019-12-14,891,0,891,89,980,980,0,0
46582,2019-12-14,557,0,557,44,601,601,0,0
46583,2019-12-14,994,0,994,79,1073,1073,0,0
46584,2019-12-14,520,0,520,41,561,561,0,0
46585,2019-12-14,687,0,687,54,741,741,0,0
46586,2019-12-14,1094,0,1094,87,1181,0,1181,0
46587,2019-12-14,611,0,611,61,672,0,0,672
46588,2019-12-14,1677,0,1677,167,1844,1844,0,0
46589,2019-12-14,149,0,149,11,160,0,0,160
46590,2019-12-14,260,0,260,20,280,0,280,0
46591,2019-12-14,260,0,260,20,280,280,0,0
46592,2019-12-14,640,0,640,51,691,691,0,0
46593,2019-12-14,705,0,705,56,761,0,761,0
46594,2019-12-14,651,0,651,52,703,703,0,0
46595,2019-12-14,177,0,177,14,191,191,0,0
46596,2019-12-14,94,0,94,7,101,101,0,0
46597,2019-12-14,1606,0,1606,160,1766,0,1766,0
46598,2019-12-14,362,0,362,28,390,390,0,0
46599,2019-12-14,865,-86,779,62,841,841,0,0
46600,2019-12-14,1932,0,1932,154,2086,2086,0,0
46601,2019-12-14,935,0,935,93,1028,1028,0,0
46602,2019-12-14,336,0,336,26,362,362,0,0
46603,2019-12-14,1216,0,1216,97,1313,0,1313,0
46604,2019-12-14,436,0,436,34,470,470,0,0
46605,2019-12-14,1002,0,1002,80,1082,1082,0,0
46606,2019-12-14,604,0,604,48,652,0,652,0
46607,2019-12-14,510,0,510,40,550,0,550,0
46608,2019-12-14,585,0,585,58,643,643,0,0
46609,2019-12-14,439,0,439,35,474,474,0,0
46610,2019-12-14,604,0,604,48,652,652,0,0
46611,2019-12-14,223,0,223,17,240,240,0,0
46612,2019-12-14,232,0,232,18,250,250,0,0
46613,2019-12-14,916,0,916,91,1007,1007,0,0
46614,2019-12-14,1528,0,1528,152,1680,1680,0,0
46615,2019-12-14,742,0,742,59,801,801,0,0
46616,2019-12-14,956,0,956,76,1032,1032,0,0
46617,2019-12-14,891,0,891,89,980,980,0,0
46618,2019-12-14,520,0,520,41,561,561,0,0
46619,2019-12-14,742,0,742,59,801,801,0,0
46620,2019-12-14,594,0,594,47,641,641,0,0
46621,2019-12-14,556,0,556,55,611,611,0,0
46622,2019-12-14,537,0,537,53,590,590,0,0
46623,2019-12-14,1003,0,1003,100,1103,1103,0,0
46624,2019-12-14,1669,0,1669,166,1835,0,1835,0
46625,2019-12-14,891,0,891,89,980,0,980,0
46626,2019-12-14,891,0,891,89,980,980,0,0
46627,2019-12-14,334,0,334,26,360,360,0,0
46628,2019-12-14,306,0,306,30,336,336,0,0
46629,2019-12-14,491,0,491,49,540,540,0,0
46630,2019-12-14,660,0,660,52,712,712,0,0
46631,2019-12-14,446,0,446,35,481,481,0,0
46632,2019-12-14,916,0,916,91,1007,1007,0,0
46633,2019-12-14,916,0,916,91,1007,1007,0,0
46634,2019-12-14,916,0,916,91,1007,0,1007,0
46635,2019-12-14,232,0,232,18,250,250,0,0
46636,2019-12-14,603,0,603,48,651,651,0,0
46637,2019-12-14,418,0,418,33,451,451,0,0
46638,2019-12-14,628,0,628,62,690,690,0,0
46639,2019-12-14,510,0,510,40,550,0,550,0
46640,2019-12-14,1399,0,1399,139,1538,0,0,1538
46641,2019-12-14,326,0,326,26,352,352,0,0
46642,2019-12-14,834,0,834,83,917,917,0,0
46643,2019-12-14,186,0,186,14,200,200,0,0
46644,2019-12-14,371,0,371,29,400,400,0,0
46645,2019-12-14,993,0,993,79,1072,1072,0,0
46646,2019-12-14,463,0,463,37,500,500,0,0
46647,2019-12-14,370,0,370,37,407,407,0,0
46648,2019-12-14,399,0,399,39,438,438,0,0
46649,2019-12-14,491,0,491,49,540,540,0,0
46650,2019-12-14,370,0,370,37,407,407,0,0
46651,2019-12-14,973,0,973,97,1070,1070,0,0
46652,2019-12-14,558,0,558,44,602,602,0,0
46653,2019-12-14,737,0,737,58,795,795,0,0
46654,2019-12-14,642,0,642,51,693,693,0,0
46655,2019-12-14,334,0,334,26,360,360,0,0
46656,2019-12-14,491,0,491,49,540,540,0,0
46657,2019-12-14,997,0,997,79,1076,1076,0,0
46658,2019-12-14,1546,0,1546,154,1700,0,1700,0
46659,2019-12-14,1546,0,1546,154,1700,1700,0,0
46660,2019-12-14,2092,0,2092,209,2301,2301,0,0
46661,2019-12-14,1546,0,1546,154,1700,1700,0,0
46662,2019-12-14,1546,0,1546,154,1700,1700,0,0
46663,2019-12-14,546,0,546,54,600,600,0,0
46664,2019-12-14,2250,0,2250,225,2475,2475,0,0
46665,2019-12-14,343,0,343,27,370,370,0,0
46666,2019-12-14,344,0,344,27,371,371,0,0
46667,2019-12-14,121,0,121,9,130,130,0,0
46668,2019-12-14,269,0,269,21,290,290,0,0
46669,2019-12-14,826,0,826,82,908,908,0,0
46670,2019-12-14,289,0,289,23,312,312,0,0
46671,2019-12-14,306,0,306,24,330,330,0,0
46672,2019-12-14,463,0,463,37,500,0,500,0
46673,2019-12-14,370,0,370,37,407,407,0,0
46674,2019-12-14,345,0,345,27,372,372,0,0
46675,2019-12-14,410,0,410,32,442,442,0,0
46676,2019-12-14,446,0,446,44,490,490,0,0
46677,2019-12-14,807,0,807,80,887,887,0,0
46678,2019-12-14,575,0,575,46,621,621,0,0
46679,2019-12-14,491,0,491,49,540,540,0,0
46680,2019-12-14,585,0,585,46,631,631,0,0
46681,2019-12-14,491,0,491,49,540,540,0,0
46682,2019-12-14,2224,0,2224,222,2446,2446,0,0
46683,2019-12-14,954,0,954,95,1049,1049,0,0
46684,2019-12-14,740,0,740,74,814,814,0,0
46685,2019-12-14,362,0,362,28,390,390,0,0
46686,2019-12-14,232,0,232,18,250,0,250,0
46687,2019-12-14,740,0,740,74,814,814,0,0
46688,2019-12-14,167,0,167,13,180,0,180,0
46689,2019-12-14,1195,0,1195,119,1314,1314,0,0
46690,2019-12-14,751,0,751,75,826,826,0,0
46691,2019-12-14,289,0,289,23,312,312,0,0
46692,2019-12-14,713,0,713,71,784,784,0,0
46693,2019-12-14,1416,0,1416,141,1557,1557,0,0
46694,2019-12-14,1371,0,1371,137,1508,1508,0,0
46695,2019-12-14,773,0,773,77,850,850,0,0
46696,2019-12-14,1871,0,1871,187,2058,2058,0,0
46697,2019-12-14,733,0,733,58,791,791,0,0
46698,2019-12-14,352,0,352,28,380,380,0,0
46699,2019-12-14,2319,-231,2088,208,2296,0,0,2296
46700,2019-12-14,1046,0,1046,104,1150,1150,0,0
46701,2019-12-14,315,0,315,25,340,340,0,0
46702,2019-12-14,167,0,167,13,180,180,0,0
46703,2019-12-14,279,0,279,22,301,301,0,0
46704,2019-12-14,773,0,773,77,850,850,0,0
46705,2019-12-14,773,0,773,77,850,850,0,0
46706,2019-12-14,816,0,816,65,881,881,0,0
46707,2019-12-14,353,0,353,28,381,381,0,0
46708,2019-12-14,269,0,269,21,290,290,0,0
46709,2019-12-14,556,0,556,44,600,600,0,0
46710,2019-12-14,752,0,752,60,812,812,0,0
46711,2019-12-14,1667,0,1667,166,1833,0,0,1833
46712,2019-12-14,500,0,500,40,540,540,0,0
46713,2019-12-14,872,0,872,69,941,941,0,0
46714,2019-12-14,501,0,501,40,541,541,0,0
46715,2019-12-14,1782,0,1782,178,1960,0,1960,0
46716,2019-12-14,622,0,622,49,671,671,0,0
46717,2019-12-14,773,0,773,77,850,850,0,0
46718,2019-12-14,1632,0,1632,130,1762,1762,0,0
46719,2019-12-14,362,0,362,28,390,0,0,390
46720,2019-12-14,806,0,806,117,923,0,0,923
46721,2019-12-14,1038,0,1038,103,1141,1141,0,0
46722,2019-12-14,343,0,343,27,370,370,0,0
46723,2019-12-14,713,0,713,71,784,784,0,0
46724,2019-12-14,1835,0,1835,183,2018,2018,0,0
46725,2019-12-14,2319,0,2319,231,2550,0,0,2550
46726,2019-12-14,566,0,566,45,611,611,0,0
46727,2019-12-14,760,0,760,76,836,836,0,0
46728,2019-12-14,773,0,773,77,850,850,0,0
46729,2019-12-14,1326,0,1326,106,1432,1432,0,0
46730,2019-12-14,343,0,343,34,377,377,0,0
46731,2019-12-14,306,0,306,24,330,330,0,0
46732,2019-12-14,1546,0,1546,154,1700,1700,0,0
46733,2019-12-14,1546,0,1546,154,1700,1700,0,0
46734,2019-12-14,464,0,464,46,510,510,0,0
46735,2019-12-14,380,0,380,38,418,418,0,0
46736,2019-12-14,491,0,491,49,540,540,0,0
46737,2019-12-14,1819,0,1819,181,2000,0,0,2000
46738,2019-12-14,242,0,242,19,261,261,0,0
46739,2019-12-14,546,0,546,54,600,600,0,0
46740,2019-12-14,1046,0,1046,104,1150,1150,0,0
46741,2019-12-14,370,0,370,29,399,399,0,0
46742,2019-12-14,491,0,491,39,530,0,530,0
46743,2019-12-14,464,0,464,37,501,501,0,0
46744,2019-12-14,539,0,539,43,582,582,0,0
46745,2019-12-14,817,0,817,65,882,882,0,0
46746,2019-12-14,1076,0,1076,86,1162,0,1162,0
46747,2019-12-15,464,0,464,37,501,501,0,0
46748,2019-12-15,483,0,483,38,521,0,521,0
46749,2019-12-15,381,0,381,30,411,411,0,0
46750,2019-12-15,825,0,825,66,891,0,891,0
46751,2019-12-15,371,0,371,29,400,400,0,0
46752,2019-12-15,315,0,315,25,340,340,0,0
46753,2019-12-15,501,0,501,40,541,0,541,0
46754,2019-12-15,864,0,864,69,933,933,0,0
46755,2019-12-15,390,0,390,31,421,421,0,0
46756,2019-12-15,1597,0,1597,127,1724,1724,0,0
46757,2019-12-15,334,0,334,26,360,360,0,0
46758,2019-12-15,464,0,464,37,501,501,0,0
46759,2019-12-15,334,0,334,26,360,360,0,0
46760,2019-12-15,891,-89,802,80,882,882,0,0
46761,2019-12-15,658,0,658,65,723,723,0,0
46762,2019-12-15,548,0,548,54,602,602,0,0
46763,2019-12-15,492,0,492,39,531,531,0,0
46764,2019-12-15,-891,169,-722,-72,-794,-794,0,0
46765,2019-12-15,891,0,891,89,980,980,0,0
46766,2019-12-15,808,0,808,64,872,872,0,0
46767,2019-12-15,1188,0,1188,95,1283,1283,0,0
46768,2019-12-15,372,0,372,29,401,401,0,0
46769,2019-12-15,891,-89,802,80,882,882,0,0
46770,2019-12-15,891,-89,802,80,882,882,0,0
46771,2019-12-15,891,-169,722,72,794,794,0,0
46772,2019-12-15,751,0,751,60,811,811,0,0
46773,2019-12-15,1109,0,1109,88,1197,1197,0,0
46774,2019-12-15,528,0,528,42,570,570,0,0
46775,2019-12-15,628,0,628,62,690,690,0,0
46776,2019-12-15,520,0,520,41,561,561,0,0
46777,2019-12-15,1346,0,1346,107,1453,1453,0,0
46778,2019-12-15,1289,0,1289,103,1392,1392,0,0
46779,2019-12-15,593,0,593,47,640,0,0,640
46780,2019-12-15,547,0,547,43,590,590,0,0
46781,2019-12-15,538,0,538,43,581,581,0,0
46782,2019-12-15,464,0,464,37,501,501,0,0
46783,2019-12-15,825,0,825,82,907,907,0,0
46784,2019-12-15,658,0,658,65,723,723,0,0
46785,2019-12-15,436,0,436,34,470,470,0,0
46786,2019-12-15,446,0,446,35,481,481,0,0
46787,2019-12-15,1340,0,1340,107,1447,1447,0,0
46788,2019-12-15,967,0,967,77,1044,0,1044,0
46789,2019-12-15,616,0,616,49,665,665,0,0
46790,2019-12-15,112,0,112,8,120,120,0,0
46791,2019-12-15,1782,-178,1604,160,1764,0,0,1764
46792,2019-12-15,1782,0,1782,178,1960,1960,0,0
46793,2019-12-15,381,0,381,30,411,411,0,0
46794,2019-12-15,566,0,566,45,611,611,0,0
46795,2019-12-15,251,0,251,20,271,271,0,0
46796,2019-12-15,399,0,399,31,430,430,0,0
46797,2019-12-15,418,0,418,33,451,451,0,0
46798,2019-12-15,576,0,576,46,622,622,0,0
46799,2019-12-15,269,-53,216,17,233,233,0,0
46800,2019-12-15,2059,0,2059,164,2223,2223,0,0
46801,2019-12-15,640,0,640,51,691,691,0,0
46802,2019-12-15,751,0,751,60,811,811,0,0
46803,2019-12-15,176,0,176,14,190,0,190,0
46804,2019-12-15,556,0,556,44,600,600,0,0
46805,2019-12-15,650,0,650,52,702,702,0,0
46806,2019-12-15,1782,0,1782,178,1960,1960,0,0
46807,2019-12-15,1782,0,1782,178,1960,0,0,1960
46808,2019-12-15,1819,0,1819,145,1964,1964,0,0
46809,2019-12-15,769,0,769,76,845,845,0,0
46810,2019-12-15,740,0,740,74,814,814,0,0
46811,2019-12-15,250,0,250,20,270,0,270,0
46812,2019-12-15,400,0,400,32,432,432,0,0
46813,2019-12-15,1546,0,1546,154,1700,1700,0,0
46814,2019-12-15,353,0,353,28,381,381,0,0
46815,2019-12-15,2316,-463,1853,148,2001,2001,0,0
46816,2019-12-15,232,0,232,18,250,250,0,0
46817,2019-12-15,233,0,233,18,251,251,0,0
46818,2019-12-15,214,0,214,17,231,231,0,0
46819,2019-12-15,1528,0,1528,152,1680,1680,0,0
46820,2019-12-15,976,0,976,78,1054,1054,0,0
46821,2019-12-15,482,0,482,48,530,530,0,0
46822,2019-12-15,1686,0,1686,168,1854,0,0,1854
46823,2019-12-15,708,0,708,56,764,764,0,0
46824,2019-12-15,362,0,362,28,390,390,0,0
46825,2019-12-15,538,0,538,43,581,581,0,0
46826,2019-12-15,362,0,362,28,390,0,390,0
46827,2019-12-15,1993,0,1993,199,2192,2192,0,0
46828,2019-12-15,242,0,242,19,261,261,0,0
46829,2019-12-15,696,0,696,55,751,751,0,0
46830,2019-12-15,334,0,334,33,367,367,0,0
46831,2019-12-15,484,0,484,38,522,522,0,0
46832,2019-12-15,363,0,363,29,392,392,0,0
46833,2019-12-15,1048,0,1048,83,1131,1131,0,0
46834,2019-12-15,1852,0,1852,185,2037,2037,0,0
46835,2019-12-15,568,0,568,45,613,613,0,0
46836,2019-12-15,891,0,891,89,980,980,0,0
46837,2019-12-15,1059,0,1059,84,1143,1143,0,0
46838,2019-12-15,927,0,927,74,1001,1001,0,0
46839,2019-12-15,593,0,593,59,652,652,0,0
46840,2019-12-15,723,0,723,72,795,795,0,0
46841,2019-12-15,620,0,620,62,682,682,0,0
46842,2019-12-15,447,0,447,35,482,0,482,0
46843,2019-12-15,250,0,250,25,275,275,0,0
46844,2019-12-15,446,0,446,35,481,481,0,0
46845,2019-12-15,574,0,574,57,631,631,0,0
46846,2019-12-15,834,0,834,83,917,917,0,0
46847,2019-12-15,916,0,916,91,1007,0,1007,0
46848,2019-12-15,1548,0,1548,154,1702,1702,0,0
46849,2019-12-15,473,0,473,37,510,510,0,0
46850,2019-12-15,445,0,445,35,480,480,0,0
46851,2019-12-15,288,0,288,23,311,311,0,0
46852,2019-12-15,846,0,846,67,913,913,0,0
46853,2019-12-15,510,0,510,40,550,550,0,0
46854,2019-12-15,1283,0,1283,102,1385,1385,0,0
46855,2019-12-15,336,0,336,26,362,362,0,0
46856,2019-12-15,176,0,176,14,190,190,0,0
46857,2019-12-15,528,0,528,42,570,0,0,570
46858,2019-12-15,779,0,779,62,841,841,0,0
46859,2019-12-15,409,0,409,32,441,0,441,0
46860,2019-12-15,381,0,381,30,411,0,411,0
46861,2019-12-15,604,0,604,48,652,652,0,0
46862,2019-12-15,773,0,773,77,850,850,0,0
46863,2019-12-15,1076,0,1076,86,1162,1162,0,0
46864,2019-12-15,2355,0,2355,188,2543,2543,0,0
46865,2019-12-15,2092,0,2092,209,2301,2301,0,0
46866,2019-12-15,1658,0,1658,165,1823,0,1823,0
46867,2019-12-15,1039,0,1039,83,1122,1122,0,0
46868,2019-12-15,773,0,773,77,850,850,0,0
46869,2019-12-15,297,0,297,23,320,0,0,320
46870,2019-12-15,280,0,280,28,308,308,0,0
46871,2019-12-15,874,0,874,69,943,943,0,0
46872,2019-12-15,455,0,455,36,491,491,0,0
46873,2019-12-15,1600,0,1600,128,1728,1728,0,0
46874,2019-12-15,1075,-107,968,77,1045,1045,0,0
46875,2019-12-15,1011,0,1011,101,1112,1112,0,0
46876,2019-12-15,773,0,773,77,850,850,0,0
46877,2019-12-16,510,0,510,40,550,550,0,0
46878,2019-12-16,269,0,269,21,290,290,0,0
46879,2019-12-16,1174,0,1174,117,1291,1291,0,0
46880,2019-12-16,628,0,628,62,690,690,0,0
46881,2019-12-16,2557,0,2557,204,2761,2761,0,0
46882,2019-12-16,1496,0,1496,119,1615,0,0,1615
46883,2019-12-16,1456,0,1456,116,1572,1572,0,0
46884,2019-12-16,3564,0,3564,356,3920,3920,0,0
46885,2019-12-16,1782,0,1782,178,1960,1960,0,0
46886,2019-12-16,2221,0,2221,177,2398,2398,0,0
46887,2019-12-16,494,0,494,39,533,533,0,0
46888,2019-12-16,594,0,594,47,641,641,0,0
46889,2019-12-16,93,0,93,7,100,0,0,100
46890,2019-12-16,678,0,678,54,732,732,0,0
46891,2019-12-16,260,0,260,20,280,280,0,0
46892,2019-12-16,891,0,891,89,980,980,0,0
46893,2019-12-16,753,0,753,60,813,813,0,0
46894,2019-12-16,401,0,401,32,433,433,0,0
46895,2019-12-16,575,0,575,46,621,621,0,0
46896,2019-12-16,464,0,464,37,501,0,0,501
46897,2019-12-16,176,0,176,17,193,0,0,193
46898,2019-12-16,918,0,918,73,991,991,0,0
46899,2019-12-16,1132,0,1132,90,1222,1222,0,0
46900,2019-12-16,631,0,631,50,681,681,0,0
46901,2019-12-16,1782,0,1782,178,1960,1960,0,0
46902,2019-12-16,334,0,334,33,367,367,0,0
46903,2019-12-16,501,0,501,50,551,551,0,0
46904,2019-12-16,845,0,845,67,912,912,0,0
46905,2019-12-16,371,0,371,29,400,400,0,0
46906,2019-12-16,780,0,780,62,842,842,0,0
46907,2019-12-16,752,-75,677,54,731,731,0,0
46908,2019-12-16,816,0,816,65,881,881,0,0
46909,2019-12-16,334,0,334,26,360,360,0,0
46910,2019-12-16,891,0,891,89,980,980,0,0
46911,2019-12-16,306,0,306,24,330,330,0,0
46912,2019-12-16,808,0,808,64,872,872,0,0
46913,2019-12-16,501,0,501,40,541,541,0,0
46914,2019-12-16,1231,0,1231,123,1354,1354,0,0
46915,2019-12-16,507,0,507,40,547,547,0,0
46916,2019-12-16,389,0,389,38,427,427,0,0
46917,2019-12-16,621,0,621,49,670,670,0,0
46918,2019-12-16,723,0,723,72,795,795,0,0
46919,2019-12-16,102,0,102,28,130,130,0,0
46920,2019-12-16,-111,0,-111,-27,-138,-138,0,0
46921,2019-12-16,111,0,111,27,138,138,0,0
46922,2019-12-16,519,0,519,51,570,570,0,0
46923,2019-12-16,891,0,891,89,980,980,0,0
46924,2019-12-16,4455,0,4455,445,4900,4900,0,0
46925,2019-12-16,380,0,380,30,410,410,0,0
46926,2019-12-16,2139,0,2139,213,2352,2352,0,0
46927,2019-12-16,176,0,176,14,190,190,0,0
46928,2019-12-16,891,0,891,89,980,980,0,0
46929,2019-12-16,1095,0,1095,87,1182,1182,0,0
46930,2019-12-16,1288,0,1288,128,1416,1416,0,0
46931,2019-12-16,743,0,743,59,802,802,0,0
46932,2019-12-16,325,0,325,26,351,351,0,0
46933,2019-12-16,576,0,576,46,622,622,0,0
46934,2019-12-16,269,0,269,21,290,290,0,0
46935,2019-12-16,167,0,167,13,180,180,0,0
46936,2019-12-16,269,0,269,21,290,290,0,0
46937,2019-12-16,251,0,251,20,271,271,0,0
46938,2019-12-16,863,0,863,69,932,932,0,0
46939,2019-12-16,613,0,613,49,662,662,0,0
46940,2019-12-16,779,0,779,62,841,841,0,0
46941,2019-12-16,898,0,898,89,987,987,0,0
46942,2019-12-16,121,0,121,9,130,130,0,0
46943,2019-12-16,309,0,309,24,333,333,0,0
46944,2019-12-16,158,0,158,12,170,170,0,0
46945,2019-12-16,808,0,808,64,872,872,0,0
46946,2019-12-16,743,0,743,59,802,802,0,0
46947,2019-12-16,491,0,491,39,530,530,0,0
46948,2019-12-16,510,0,510,40,550,550,0,0
46949,2019-12-16,807,0,807,64,871,871,0,0
46950,2019-12-16,900,0,900,72,972,972,0,0
46951,2019-12-16,260,0,260,20,280,280,0,0
46952,2019-12-16,436,0,436,34,470,470,0,0
46953,2019-12-16,891,0,891,89,980,980,0,0
46954,2019-12-16,1128,0,1128,90,1218,1218,0,0
46955,2019-12-16,2509,0,2509,250,2759,2759,0,0
46956,2019-12-16,807,0,807,64,871,0,0,871
46957,2019-12-16,779,0,779,62,841,841,0,0
46958,2019-12-16,650,-65,585,46,631,631,0,0
46959,2019-12-16,343,0,343,34,377,377,0,0
46960,2019-12-16,890,0,890,71,961,961,0,0
46961,2019-12-16,891,0,891,89,980,980,0,0
46962,2019-12-16,891,0,891,89,980,980,0,0
46963,2019-12-16,362,0,362,28,390,390,0,0
46964,2019-12-16,334,0,334,26,360,360,0,0
46965,2019-12-16,891,0,891,89,980,0,0,980
46966,2019-12-16,473,0,473,37,510,510,0,0
46967,2019-12-16,409,0,409,40,449,449,0,0
46968,2019-12-16,676,0,676,67,743,743,0,0
46969,2019-12-16,334,0,334,26,360,360,0,0
46970,2019-12-16,1280,0,1280,102,1382,1382,0,0
46971,2019-12-16,234,0,234,18,252,252,0,0
46972,2019-12-16,234,0,234,18,252,252,0,0
46973,2019-12-16,308,0,308,24,332,332,0,0
46974,2019-12-16,290,0,290,23,313,313,0,0
46975,2019-12-16,278,0,278,22,300,300,0,0
46976,2019-12-16,345,0,345,27,372,372,0,0
46977,2019-12-16,705,0,705,56,761,761,0,0
46978,2019-12-16,417,0,417,41,458,458,0,0
46979,2019-12-16,929,0,929,74,1003,1003,0,0
46980,2019-12-16,798,0,798,63,861,861,0,0
46981,2019-12-16,12167,-28,12139,971,13110,13110,0,0
46982,2019-12-17,798,0,798,63,861,861,0,0
46983,2019-12-17,316,0,316,25,341,0,341,0
46984,2019-12-17,520,0,520,41,561,561,0,0
46985,2019-12-17,181,0,181,14,195,195,0,0
46986,2019-12-17,854,0,854,68,922,922,0,0
46987,2019-12-17,-854,0,-854,-68,-922,-922,0,0
46988,2019-12-17,622,-62,560,44,604,0,604,0
46989,2019-12-17,722,0,722,72,794,794,0,0
46990,2019-12-17,612,0,612,48,660,660,0,0
46991,2019-12-17,269,0,269,21,290,290,0,0
46992,2019-12-17,501,0,501,40,541,541,0,0
46993,2019-12-17,612,0,612,48,660,0,0,660
46994,2019-12-17,705,0,705,56,761,761,0,0
46995,2019-12-17,519,0,519,51,570,0,570,0
46996,2019-12-17,282,0,282,22,304,304,0,0
46997,2019-12-17,1040,0,1040,83,1123,0,0,1123
46998,2019-12-17,538,0,538,43,581,0,581,0
46999,2019-12-17,242,0,242,19,261,261,0,0
47000,2019-12-17,446,0,446,35,481,0,481,0
47001,2019-12-18,260,0,260,20,280,0,280,0
47002,2019-12-18,139,0,139,11,150,150,0,0
47003,2019-12-18,316,0,316,25,341,341,0,0
47004,2019-12-18,417,0,417,33,450,0,0,450
47005,2019-12-18,1345,0,1345,107,1452,0,1452,0
47006,2019-12-18,715,0,715,57,772,772,0,0
47007,2019-12-18,399,0,399,31,430,0,430,0
47008,2019-12-18,372,-37,335,26,361,361,0,0
47009,2019-12-18,628,0,628,62,690,0,690,0
47010,2019-12-18,1782,0,1782,178,1960,1960,0,0
47011,2019-12-18,1871,0,1871,187,2058,2058,0,0
47012,2019-12-18,223,0,223,17,240,240,0,0
47013,2019-12-18,917,0,917,91,1008,1008,0,0
47014,2019-12-18,677,0,677,54,731,731,0,0
47015,2019-12-18,891,0,891,89,980,0,980,0
47016,2019-12-18,520,0,520,41,561,561,0,0
47017,2019-12-18,1782,0,1782,178,1960,1960,0,0
47018,2019-12-18,343,0,343,27,370,370,0,0
47019,2019-12-18,891,0,891,89,980,980,0,0
47020,2019-12-18,705,0,705,56,761,761,0,0
47021,2019-12-18,891,0,891,89,980,980,0,0
47022,2019-12-18,334,0,334,26,360,360,0,0
47023,2019-12-18,390,0,390,31,421,421,0,0
47024,2019-12-18,817,0,817,65,882,882,0,0
47025,2019-12-18,640,0,640,64,704,704,0,0
47026,2019-12-18,1215,0,1215,121,1336,1336,0,0
47027,2019-12-18,546,-109,437,43,480,480,0,0
47028,2019-12-18,176,0,176,14,190,190,0,0
47029,2019-12-18,1133,0,1133,90,1223,1223,0,0
47030,2019-12-18,334,0,334,26,360,360,0,0
47031,2019-12-18,956,0,956,76,1032,1032,0,0
47032,2019-12-18,1998,0,1998,348,2346,2346,0,0
47033,2019-12-18,167,0,167,13,180,180,0,0
47034,2019-12-18,465,0,465,37,502,502,0,0
47035,2019-12-18,344,-34,310,24,334,334,0,0
47036,2019-12-18,859,0,859,68,927,0,0,927
47037,2019-12-18,1021,0,1021,81,1102,1102,0,0
47038,2019-12-18,167,0,167,13,180,180,0,0
47039,2019-12-18,519,0,519,51,570,570,0,0
47040,2019-12-18,260,0,260,20,280,280,0,0
47041,2019-12-18,780,0,780,62,842,842,0,0
47042,2019-12-18,512,0,512,40,552,552,0,0
47043,2019-12-18,437,0,437,34,471,0,471,0
47044,2019-12-18,454,0,454,36,490,490,0,0
47045,2019-12-18,335,0,335,26,361,361,0,0
47046,2019-12-18,279,0,279,22,301,301,0,0
47047,2019-12-18,528,0,528,52,580,580,0,0
47048,2019-12-18,520,0,520,41,561,561,0,0
47049,2019-12-18,789,0,789,63,852,852,0,0
47050,2019-12-18,2779,0,2779,222,3001,3001,0,0
47051,2019-12-18,223,0,223,17,240,240,0,0
47052,2019-12-18,1616,0,1616,129,1745,0,0,1745
47053,2019-12-18,445,0,445,35,480,480,0,0
47054,2019-12-18,427,0,427,34,461,461,0,0
47055,2019-12-18,650,0,650,52,702,702,0,0
47056,2019-12-18,918,0,918,91,1009,1009,0,0
47057,2019-12-18,520,0,520,41,561,561,0,0
47058,2019-12-18,520,0,520,41,561,561,0,0
47059,2019-12-18,436,0,436,34,470,470,0,0
47060,2019-12-18,269,0,269,21,290,290,0,0
47061,2019-12-18,1235,0,1235,98,1333,1333,0,0
47062,2019-12-18,834,0,834,83,917,917,0,0
47063,2019-12-18,417,0,417,33,450,450,0,0
47064,2019-12-18,844,0,844,67,911,911,0,0
47065,2019-12-18,353,0,353,28,381,381,0,0
47066,2019-12-18,640,0,640,51,691,691,0,0
47067,2019-12-18,469,0,469,37,506,506,0,0
47068,2019-12-18,828,0,828,66,894,894,0,0
47069,2019-12-18,773,0,773,77,850,850,0,0
47070,2019-12-18,306,0,306,24,330,330,0,0
47071,2019-12-18,1546,-154,1392,139,1531,1531,0,0
47072,2019-12-18,695,0,695,55,750,750,0,0
47073,2019-12-18,371,0,371,29,400,400,0,0
47074,2019-12-18,141,0,141,11,152,152,0,0
47075,2019-12-18,751,0,751,60,811,811,0,0
47076,2019-12-18,167,0,167,13,180,180,0,0
47077,2019-12-18,-389,0,-389,-38,-427,-427,0,0
47078,2019-12-18,741,0,741,59,800,800,0,0
47079,2019-12-18,343,0,343,27,370,370,0,0
47080,2019-12-18,658,0,658,65,723,723,0,0
47081,2019-12-18,778,0,778,77,855,855,0,0
47082,2019-12-18,447,0,447,35,482,482,0,0
47083,2019-12-18,1546,0,1546,154,1700,1700,0,0
47084,2019-12-18,835,0,835,66,901,901,0,0
47085,2019-12-18,773,0,773,77,850,850,0,0
47086,2019-12-18,773,0,773,77,850,850,0,0
47087,2019-12-18,1260,0,1260,126,1386,1386,0,0
47088,2019-12-18,773,0,773,77,850,0,850,0
47089,2019-12-18,891,-178,713,71,784,784,0,0
47090,2019-12-18,343,0,343,27,370,370,0,0
47091,2019-12-18,565,0,565,45,610,610,0,0
47092,2019-12-18,1066,0,1066,85,1151,1151,0,0
47093,2019-12-18,773,0,773,77,850,0,0,850
47094,2019-12-18,761,0,761,60,821,821,0,0
47095,2019-12-18,1808,0,1808,180,1988,1988,0,0
47096,2019-12-18,167,0,167,13,180,180,0,0
47097,2019-12-18,278,0,278,22,300,0,300,0
47098,2019-12-18,891,0,891,89,980,980,0,0
47099,2019-12-18,520,0,520,41,561,561,0,0
47100,2019-12-18,650,0,650,52,702,702,0,0
47101,2019-12-18,521,0,521,41,562,562,0,0
47102,2019-12-18,716,0,716,71,787,787,0,0
47103,2019-12-18,354,0,354,28,382,382,0,0
47104,2019-12-18,1323,0,1323,105,1428,1428,0,0
47105,2019-12-18,677,0,677,54,731,731,0,0
47106,2019-12-18,445,0,445,35,480,480,0,0
47107,2019-12-18,1180,0,1180,94,1274,1274,0,0
47108,2019-12-18,769,0,769,76,845,845,0,0
47109,2019-12-18,423,0,423,33,456,456,0,0
47110,2019-12-18,1408,0,1408,112,1520,1520,0,0
47111,2019-12-18,446,0,446,35,481,481,0,0
47112,2019-12-18,984,0,984,78,1062,1062,0,0
47113,2019-12-18,853,0,853,68,921,921,0,0
47114,2019-12-18,167,0,167,13,180,180,0,0
47115,2019-12-18,519,0,519,41,560,560,0,0
47116,2019-12-18,139,0,139,11,150,150,0,0
47117,2019-12-18,334,0,334,26,360,360,0,0
47118,2019-12-18,773,-154,619,61,680,680,0,0
47119,2019-12-18,576,0,576,46,622,622,0,0
47120,2019-12-18,500,0,500,40,540,540,0,0
47121,2019-12-18,1438,-143,1295,103,1398,1398,0,0
47122,2019-12-18,863,0,863,69,932,932,0,0
47123,2019-12-19,909,-909,0,0,0,0,0,0
47124,2019-12-19,482,0,482,38,520,520,0,0
47125,2019-12-19,232,0,232,18,250,250,0,0
47126,2019-12-19,2417,0,2417,193,2610,2610,0,0
47127,2019-12-19,667,0,667,66,733,733,0,0
47128,2019-12-19,927,0,927,74,1001,1001,0,0
47129,2019-12-19,176,0,176,14,190,190,0,0
47130,2019-12-19,585,-58,527,42,569,569,0,0
47131,2019-12-19,1782,0,1782,178,1960,1960,0,0
47132,2019-12-19,279,-27,252,20,272,272,0,0
47133,2019-12-19,687,0,687,54,741,741,0,0
47134,2019-12-19,686,0,686,68,754,754,0,0
47135,2019-12-19,408,0,408,32,440,440,0,0
47136,2019-12-19,752,0,752,60,812,812,0,0
47137,2019-12-19,2003,0,2003,160,2163,0,2163,0
47138,2019-12-19,436,0,436,34,470,0,0,470
47139,2019-12-19,891,0,891,89,980,0,0,980
47140,2019-12-19,520,0,520,52,572,572,0,0
47141,2019-12-19,343,0,343,27,370,370,0,0
47142,2019-12-19,297,0,297,23,320,320,0,0
47143,2019-12-19,649,0,649,64,713,713,0,0
47144,2019-12-19,1067,0,1067,85,1152,1152,0,0
47145,2019-12-19,974,0,974,77,1051,1051,0,0
47146,2019-12-19,1096,0,1096,109,1205,0,0,1205
47147,2019-12-19,612,0,612,48,660,660,0,0
47148,2019-12-19,891,0,891,89,980,980,0,0
47149,2019-12-19,631,0,631,50,681,681,0,0
47150,2019-12-19,176,0,176,14,190,0,0,190
47151,2019-12-19,417,0,417,33,450,450,0,0
47152,2019-12-19,593,0,593,59,652,652,0,0
47153,2019-12-19,278,0,278,22,300,300,0,0
47154,2019-12-19,261,0,261,20,281,281,0,0
47155,2019-12-19,334,0,334,26,360,360,0,0
47156,2019-12-19,1329,-1000,329,26,355,355,0,0
47157,2019-12-19,167,0,167,13,180,180,0,0
47158,2019-12-19,389,0,389,31,420,420,0,0
47159,2019-12-19,642,0,642,51,693,693,0,0
47160,2019-12-19,557,0,557,44,601,601,0,0
47161,2019-12-19,968,0,968,77,1045,1045,0,0
47162,2019-12-19,891,0,891,89,980,980,0,0
47163,2019-12-19,465,0,465,37,502,0,0,502
47164,2019-12-19,492,-492,0,0,0,0,0,0
47165,2019-12-19,1334,0,1334,106,1440,1440,0,0
47166,2019-12-19,501,0,501,40,541,541,0,0
47167,2019-12-19,789,0,789,63,852,852,0,0
47168,2019-12-19,436,0,436,34,470,470,0,0
47169,2019-12-19,993,0,993,79,1072,1072,0,0
47170,2019-12-19,307,-61,246,19,265,265,0,0
47171,2019-12-19,696,0,696,55,751,751,0,0
47172,2019-12-19,334,0,334,26,360,360,0,0
47173,2019-12-19,334,0,334,26,360,360,0,0
47174,2019-12-19,260,0,260,20,280,0,0,280
47175,2019-12-19,1002,0,1002,80,1082,1082,0,0
47176,2019-12-19,522,0,522,41,563,563,0,0
47177,2019-12-19,306,0,306,24,330,330,0,0
47178,2019-12-19,659,0,659,52,711,711,0,0
47179,2019-12-19,1168,0,1168,116,1284,1284,0,0
47180,2019-12-19,918,0,918,73,991,991,0,0
47181,2019-12-19,245,0,245,62,307,307,0,0
47182,2019-12-19,232,0,232,18,250,250,0,0
47183,2019-12-19,329,0,329,26,355,355,0,0
47184,2019-12-19,370,0,370,37,407,407,0,0
47185,2019-12-19,1546,0,1546,154,1700,1700,0,0
47186,2019-12-19,2285,0,2285,228,2513,0,2513,0
47187,2019-12-19,510,0,510,40,550,550,0,0
47188,2019-12-19,417,0,417,41,458,458,0,0
47189,2019-12-19,1464,0,1464,146,1610,0,1610,0
47190,2019-12-19,1169,0,1169,93,1262,1262,0,0
47191,2019-12-19,773,0,773,77,850,850,0,0
47192,2019-12-19,547,0,547,43,590,590,0,0
47193,2019-12-19,1546,0,1546,154,1700,1700,0,0
47194,2019-12-19,-130,0,-130,-10,-140,-140,0,0
47195,2019-12-19,946,0,946,75,1021,1021,0,0
47196,2019-12-19,130,0,130,10,140,140,0,0
47197,2019-12-19,298,0,298,23,321,321,0,0
47198,2019-12-19,269,0,269,21,290,290,0,0
47199,2019-12-19,855,0,855,68,923,923,0,0
47200,2019-12-19,1058,0,1058,84,1142,1142,0,0
47201,2019-12-19,501,0,501,40,541,541,0,0
47202,2019-12-19,447,0,447,35,482,482,0,0
47203,2019-12-19,278,0,278,22,300,300,0,0
47204,2019-12-19,1428,0,1428,142,1570,0,1570,0
47205,2019-12-19,1465,0,1465,117,1582,0,1582,0
47206,2019-12-19,817,0,817,65,882,0,882,0
47207,2019-12-19,149,0,149,11,160,160,0,0
47208,2019-12-19,1866,0,1866,149,2015,2015,0,0
47209,2019-12-19,2316,-463,1853,148,2001,2001,0,0
47210,2019-12-19,1546,0,1546,154,1700,1700,0,0
47211,2019-12-19,956,0,956,76,1032,1032,0,0
47212,2019-12-19,1133,0,1133,90,1223,1223,0,0
47213,2019-12-19,1153,0,1153,92,1245,1245,0,0
47214,2019-12-19,705,0,705,56,761,761,0,0
47215,2019-12-19,891,0,891,89,980,0,0,980
47216,2019-12-19,1317,0,1317,105,1422,1422,0,0
47217,2019-12-19,891,0,891,89,980,980,0,0
47218,2019-12-19,529,0,529,42,571,571,0,0
47219,2019-12-19,827,0,827,66,893,893,0,0
47220,2019-12-19,2316,0,2316,185,2501,2501,0,0
47221,2019-12-19,1354,0,1354,108,1462,1462,0,0
47222,2019-12-19,538,-53,485,38,523,523,0,0
47223,2019-12-19,1122,0,1122,112,1234,1234,0,0
47224,2019-12-19,533,0,533,42,575,575,0,0
47225,2019-12-19,306,0,306,30,336,336,0,0
47226,2019-12-19,1755,0,1755,140,1895,1895,0,0
47227,2019-12-19,788,0,788,78,866,866,0,0
47228,2019-12-19,773,0,773,77,850,850,0,0
47229,2019-12-19,1132,-113,1019,81,1100,1100,0,0
47230,2019-12-19,799,0,799,63,862,0,862,0
47231,2019-12-19,807,0,807,64,871,871,0,0
47232,2019-12-19,706,0,706,56,762,762,0,0
47233,2019-12-19,773,0,773,77,850,850,0,0
47234,2019-12-19,242,0,242,19,261,261,0,0
47235,2019-12-19,269,0,269,21,290,290,0,0
47236,2019-12-19,773,0,773,77,850,850,0,0
47237,2019-12-19,297,0,297,29,326,326,0,0
47238,2019-12-19,353,0,353,28,381,381,0,0
47239,2019-12-19,80,0,80,20,100,100,0,0
47240,2019-12-19,773,0,773,77,850,850,0,0
47241,2019-12-20,1971,0,1971,197,2168,2168,0,0
47242,2019-12-20,1123,0,1123,89,1212,1212,0,0
47243,2019-12-20,602,0,602,48,650,650,0,0
47244,2019-12-20,1484,0,1484,118,1602,1602,0,0
47245,2019-12-20,232,0,232,18,250,250,0,0
47246,2019-12-20,872,0,872,69,941,941,0,0
47247,2019-12-20,1782,0,1782,178,1960,1960,0,0
47248,2019-12-20,808,0,808,64,872,872,0,0
47249,2019-12-20,827,0,827,66,893,893,0,0
47250,2019-12-20,2107,-210,1897,151,2048,2048,0,0
47251,2019-12-20,1974,0,1974,197,2171,2171,0,0
47252,2019-12-20,1782,0,1782,178,1960,1960,0,0
47253,2019-12-20,2402,0,2402,192,2594,2594,0,0
47254,2019-12-20,445,0,445,35,480,480,0,0
47255,2019-12-20,2105,0,2105,168,2273,2273,0,0
47256,2019-12-20,381,0,381,30,411,411,0,0
47257,2019-12-20,928,0,928,74,1002,1002,0,0
47258,2019-12-20,891,0,891,89,980,0,0,980
47259,2019-12-20,1546,0,1546,154,1700,1700,0,0
47260,2019-12-20,371,0,371,29,400,400,0,0
47261,2019-12-20,520,0,520,41,561,561,0,0
47262,2019-12-20,1119,0,1119,111,1230,1230,0,0
47263,2019-12-20,2414,0,2414,193,2607,2607,0,0
47264,2019-12-20,1541,0,1541,123,1664,1664,0,0
47265,2019-12-20,891,0,891,89,980,980,0,0
47266,2019-12-20,325,0,325,26,351,351,0,0
47267,2019-12-20,1020,0,1020,81,1101,1101,0,0
47268,2019-12-20,1140,0,1140,91,1231,1231,0,0
47269,2019-12-20,946,0,946,75,1021,0,1021,0
47270,2019-12-20,316,0,316,25,341,0,0,341
47271,2019-12-20,1344,0,1344,107,1451,1451,0,0
47272,2019-12-20,1279,0,1279,109,1388,0,1388,0
47273,2019-12-20,429,0,429,34,463,463,0,0
47274,2019-12-20,1431,0,1431,114,1545,1545,0,0
47275,2019-12-20,1884,0,1884,188,2072,2072,0,0
47276,2019-12-20,2151,0,2151,172,2323,0,2323,0
47277,2019-12-20,2282,0,2282,182,2464,2464,0,0
47278,2019-12-20,742,0,742,59,801,801,0,0
47279,2019-12-20,204,0,204,16,220,220,0,0
47280,2019-12-20,557,0,557,55,612,612,0,0
47281,2019-12-20,547,0,547,54,601,601,0,0
47282,2019-12-20,427,0,427,34,461,461,0,0
47283,2019-12-20,362,0,362,28,390,390,0,0
47284,2019-12-20,891,0,891,89,980,980,0,0
47285,2019-12-20,705,0,705,56,761,761,0,0
47286,2019-12-20,520,0,520,41,561,561,0,0
47287,2019-12-20,725,0,725,58,783,783,0,0
47288,2019-12-20,1513,0,1513,121,1634,1634,0,0
47289,2019-12-20,2851,0,2851,228,3079,3079,0,0
47290,2019-12-20,584,0,584,58,642,642,0,0
47291,2019-12-20,687,0,687,54,741,0,0,741
47292,2019-12-20,232,0,232,18,250,250,0,0
47293,2019-12-20,1178,0,1178,117,1295,1295,0,0
47294,2019-12-20,352,0,352,35,387,387,0,0
47295,2019-12-20,501,0,501,50,551,551,0,0
47296,2019-12-20,1290,0,1290,103,1393,1393,0,0
47297,2019-12-20,1782,0,1782,178,1960,1960,0,0
47298,2019-12-20,651,0,651,52,703,703,0,0
47299,2019-12-20,483,0,483,48,531,531,0,0
47300,2019-12-20,724,0,724,57,781,781,0,0
47301,2019-12-20,1523,0,1523,121,1644,1644,0,0
47302,2019-12-20,745,0,745,59,804,804,0,0
47303,2019-12-20,1782,0,1782,178,1960,1960,0,0
47304,2019-12-20,891,0,891,89,980,980,0,0
47305,2019-12-20,1782,0,1782,178,1960,1960,0,0
47306,2019-12-20,1782,0,1782,178,1960,1960,0,0
47307,2019-12-20,1084,0,1084,108,1192,1192,0,0
47308,2019-12-20,436,0,436,34,470,470,0,0
47309,2019-12-20,464,0,464,37,501,501,0,0
47310,2019-12-20,343,0,343,27,370,0,370,0
47311,2019-12-20,650,0,650,52,702,702,0,0
47312,2019-12-20,1327,0,1327,106,1433,1433,0,0
47313,2019-12-20,916,0,916,91,1007,1007,0,0
47314,2019-12-20,898,0,898,89,987,987,0,0
47315,2019-12-20,279,0,279,27,306,306,0,0
47316,2019-12-20,1095,0,1095,87,1182,0,1182,0
47317,2019-12-20,836,0,836,66,902,902,0,0
47318,2019-12-20,149,0,149,11,160,160,0,0
47319,2019-12-20,1244,0,1244,99,1343,1343,0,0
47320,2019-12-20,343,0,343,27,370,370,0,0
47321,2019-12-20,121,0,121,9,130,130,0,0
47322,2019-12-20,343,0,343,27,370,370,0,0
47323,2019-12-20,121,0,121,9,130,130,0,0
47324,2019-12-20,343,0,343,27,370,370,0,0
47325,2019-12-20,343,0,343,27,370,370,0,0
47326,2019-12-20,121,0,121,9,130,130,0,0
47327,2019-12-20,121,0,121,9,130,130,0,0
47328,2019-12-20,343,0,343,27,370,370,0,0
47329,2019-12-20,121,0,121,9,130,130,0,0
47330,2019-12-20,343,0,343,27,370,370,0,0
47331,2019-12-20,343,0,343,27,370,370,0,0
47332,2019-12-20,121,0,121,9,130,130,0,0
47333,2019-12-20,121,0,121,9,130,130,0,0
47334,2019-12-20,121,0,121,9,130,130,0,0
47335,2019-12-20,121,0,121,9,130,130,0,0
47336,2019-12-20,343,0,343,27,370,370,0,0
47337,2019-12-20,121,0,121,9,130,130,0,0
47338,2019-12-20,343,0,343,27,370,370,0,0
47339,2019-12-20,343,0,343,27,370,370,0,0
47340,2019-12-20,825,0,825,66,891,891,0,0
47341,2019-12-20,269,0,269,21,290,290,0,0
47342,2019-12-20,353,0,353,28,381,381,0,0
47343,2019-12-20,465,-46,419,33,452,452,0,0
47344,2019-12-20,251,0,251,20,271,271,0,0
47345,2019-12-20,529,0,529,42,571,0,571,0
47346,2019-12-20,1577,0,1577,126,1703,1703,0,0
47347,2019-12-20,121,0,121,9,130,130,0,0
47348,2019-12-20,288,0,288,28,316,0,0,316
47349,2019-12-20,558,0,558,44,602,602,0,0
47350,2019-12-20,429,0,429,34,463,463,0,0
47351,2019-12-20,466,0,466,37,503,503,0,0
47352,2019-12-20,603,0,603,48,651,651,0,0
47353,2019-12-20,343,0,343,27,370,370,0,0
47354,2019-12-20,121,0,121,9,130,130,0,0
47355,2019-12-20,343,0,343,27,370,370,0,0
47356,2019-12-20,608,0,608,48,656,656,0,0
47357,2019-12-20,121,0,121,9,130,130,0,0
47358,2019-12-20,343,0,343,27,370,370,0,0
47359,2019-12-20,269,0,269,26,295,295,0,0
47360,2019-12-20,1546,-154,1392,139,1531,1531,0,0
47361,2019-12-20,1161,0,1161,92,1253,1253,0,0
47362,2019-12-20,773,-77,696,69,765,765,0,0
47363,2019-12-20,1546,0,1546,154,1700,1700,0,0
47364,2019-12-20,269,0,269,21,290,290,0,0
47365,2019-12-20,2448,0,2448,195,2643,2643,0,0
47366,2019-12-20,740,0,740,74,814,0,814,0
47367,2019-12-20,902,0,902,72,974,974,0,0
47368,2019-12-20,613,0,613,49,662,0,0,662
47369,2019-12-20,1115,0,1115,89,1204,1204,0,0
47370,2019-12-20,269,0,269,21,290,290,0,0
47371,2019-12-20,854,0,854,68,922,0,0,922
47372,2019-12-20,353,0,353,28,381,381,0,0
47373,2019-12-20,697,0,697,55,752,752,0,0
47374,2019-12-20,1577,0,1577,126,1703,1703,0,0
47375,2019-12-20,362,0,362,28,390,390,0,0
47376,2019-12-20,733,0,733,58,791,791,0,0
47377,2019-12-20,473,0,473,37,510,510,0,0
47378,2019-12-20,417,0,417,41,458,0,458,0
47379,2019-12-20,260,0,260,20,280,280,0,0
47380,2019-12-20,390,0,390,31,421,421,0,0
47381,2019-12-20,1204,0,1204,120,1324,1324,0,0
47382,2019-12-20,288,0,288,23,311,311,0,0
47383,2019-12-20,1546,0,1546,154,1700,1700,0,0
47384,2019-12-20,1546,0,1546,154,1700,1700,0,0
47385,2019-12-20,1546,0,1546,154,1700,1700,0,0
47386,2019-12-20,773,0,773,77,850,850,0,0
47387,2019-12-20,1546,0,1546,154,1700,1700,0,0
47388,2019-12-20,773,0,773,77,850,850,0,0
47389,2019-12-20,1912,0,1912,152,2064,2064,0,0
47390,2019-12-20,1546,0,1546,154,1700,1700,0,0
47391,2019-12-20,2327,0,2327,186,2513,0,0,2513
47392,2019-12-20,918,0,918,73,991,991,0,0
47393,2019-12-20,704,0,704,56,760,760,0,0
47394,2019-12-20,3955,0,3955,395,4350,4350,0,0
47395,2019-12-20,593,0,593,47,640,0,0,640
47396,2019-12-20,1546,0,1546,154,1700,0,1700,0
47397,2019-12-21,409,0,409,32,441,441,0,0
47398,2019-12-21,539,0,539,43,582,582,0,0
47399,2019-12-21,771,0,771,61,832,832,0,0
47400,2019-12-21,362,0,362,28,390,390,0,0
47401,2019-12-21,1782,0,1782,178,1960,1960,0,0
47402,2019-12-21,1300,0,1300,130,1430,1430,0,0
47403,2019-12-21,1782,0,1782,178,1960,1960,0,0
47404,2019-12-21,455,0,455,36,491,491,0,0
47405,2019-12-21,2064,0,2064,206,2270,2270,0,0
47406,2019-12-21,2197,0,2197,219,2416,2416,0,0
47407,2019-12-21,1392,0,1392,111,1503,1503,0,0
47408,2019-12-21,1164,0,1164,116,1280,1280,0,0
47409,2019-12-21,640,0,640,51,691,691,0,0
47410,2019-12-21,654,0,654,52,706,706,0,0
47411,2019-12-21,1018,0,1018,101,1119,1119,0,0
47412,2019-12-21,269,0,269,21,290,290,0,0
47413,2019-12-21,446,0,446,35,481,481,0,0
47414,2019-12-21,260,0,260,20,280,280,0,0
47415,2019-12-21,176,0,176,14,190,190,0,0
47416,2019-12-21,890,0,890,71,961,961,0,0
47417,2019-12-21,992,0,992,79,1071,1071,0,0
47418,2019-12-21,167,0,167,13,180,180,0,0
47419,2019-12-21,1002,0,1002,80,1082,1082,0,0
47420,2019-12-21,623,0,623,49,672,672,0,0
47421,2019-12-21,640,0,640,51,691,691,0,0
47422,2019-12-21,520,0,520,41,561,561,0,0
47423,2019-12-21,713,0,713,71,784,784,0,0
47424,2019-12-21,1455,0,1455,145,1600,1600,0,0
47425,2019-12-21,306,0,306,24,330,330,0,0
47426,2019-12-21,752,0,752,60,812,812,0,0
47427,2019-12-21,584,0,584,46,630,630,0,0
47428,2019-12-21,1782,0,1782,178,1960,1960,0,0
47429,2019-12-21,362,-72,290,23,313,313,0,0
47430,2019-12-21,1206,0,1206,96,1302,1302,0,0
47431,2019-12-21,510,0,510,40,550,550,0,0
47432,2019-12-21,928,-928,0,0,0,0,0,0
47433,2019-12-21,278,0,278,22,300,300,0,0
47434,2019-12-21,797,0,797,79,876,876,0,0
47435,2019-12-21,306,0,306,30,336,336,0,0
47436,2019-12-21,1150,0,1150,115,1265,1265,0,0
47437,2019-12-21,473,0,473,37,510,0,0,510
47438,2019-12-21,204,0,204,16,220,220,0,0
47439,2019-12-21,1214,0,1214,121,1335,1335,0,0
47440,2019-12-21,1038,0,1038,103,1141,1141,0,0
47441,2019-12-21,1782,0,1782,178,1960,0,1960,0
47442,2019-12-21,473,0,473,37,510,510,0,0
47443,2019-12-21,409,0,409,32,441,441,0,0
47444,2019-12-21,167,0,167,16,183,183,0,0
47445,2019-12-21,408,0,408,32,440,440,0,0
47446,2019-12-21,1032,0,1032,82,1114,1114,0,0
47447,2019-12-21,491,0,491,49,540,540,0,0
47448,2019-12-21,448,0,448,35,483,483,0,0
47449,2019-12-21,797,0,797,79,876,876,0,0
47450,2019-12-21,603,0,603,60,663,663,0,0
47451,2019-12-21,631,0,631,63,694,694,0,0
47452,2019-12-21,614,0,614,49,663,663,0,0
47453,2019-12-21,927,0,927,74,1001,1001,0,0
47454,2019-12-21,362,0,362,28,390,390,0,0
47455,2019-12-21,1345,0,1345,107,1452,1452,0,0
47456,2019-12-21,316,0,316,31,347,347,0,0
47457,2019-12-21,575,-57,518,41,559,559,0,0
47458,2019-12-21,241,0,241,19,260,260,0,0
47459,2019-12-21,445,0,445,35,480,480,0,0
47460,2019-12-21,1717,0,1717,171,1888,1888,0,0
47461,2019-12-21,603,0,603,48,651,651,0,0
47462,2019-12-21,389,0,389,31,420,420,0,0
47463,2019-12-21,2076,0,2076,166,2242,2242,0,0
47464,2019-12-21,149,0,149,11,160,160,0,0
47465,2019-12-21,484,0,484,38,522,522,0,0
47466,2019-12-21,176,0,176,14,190,0,0,190
47467,2019-12-21,696,0,696,55,751,751,0,0
47468,2019-12-21,853,-170,683,54,737,0,737,0
47469,2019-12-21,279,0,279,22,301,0,0,301
47470,2019-12-21,927,0,927,74,1001,1001,0,0
47471,2019-12-21,232,0,232,18,250,250,0,0
47472,2019-12-21,640,0,640,51,691,691,0,0
47473,2019-12-21,658,0,658,65,723,723,0,0
47474,2019-12-21,112,0,112,8,120,120,0,0
47475,2019-12-21,1105,0,1105,88,1193,1193,0,0
47476,2019-12-21,242,0,242,19,261,261,0,0
47477,2019-12-21,400,0,400,32,432,432,0,0
47478,2019-12-21,1076,0,1076,86,1162,1162,0,0
47479,2019-12-21,686,0,686,54,740,740,0,0
47480,2019-12-21,624,0,624,49,673,673,0,0
47481,2019-12-21,306,0,306,24,330,0,0,330
47482,2019-12-21,1504,0,1504,120,1624,1624,0,0
47483,2019-12-21,362,0,362,28,390,390,0,0
47484,2019-12-21,798,-79,719,57,776,776,0,0
47485,2019-12-21,1076,0,1076,107,1183,1183,0,0
47486,2019-12-21,667,0,667,53,720,720,0,0
47487,2019-12-21,204,0,204,20,224,224,0,0
47488,2019-12-21,2092,0,2092,209,2301,0,2301,0
47489,2019-12-21,371,0,371,29,400,400,0,0
47490,2019-12-21,634,0,634,50,684,0,684,0
47491,2019-12-21,1546,0,1546,154,1700,0,1700,0
47492,2019-12-21,773,0,773,77,850,850,0,0
47493,2019-12-21,773,0,773,77,850,850,0,0
47494,2019-12-21,2865,0,2865,274,3139,3139,0,0
47495,2019-12-21,1546,0,1546,154,1700,1700,0,0
47496,2019-12-21,436,0,436,34,470,470,0,0
47497,2019-12-21,417,0,417,33,450,450,0,0
47498,2019-12-21,2092,0,2092,209,2301,2301,0,0
47499,2019-12-21,269,0,269,21,290,290,0,0
47500,2019-12-21,1325,0,1325,132,1457,0,0,1457
47501,2019-12-21,936,0,936,74,1010,1010,0,0
47502,2019-12-21,343,0,343,27,370,370,0,0
47503,2019-12-21,455,0,455,36,491,491,0,0
47504,2019-12-21,722,0,722,72,794,794,0,0
47505,2019-12-21,343,0,343,27,370,370,0,0
47506,2019-12-21,556,-55,501,50,551,551,0,0
47507,2019-12-21,797,0,797,79,876,876,0,0
47508,2019-12-21,412,0,412,32,444,0,444,0
47509,2019-12-21,325,0,325,26,351,351,0,0
47510,2019-12-21,863,0,863,69,932,932,0,0
47511,2019-12-21,520,0,520,41,561,561,0,0
47512,2019-12-21,1020,0,1020,102,1122,1122,0,0
47513,2019-12-21,121,0,121,9,130,130,0,0
47514,2019-12-21,344,0,344,34,378,378,0,0
47515,2019-12-21,370,0,370,37,407,407,0,0
47516,2019-12-21,352,0,352,35,387,387,0,0
47517,2019-12-21,853,0,853,85,938,938,0,0
47518,2019-12-21,936,0,936,93,1029,0,1029,0
47519,2019-12-21,640,0,640,64,704,704,0,0
47520,2019-12-21,317,0,317,25,342,342,0,0
47521,2019-12-21,1546,0,1546,154,1700,0,1700,0
47522,2019-12-21,752,0,752,75,827,827,0,0
47523,2019-12-21,1864,0,1864,186,2050,0,2050,0
47524,2019-12-21,612,0,612,48,660,660,0,0
47525,2019-12-21,855,0,855,68,923,923,0,0
47526,2019-12-21,493,0,493,39,532,532,0,0
47527,2019-12-21,639,0,639,63,702,702,0,0
47528,2019-12-21,537,0,537,53,590,590,0,0
47529,2019-12-21,3138,0,3138,313,3451,0,0,3451
47530,2019-12-21,1178,0,1178,117,1295,1295,0,0
47531,2019-12-21,773,0,773,77,850,850,0,0
47532,2019-12-21,420,0,420,42,462,462,0,0
47533,2019-12-21,891,0,891,89,980,0,980,0
47534,2019-12-21,372,0,372,29,401,401,0,0
47535,2019-12-21,260,0,260,20,280,280,0,0
47536,2019-12-21,668,0,668,53,721,0,721,0
47537,2019-12-21,881,0,881,88,969,969,0,0
47538,2019-12-21,725,0,725,58,783,0,783,0
47539,2019-12-21,438,0,438,43,481,0,0,481
47540,2019-12-21,769,0,769,76,845,0,0,845
47541,2019-12-21,705,0,705,56,761,761,0,0
47542,2019-12-21,269,0,269,21,290,0,290,0
47543,2019-12-21,2464,0,2464,246,2710,2710,0,0
47544,2019-12-21,1046,0,1046,104,1150,0,1150,0
47545,2019-12-21,704,0,704,70,774,774,0,0
47546,2019-12-21,770,0,770,61,831,831,0,0
47547,2019-12-21,723,0,723,57,780,780,0,0
47548,2019-12-21,773,0,773,77,850,0,850,0
47549,2019-12-21,473,0,473,37,510,0,510,0
47550,2019-12-21,631,0,631,50,681,0,681,0
47551,2019-12-21,1930,0,1930,154,2084,2084,0,0
47552,2019-12-21,773,0,773,77,850,850,0,0
47553,2019-12-21,1546,0,1546,154,1700,1700,0,0
47554,2019-12-21,112,0,112,11,123,123,0,0
47555,2019-12-21,372,0,372,29,401,401,0,0
47556,2019-12-21,197,0,197,15,212,212,0,0
47557,2019-12-21,1546,0,1546,154,1700,0,1700,0
47558,2019-12-21,734,0,734,58,792,792,0,0
47559,2019-12-21,1132,0,1132,90,1222,1222,0,0
47560,2019-12-21,817,0,817,65,882,882,0,0
47561,2019-12-22,622,0,622,49,671,671,0,0
47562,2019-12-22,556,0,556,44,600,600,0,0
47563,2019-12-22,628,0,628,62,690,690,0,0
47564,2019-12-22,1782,0,1782,178,1960,0,0,1960
47565,2019-12-22,447,0,447,35,482,482,0,0
47566,2019-12-22,484,0,484,38,522,522,0,0
47567,2019-12-22,373,0,373,29,402,402,0,0
47568,2019-12-22,1782,0,1782,178,1960,1960,0,0
47569,2019-12-22,880,0,880,70,950,950,0,0
47570,2019-12-22,343,0,343,27,370,370,0,0
47571,2019-12-22,919,-500,419,33,452,452,0,0
47572,2019-12-22,880,0,880,88,968,968,0,0
47573,2019-12-22,315,0,315,25,340,340,0,0
47574,2019-12-22,1697,0,1697,169,1866,1866,0,0
47575,2019-12-22,575,0,575,57,632,0,0,632
47576,2019-12-22,501,0,501,40,541,541,0,0
47577,2019-12-22,473,0,473,37,510,510,0,0
47578,2019-12-22,806,0,806,80,886,886,0,0
47579,2019-12-22,409,0,409,32,441,441,0,0
47580,2019-12-22,436,0,436,34,470,470,0,0
47581,2019-12-22,798,0,798,79,877,877,0,0
47582,2019-12-22,418,0,418,33,451,451,0,0
47583,2019-12-22,3132,0,3132,313,3445,3445,0,0
47584,2019-12-22,957,0,957,76,1033,1033,0,0
47585,2019-12-22,865,0,865,69,934,934,0,0
47586,2019-12-22,519,0,519,41,560,560,0,0
47587,2019-12-22,362,-36,326,26,352,0,352,0
47588,2019-12-22,224,0,224,17,241,241,0,0
47589,2019-12-22,380,0,380,30,410,410,0,0
47590,2019-12-22,473,0,473,37,510,510,0,0
47591,2019-12-22,389,0,389,31,420,420,0,0
47592,2019-12-22,882,0,882,70,952,0,0,952
47593,2019-12-22,389,0,389,38,427,427,0,0
47594,2019-12-22,491,0,491,49,540,540,0,0
47595,2019-12-22,491,0,491,39,530,530,0,0
47596,2019-12-22,724,-72,652,52,704,0,704,0
47597,2019-12-22,1956,0,1956,195,2151,2151,0,0
47598,2019-12-22,908,0,908,72,980,980,0,0
47599,2019-12-22,1782,0,1782,178,1960,1960,0,0
47600,2019-12-22,1782,0,1782,178,1960,1960,0,0
47601,2019-12-22,149,0,149,11,160,160,0,0
47602,2019-12-22,250,0,250,20,270,270,0,0
47603,2019-12-22,93,0,93,7,100,100,0,0
47604,2019-12-22,1335,0,1335,106,1441,0,0,1441
47605,2019-12-22,753,0,753,60,813,813,0,0
47606,2019-12-22,1050,0,1050,84,1134,1134,0,0
47607,2019-12-22,624,0,624,49,673,673,0,0
47608,2019-12-22,621,0,621,49,670,670,0,0
47609,2019-12-22,362,0,362,28,390,390,0,0
47610,2019-12-22,1344,0,1344,107,1451,1451,0,0
47611,2019-12-22,753,0,753,60,813,813,0,0
47612,2019-12-22,604,0,604,48,652,652,0,0
47613,2019-12-22,204,0,204,16,220,220,0,0
47614,2019-12-22,687,0,687,54,741,0,741,0
47615,2019-12-22,260,-26,234,18,252,252,0,0
47616,2019-12-22,204,0,204,20,224,224,0,0
47617,2019-12-22,260,0,260,20,280,280,0,0
47618,2019-12-22,568,0,568,45,613,613,0,0
47619,2019-12-22,1204,0,1204,120,1324,1324,0,0
47620,2019-12-22,408,0,408,32,440,440,0,0
47621,2019-12-22,677,0,677,54,731,731,0,0
47622,2019-12-22,204,0,204,16,220,220,0,0
47623,2019-12-22,773,0,773,77,850,850,0,0
47624,2019-12-22,260,0,260,20,280,280,0,0
47625,2019-12-22,726,0,726,58,784,784,0,0
47626,2019-12-22,982,0,982,98,1080,1080,0,0
47627,2019-12-22,723,0,723,57,780,780,0,0
47628,2019-12-22,1590,0,1590,127,1717,1717,0,0
47629,2019-12-22,1086,0,1086,86,1172,1172,0,0
47630,2019-12-22,754,0,754,60,814,814,0,0
47631,2019-12-22,418,0,418,33,451,451,0,0
47632,2019-12-22,279,0,279,22,301,301,0,0
47633,2019-12-22,334,0,334,26,360,360,0,0
47634,2019-12-22,2188,0,2188,175,2363,2363,0,0
47635,2019-12-22,861,0,861,68,929,0,929,0
47636,2019-12-22,1046,0,1046,98,1144,1144,0,0
47637,2019-12-22,1157,0,1157,115,1272,1272,0,0
47638,2019-12-22,279,0,279,27,306,306,0,0
47639,2019-12-22,437,0,437,34,471,471,0,0
47640,2019-12-22,176,0,176,14,190,190,0,0
47641,2019-12-22,992,0,992,79,1071,1071,0,0
47642,2019-12-22,1171,0,1171,93,1264,1264,0,0
47643,2019-12-22,835,0,835,66,901,901,0,0
47644,2019-12-22,168,0,168,13,181,181,0,0
47645,2019-12-22,176,0,176,14,190,190,0,0
47646,2019-12-22,269,0,269,21,290,290,0,0
47647,2019-12-22,1041,0,1041,83,1124,0,1124,0
47648,2019-12-22,436,0,436,34,470,0,470,0
47649,2019-12-22,881,0,881,70,951,951,0,0
47650,2019-12-22,510,0,510,40,550,550,0,0
47651,2019-12-22,773,0,773,77,850,850,0,0
47652,2019-12-22,864,0,864,69,933,933,0,0
47653,2019-12-22,343,0,343,27,370,370,0,0
47654,2019-12-22,773,0,773,77,850,850,0,0
47655,2019-12-22,1546,0,1546,154,1700,1700,0,0
47656,2019-12-22,773,0,773,77,850,850,0,0
47657,2019-12-22,773,0,773,77,850,850,0,0
47658,2019-12-22,771,0,771,61,832,832,0,0
47659,2019-12-22,586,0,586,46,632,632,0,0
47660,2019-12-22,900,0,900,72,972,972,0,0
47661,2019-12-22,464,0,464,37,501,0,501,0
47662,2019-12-23,363,0,363,29,392,392,0,0
47663,2019-12-23,1058,0,1058,84,1142,1142,0,0
47664,2019-12-23,1105,0,1105,88,1193,1193,0,0
47665,2019-12-23,679,0,679,54,733,733,0,0
47666,2019-12-23,843,0,843,67,910,910,0,0
47667,2019-12-23,1782,0,1782,178,1960,0,1960,0
47668,2019-12-23,1782,0,1782,178,1960,0,0,1960
47669,2019-12-23,343,0,343,27,370,370,0,0
47670,2019-12-23,390,0,390,31,421,421,0,0
47671,2019-12-23,454,0,454,36,490,490,0,0
47672,2019-12-23,1235,0,1235,98,1333,0,1333,0
47673,2019-12-23,770,0,770,61,831,831,0,0
47674,2019-12-23,176,0,176,14,190,190,0,0
47675,2019-12-23,427,0,427,34,461,0,461,0
47676,2019-12-23,585,0,585,46,631,631,0,0
47677,2019-12-23,830,0,830,66,896,0,896,0
47678,2019-12-23,1399,0,1399,139,1538,1538,0,0
47679,2019-12-23,891,0,891,89,980,980,0,0
47680,2019-12-23,456,0,456,36,492,492,0,0
47681,2019-12-23,667,0,667,53,720,720,0,0
47682,2019-12-23,484,0,484,38,522,0,0,522
47683,2019-12-23,696,0,696,55,751,751,0,0
47684,2019-12-23,585,0,585,46,631,631,0,0
47685,2019-12-23,891,0,891,89,980,0,980,0
47686,2019-12-23,269,0,269,21,290,290,0,0
47687,2019-12-23,566,0,566,45,611,611,0,0
47688,2019-12-23,528,-105,423,33,456,456,0,0
47689,2019-12-23,547,0,547,43,590,590,0,0
47690,2019-12-23,444,0,444,35,479,0,0,479
47691,2019-12-23,535,0,535,42,577,577,0,0
47692,2019-12-23,260,0,260,20,280,280,0,0
47693,2019-12-23,585,0,585,46,631,631,0,0
47694,2019-12-23,121,0,121,9,130,130,0,0
47695,2019-12-23,854,0,854,68,922,0,922,0
47696,2019-12-23,909,0,909,72,981,981,0,0
47697,2019-12-23,463,0,463,46,509,509,0,0
47698,2019-12-23,445,0,445,35,480,480,0,0
47699,2019-12-23,297,0,297,23,320,0,320,0
47700,2019-12-23,899,0,899,89,988,988,0,0
47701,2019-12-23,436,0,436,34,470,470,0,0
47702,2019-12-23,491,0,491,49,540,540,0,0
47703,2019-12-23,491,0,491,49,540,540,0,0
47704,2019-12-23,260,0,260,20,280,280,0,0
47705,2019-12-23,2122,0,2122,212,2334,0,2334,0
47706,2019-12-23,149,0,149,11,160,160,0,0
47707,2019-12-23,901,0,901,72,973,973,0,0
47708,2019-12-23,1243,-248,995,79,1074,0,0,1074
47709,2019-12-23,483,-48,435,43,478,0,0,478
47710,2019-12-23,436,0,436,34,470,470,0,0
47711,2019-12-23,891,0,891,89,980,0,980,0
47712,2019-12-23,223,0,223,22,245,245,0,0
47713,2019-12-23,537,0,537,53,590,590,0,0
47714,2019-12-23,773,0,773,77,850,0,850,0
47715,2019-12-23,556,0,556,55,611,611,0,0
47716,2019-12-23,566,0,566,45,611,611,0,0
47717,2019-12-23,623,0,623,49,672,672,0,0
47718,2019-12-23,279,0,279,22,301,301,0,0
47719,2019-12-23,306,0,306,24,330,330,0,0
47720,2019-12-23,214,0,214,17,231,231,0,0
47721,2019-12-23,250,0,250,25,275,0,275,0
47722,2019-12-23,768,0,768,76,844,0,844,0
47723,2019-12-23,1546,0,1546,154,1700,0,1700,0
47724,2019-12-23,251,-50,201,16,217,217,0,0
47725,2019-12-23,232,0,232,18,250,0,0,250
47726,2019-12-23,918,0,918,73,991,991,0,0
47727,2019-12-23,260,0,260,20,280,280,0,0
47728,2019-12-23,121,0,121,9,130,130,0,0
47729,2019-12-23,473,0,473,37,510,510,0,0
47730,2019-12-23,298,0,298,23,321,321,0,0
47731,2019-12-23,917,0,917,91,1008,1008,0,0
47732,2019-12-23,816,0,816,65,881,881,0,0
47733,2019-12-23,1255,0,1255,100,1355,1355,0,0
47734,2019-12-23,632,0,632,50,682,682,0,0
47735,2019-12-23,334,0,334,26,360,360,0,0
47736,2019-12-23,1002,0,1002,80,1082,1082,0,0
47737,2019-12-23,937,0,937,74,1011,0,1011,0
47738,2019-12-23,845,0,845,67,912,912,0,0
47739,2019-12-23,1234,0,1234,98,1332,1332,0,0
47740,2019-12-23,891,0,891,89,980,980,0,0
47741,2019-12-23,121,0,121,9,130,130,0,0
47742,2019-12-23,457,0,457,36,493,493,0,0
47743,2019-12-23,891,0,891,89,980,980,0,0
47744,2019-12-23,408,0,408,40,448,448,0,0
47745,2019-12-23,1346,0,1346,107,1453,1453,0,0
47746,2019-12-23,891,0,891,89,980,980,0,0
47747,2019-12-23,408,0,408,32,440,440,0,0
47748,2019-12-23,807,-80,727,58,785,785,0,0
47749,2019-12-23,799,0,799,63,862,862,0,0
47750,2019-12-23,1344,0,1344,107,1451,1451,0,0
47751,2019-12-23,891,0,891,89,980,980,0,0
47752,2019-12-23,280,0,280,22,302,302,0,0
47753,2019-12-23,640,0,640,51,691,691,0,0
47754,2019-12-23,594,0,594,47,641,641,0,0
47755,2019-12-23,2674,0,2674,249,2923,2923,0,0
47756,2019-12-23,269,0,269,21,290,290,0,0
47757,2019-12-23,1159,0,1159,92,1251,1251,0,0
47758,2019-12-23,816,0,816,65,881,881,0,0
47759,2019-12-23,1040,0,1040,83,1123,1123,0,0
47760,2019-12-23,260,0,260,20,280,280,0,0
47761,2019-12-23,278,0,278,22,300,300,0,0
47762,2019-12-23,399,0,399,31,430,430,0,0
47763,2019-12-24,241,0,241,19,260,260,0,0
47764,2019-12-24,352,0,352,28,380,380,0,0
47765,2019-12-24,233,0,233,18,251,251,0,0
47766,2019-12-24,440,0,440,35,475,0,0,475
47767,2019-12-24,232,0,232,18,250,0,0,250
47768,2019-12-24,475,0,475,38,513,513,0,0
47769,2019-12-24,659,0,659,52,711,711,0,0
47770,2019-12-24,799,0,799,63,862,862,0,0
47771,2019-12-24,362,0,362,28,390,390,0,0
47772,2019-12-24,733,0,733,58,791,791,0,0
47773,2019-12-24,659,0,659,52,711,0,711,0
47774,2019-12-24,363,0,363,29,392,392,0,0
47775,2019-12-24,511,0,511,40,551,551,0,0
47776,2019-12-24,436,0,436,34,470,470,0,0
47777,2019-12-24,436,0,436,34,470,0,0,470
47778,2019-12-25,742,0,742,59,801,801,0,0
47779,2019-12-25,418,0,418,33,451,0,451,0
47780,2019-12-25,1058,0,1058,84,1142,1142,0,0
47781,2019-12-25,614,0,614,49,663,0,0,663
47782,2019-12-25,1121,0,1121,112,1233,1233,0,0
47783,2019-12-25,705,0,705,56,761,761,0,0
47784,2019-12-25,1801,0,1801,180,1981,1981,0,0
47785,2019-12-25,998,-99,899,89,988,988,0,0
47786,2019-12-25,334,0,334,26,360,360,0,0
47787,2019-12-25,1196,0,1196,95,1291,1291,0,0
47788,2019-12-25,891,0,891,89,980,980,0,0
47789,2019-12-25,232,0,232,18,250,250,0,0
47790,2019-12-25,891,0,891,89,980,980,0,0
47791,2019-12-25,370,0,370,37,407,407,0,0
47792,2019-12-25,900,0,900,90,990,0,0,990
47793,2019-12-25,765,0,765,61,826,826,0,0
47794,2019-12-25,363,0,363,29,392,392,0,0
47795,2019-12-25,891,0,891,89,980,980,0,0
47796,2019-12-25,891,0,891,89,980,980,0,0
47797,2019-12-25,1747,0,1747,174,1921,1921,0,0
47798,2019-12-25,725,0,725,58,783,783,0,0
47799,2019-12-25,910,-91,819,65,884,0,0,884
47800,2019-12-25,1782,0,1782,142,1924,0,0,1924
47801,2019-12-25,1606,-1000,606,48,654,654,0,0
47802,2019-12-25,400,0,400,40,440,440,0,0
47803,2019-12-25,640,0,640,64,704,704,0,0
47804,2019-12-25,269,0,269,21,290,290,0,0
47805,2019-12-25,491,0,491,39,530,530,0,0
47806,2019-12-25,900,0,900,72,972,0,972,0
47807,2019-12-25,1151,0,1151,92,1243,1243,0,0
47808,2019-12-25,492,0,492,39,531,531,0,0
47809,2019-12-25,380,0,380,30,410,410,0,0
47810,2019-12-25,520,0,520,41,561,561,0,0
47811,2019-12-25,918,0,918,73,991,0,0,991
47812,2019-12-25,121,0,121,9,130,130,0,0
47813,2019-12-25,446,0,446,35,481,481,0,0
47814,2019-12-25,1782,0,1782,178,1960,1960,0,0
47815,2019-12-25,1654,0,1654,132,1786,1786,0,0
47816,2019-12-25,760,0,760,76,836,836,0,0
47817,2019-12-25,575,0,575,46,621,621,0,0
47818,2019-12-25,1017,0,1017,101,1118,0,1118,0
47819,2019-12-25,773,0,773,61,834,834,0,0
47820,2019-12-25,502,0,502,40,542,542,0,0
47821,2019-12-25,891,0,891,89,980,980,0,0
47822,2019-12-25,862,0,862,86,948,948,0,0
47823,2019-12-25,389,0,389,38,427,0,427,0
47824,2019-12-25,389,0,389,31,420,420,0,0
47825,2019-12-25,400,0,400,32,432,432,0,0
47826,2019-12-25,380,0,380,30,410,410,0,0
47827,2019-12-25,437,0,437,34,471,471,0,0
47828,2019-12-25,936,0,936,74,1010,0,1010,0
47829,2019-12-25,306,0,306,24,330,330,0,0
47830,2019-12-25,463,0,463,37,500,500,0,0
47831,2019-12-25,408,0,408,32,440,440,0,0
47832,2019-12-25,714,0,714,57,771,771,0,0
47833,2019-12-25,605,0,605,60,665,665,0,0
47834,2019-12-25,835,0,835,66,901,901,0,0
47835,2019-12-25,1030,0,1030,82,1112,1112,0,0
47836,2019-12-25,343,0,343,27,370,370,0,0
47837,2019-12-25,1142,0,1142,91,1233,1233,0,0
47838,2019-12-25,982,0,982,78,1060,1060,0,0
47839,2019-12-25,871,0,871,69,940,0,940,0
47840,2019-12-25,594,0,594,47,641,0,641,0
47841,2019-12-25,769,0,769,76,845,0,845,0
47842,2019-12-25,1225,0,1225,98,1323,1323,0,0
47843,2019-12-25,773,0,773,77,850,850,0,0
47844,2019-12-25,473,0,473,37,510,510,0,0
47845,2019-12-25,186,0,186,14,200,200,0,0
47846,2019-12-25,773,0,773,77,850,850,0,0
47847,2019-12-25,773,0,773,77,850,850,0,0
47848,2019-12-25,773,0,773,77,850,850,0,0
47849,2019-12-25,773,-77,696,69,765,765,0,0
47850,2019-12-25,149,0,149,11,160,160,0,0
47851,2019-12-25,1067,0,1067,107,1174,0,1174,0
47852,2019-12-25,773,0,773,77,850,850,0,0
47853,2019-12-25,658,0,658,52,710,710,0,0
47854,2019-12-25,773,0,773,77,850,850,0,0
47855,2019-12-25,473,0,473,37,510,510,0,0
47856,2019-12-25,920,0,920,73,993,993,0,0
47857,2019-12-25,3092,-309,2783,278,3061,3061,0,0
47858,2019-12-25,668,0,668,53,721,721,0,0
47859,2019-12-25,872,0,872,69,941,941,0,0
47860,2019-12-25,1546,0,1546,154,1700,1700,0,0
47861,2019-12-25,742,0,742,59,801,801,0,0
47862,2019-12-25,520,0,520,41,561,561,0,0
47863,2019-12-25,1586,0,1586,126,1712,1712,0,0
47864,2019-12-25,510,0,510,40,550,550,0,0
47865,2019-12-25,891,0,891,89,980,980,0,0
47866,2019-12-25,492,0,492,39,531,531,0,0
47867,2019-12-25,232,0,232,18,250,250,0,0
47868,2019-12-25,446,0,446,35,481,481,0,0
47869,2019-12-25,93,0,93,7,100,100,0,0
47870,2019-12-25,686,0,686,54,740,740,0,0
47871,2019-12-25,828,0,828,66,894,894,0,0
47872,2019-12-25,309,0,309,24,333,0,333,0
47873,2019-12-25,724,0,724,57,781,781,0,0
47874,2019-12-25,1152,0,1152,92,1244,1244,0,0
47875,2019-12-25,594,0,594,47,641,641,0,0
47876,2019-12-25,752,0,752,75,827,0,827,0
47877,2019-12-25,112,0,112,8,120,0,120,0
47878,2019-12-25,1513,0,1513,151,1664,1664,0,0
47879,2019-12-25,232,0,232,18,250,250,0,0
47880,2019-12-25,1623,0,1623,162,1785,1785,0,0
47881,2019-12-25,612,0,612,48,660,0,0,660
47882,2019-12-25,149,0,149,11,160,160,0,0
47883,2019-12-26,529,0,529,42,571,571,0,0
47884,2019-12-26,232,0,232,18,250,250,0,0
47885,2019-12-26,279,0,279,22,301,301,0,0
47886,2019-12-26,837,0,837,66,903,903,0,0
47887,2019-12-26,891,0,891,89,980,980,0,0
47888,2019-12-26,1039,0,1039,83,1122,1122,0,0
47889,2019-12-26,492,0,492,39,531,531,0,0
47890,2019-12-26,269,0,269,21,290,290,0,0
47891,2019-12-26,1148,0,1148,114,1262,1262,0,0
47892,2019-12-26,891,0,891,89,980,0,980,0
47893,2019-12-26,891,0,891,89,980,0,980,0
47894,2019-12-26,1782,0,1782,178,1960,0,0,1960
47895,2019-12-26,649,0,649,64,713,713,0,0
47896,2019-12-26,428,0,428,34,462,462,0,0
47897,2019-12-26,735,0,735,58,793,793,0,0
47898,2019-12-26,2106,0,2106,210,2316,2316,0,0
47899,2019-12-26,686,0,686,54,740,740,0,0
47900,2019-12-26,389,0,389,31,420,420,0,0
47901,2019-12-26,1336,-133,1203,96,1299,1299,0,0
47902,2019-12-26,306,0,306,24,330,330,0,0
47903,2019-12-26,427,0,427,34,461,0,461,0
47904,2019-12-26,2597,0,2597,259,2856,2856,0,0
47905,2019-12-26,2703,0,2703,270,2973,2973,0,0
47906,2019-12-26,260,0,260,20,280,280,0,0
47907,2019-12-26,399,0,399,39,438,438,0,0
47908,2019-12-26,1027,0,1027,102,1129,1129,0,0
47909,2019-12-26,288,0,288,23,311,311,0,0
47910,2019-12-26,916,0,916,91,1007,1007,0,0
47911,2019-12-26,519,0,519,41,560,0,0,560
47912,2019-12-26,1010,0,1010,80,1090,1090,0,0
47913,2019-12-26,519,0,519,41,560,560,0,0
47914,2019-12-26,195,0,195,15,210,210,0,0
47915,2019-12-26,389,0,389,38,427,427,0,0
47916,2019-12-26,269,0,269,21,290,290,0,0
47917,2019-12-26,899,0,899,89,988,0,0,988
47918,2019-12-26,1256,0,1256,125,1381,1381,0,0
47919,2019-12-26,1434,0,1434,114,1548,1548,0,0
47920,2019-12-26,1756,0,1756,140,1896,1896,0,0
47921,2019-12-26,279,0,279,22,301,301,0,0
47922,2019-12-26,410,-41,369,29,398,398,0,0
47923,2019-12-26,168,0,168,13,181,181,0,0
47924,2019-12-26,260,0,260,20,280,280,0,0
47925,2019-12-26,196,0,196,15,211,211,0,0
47926,2019-12-26,722,0,722,72,794,794,0,0
47927,2019-12-26,1038,0,1038,103,1141,1141,0,0
47928,2019-12-26,491,0,491,49,540,540,0,0
47929,2019-12-26,399,0,399,39,438,438,0,0
47930,2019-12-26,149,0,149,11,160,160,0,0
47931,2019-12-26,891,0,891,89,980,980,0,0
47932,2019-12-26,807,0,807,64,871,871,0,0
47933,2019-12-26,389,0,389,31,420,420,0,0
47934,2019-12-26,936,0,936,93,1029,0,1029,0
47935,2019-12-26,139,0,139,11,150,0,0,150
47936,2019-12-26,438,0,438,35,473,473,0,0
47937,2019-12-26,510,0,510,40,550,0,0,550
47938,2019-12-26,640,0,640,64,704,0,0,704
47939,2019-12-26,658,0,658,65,723,723,0,0
47940,2019-12-26,920,0,920,73,993,993,0,0
47941,2019-12-26,537,0,537,42,579,579,0,0
47942,2019-12-26,-1225,0,-1225,-115,-1340,-1340,0,0
47943,2019-12-26,1300,0,1300,104,1404,1404,0,0
47944,2019-12-26,1225,0,1225,115,1340,1340,0,0
47945,2019-12-26,316,0,316,25,341,0,341,0
47946,2019-12-26,288,-57,231,18,249,249,0,0
47947,2019-12-26,241,0,241,19,260,260,0,0
47948,2019-12-26,538,0,538,43,581,581,0,0
47949,2019-12-26,269,0,269,21,290,290,0,0
47950,2019-12-26,288,0,288,23,311,311,0,0
47951,2019-12-26,891,0,891,89,980,980,0,0
47952,2019-12-26,1206,0,1206,96,1302,1302,0,0
47953,2019-12-26,891,0,891,89,980,980,0,0
47954,2019-12-26,352,0,352,28,380,0,0,380
47955,2019-12-26,1815,0,1815,181,1996,1996,0,0
47956,2019-12-26,779,0,779,62,841,0,841,0
47957,2019-12-26,640,0,640,51,691,691,0,0
47958,2019-12-26,565,0,565,56,621,621,0,0
47959,2019-12-26,1546,0,1546,154,1700,1700,0,0
47960,2019-12-26,779,0,779,62,841,841,0,0
47961,2019-12-26,1143,0,1143,91,1234,1234,0,0
47962,2019-12-26,752,0,752,60,812,812,0,0
47963,2019-12-26,1020,0,1020,81,1101,0,0,1101
47964,2019-12-26,241,0,241,19,260,260,0,0
47965,2019-12-26,1169,0,1169,116,1285,0,0,1285
47966,2019-12-26,241,0,241,19,260,260,0,0
47967,2019-12-26,955,0,955,76,1031,1031,0,0
47968,2019-12-26,1546,0,1546,154,1700,1700,0,0
47969,2019-12-26,1546,0,1546,154,1700,1700,0,0
47970,2019-12-26,724,0,724,57,781,781,0,0
47971,2019-12-26,891,0,891,89,980,980,0,0
47972,2019-12-26,204,0,204,16,220,220,0,0
47973,2019-12-26,280,0,280,22,302,302,0,0
47974,2019-12-26,644,0,644,51,695,695,0,0
47975,2019-12-26,1207,-241,966,77,1043,1043,0,0
47976,2019-12-26,510,-102,408,32,440,440,0,0
47977,2019-12-26,778,0,778,62,840,0,840,0
47978,2019-12-26,417,-41,376,30,406,406,0,0
47979,2019-12-26,1068,0,1068,85,1153,1153,0,0
47980,2019-12-26,1626,0,1626,162,1788,1788,0,0
47981,2019-12-26,713,0,713,57,770,770,0,0
47982,2019-12-26,241,0,241,19,260,260,0,0
47983,2019-12-26,1158,-231,927,74,1001,1001,0,0
47984,2019-12-26,260,0,260,20,280,280,0,0
47985,2019-12-26,334,0,334,26,360,360,0,0
47986,2019-12-26,2863,0,2863,286,3149,3149,0,0
47987,2019-12-26,3037,0,3037,242,3279,3279,0,0
47988,2019-12-26,168,0,168,13,181,181,0,0
47989,2019-12-26,1782,0,1782,178,1960,1960,0,0
47990,2019-12-26,567,0,567,45,612,612,0,0
47991,2019-12-26,538,0,538,43,581,581,0,0
47992,2019-12-26,825,0,825,66,891,891,0,0
47993,2019-12-26,891,0,891,89,980,980,0,0
47994,2019-12-26,232,0,232,18,250,250,0,0
47995,2019-12-26,1782,0,1782,178,1960,1960,0,0
47996,2019-12-26,882,0,882,70,952,952,0,0
47997,2019-12-26,370,0,370,37,407,0,407,0
47998,2019-12-26,511,0,511,40,551,0,551,0
47999,2019-12-26,751,0,751,60,811,811,0,0
48000,2019-12-26,529,0,529,42,571,571,0,0
48001,2019-12-26,704,0,704,70,774,774,0,0
48002,2019-12-26,2673,-267,2406,240,2646,2646,0,0
48003,2019-12-26,946,0,946,75,1021,1021,0,0
48004,2019-12-26,1782,0,1782,178,1960,0,1960,0
48005,2019-12-26,873,0,873,69,942,942,0,0
48006,2019-12-26,678,0,678,54,732,732,0,0
48007,2019-12-26,232,0,232,18,250,250,0,0
48008,2019-12-26,250,0,250,20,270,270,0,0
48009,2019-12-26,602,0,602,48,650,650,0,0
48010,2019-12-26,251,0,251,20,271,271,0,0
48011,2019-12-26,1030,0,1030,82,1112,1112,0,0
48012,2019-12-26,389,0,389,31,420,420,0,0
48013,2019-12-26,315,0,315,31,346,0,346,0
48014,2019-12-26,520,0,520,41,561,561,0,0
48015,2019-12-26,1782,0,1782,178,1960,1960,0,0
48016,2019-12-26,1076,0,1076,86,1162,1162,0,0
48017,2019-12-26,1530,-153,1377,110,1487,1487,0,0
48018,2019-12-26,1179,0,1179,94,1273,1273,0,0
48019,2019-12-26,696,0,696,55,751,751,0,0
48020,2019-12-26,1262,0,1262,100,1362,0,1362,0
48021,2019-12-26,781,0,781,78,859,0,859,0
48022,2019-12-27,603,0,603,48,651,651,0,0
48023,2019-12-27,584,0,584,46,630,630,0,0
48024,2019-12-27,1726,0,1726,138,1864,1864,0,0
48025,2019-12-27,628,0,628,62,690,690,0,0
48026,2019-12-27,891,0,891,89,980,980,0,0
48027,2019-12-27,1087,-1000,87,6,93,93,0,0
48028,2019-12-27,984,0,984,78,1062,1062,0,0
48029,2019-12-27,686,0,686,54,740,740,0,0
48030,2019-12-27,417,0,417,33,450,450,0,0
48031,2019-12-27,649,0,649,64,713,713,0,0
48032,2019-12-27,269,0,269,21,290,290,0,0
48033,2019-12-27,751,0,751,60,811,811,0,0
48034,2019-12-27,1782,0,1782,178,1960,1960,0,0
48035,2019-12-27,260,0,260,20,280,280,0,0
48036,2019-12-27,1732,0,1732,173,1905,1905,0,0
48037,2019-12-27,1040,0,1040,104,1144,1144,0,0
48038,2019-12-27,1512,0,1512,151,1663,0,1663,0
48039,2019-12-27,465,0,465,37,502,502,0,0
48040,2019-12-27,825,0,825,66,891,891,0,0
48041,2019-12-27,279,0,279,22,301,301,0,0
48042,2019-12-27,520,0,520,41,561,561,0,0
48043,2019-12-27,928,0,928,74,1002,1002,0,0
48044,2019-12-27,920,0,920,73,993,993,0,0
48045,2019-12-27,1782,0,1782,178,1960,1960,0,0
48046,2019-12-27,1513,0,1513,121,1634,0,1634,0
48047,2019-12-27,529,0,529,42,571,571,0,0
48048,2019-12-27,779,0,779,62,841,841,0,0
48049,2019-12-27,417,0,417,33,450,450,0,0
48050,2019-12-27,1567,0,1567,156,1723,1723,0,0
48051,2019-12-27,976,0,976,78,1054,1054,0,0
48052,2019-12-27,1315,0,1315,131,1446,1446,0,0
48053,2019-12-27,1286,0,1286,128,1414,1414,0,0
48054,2019-12-27,1782,0,1782,178,1960,0,1960,0
48055,2019-12-27,584,0,584,46,630,630,0,0
48056,2019-12-27,892,0,892,71,963,963,0,0
48057,2019-12-27,1030,0,1030,82,1112,1112,0,0
48058,2019-12-27,695,0,695,55,750,750,0,0
48059,2019-12-27,2411,0,2411,192,2603,2603,0,0
48060,2019-12-27,2216,0,2216,221,2437,0,2437,0
48061,2019-12-27,529,0,529,42,571,571,0,0
48062,2019-12-27,947,0,947,94,1041,0,1041,0
48063,2019-12-27,429,0,429,34,463,463,0,0
48064,2019-12-27,753,0,753,60,813,813,0,0
48065,2019-12-27,279,0,279,22,301,301,0,0
48066,2019-12-27,1231,0,1231,123,1354,0,0,1354
48067,2019-12-27,862,0,862,68,930,930,0,0
48068,2019-12-27,538,0,538,43,581,581,0,0
48069,2019-12-27,483,0,483,38,521,0,0,521
48070,2019-12-27,612,0,612,48,660,660,0,0
48071,2019-12-27,315,0,315,25,340,340,0,0
48072,2019-12-27,232,0,232,18,250,250,0,0
48073,2019-12-27,336,0,336,26,362,362,0,0
48074,2019-12-27,548,0,548,43,591,591,0,0
48075,2019-12-27,447,0,447,35,482,482,0,0
48076,2019-12-27,732,0,732,58,790,790,0,0
48077,2019-12-27,439,-43,396,31,427,427,0,0
48078,2019-12-27,306,0,306,24,330,330,0,0
48079,2019-12-27,306,-30,276,22,298,298,0,0
48080,2019-12-27,-306,0,-306,-24,-330,-330,0,0
48081,2019-12-27,380,0,380,30,410,410,0,0
48082,2019-12-27,269,0,269,21,290,290,0,0
48083,2019-12-27,575,0,575,46,621,621,0,0
48084,2019-12-27,630,0,630,63,693,693,0,0
48085,2019-12-27,3188,0,3188,312,3500,0,3500,0
48086,2019-12-27,1465,0,1465,117,1582,1582,0,0
48087,2019-12-27,520,0,520,41,561,561,0,0
48088,2019-12-27,279,0,279,22,301,301,0,0
48089,2019-12-27,-279,0,-279,-22,-301,-301,0,0
48090,2019-12-27,232,0,232,18,250,250,0,0
48091,2019-12-27,1782,0,1782,178,1960,1960,0,0
48092,2019-12-27,1180,0,1180,94,1274,0,0,1274
48093,2019-12-27,698,0,698,55,753,0,753,0
48094,2019-12-27,1261,0,1261,126,1387,1387,0,0
48095,2019-12-27,390,0,390,31,421,421,0,0
48096,2019-12-27,241,0,241,19,260,260,0,0
48097,2019-12-27,540,0,540,43,583,583,0,0
48098,2019-12-27,1325,0,1325,132,1457,1457,0,0
48099,2019-12-27,705,0,705,56,761,0,0,761
48100,2019-12-27,269,0,269,21,290,290,0,0
48101,2019-12-27,408,0,408,32,440,440,0,0
48102,2019-12-27,882,0,882,81,963,963,0,0
48103,2019-12-27,528,0,528,42,570,570,0,0
48104,2019-12-27,-882,0,-882,-81,-963,-963,0,0
48105,2019-12-27,464,0,464,37,501,501,0,0
48106,2019-12-27,436,0,436,34,470,470,0,0
48107,2019-12-27,984,0,984,78,1062,1062,0,0
48108,2019-12-27,898,0,898,89,987,987,0,0
48109,2019-12-27,1337,0,1337,106,1443,1443,0,0
48110,2019-12-27,2092,0,2092,209,2301,2301,0,0
48111,2019-12-27,983,0,983,78,1061,1061,0,0
48112,2019-12-27,1232,0,1232,123,1355,0,1355,0
48113,2019-12-27,1141,0,1141,91,1232,0,1232,0
48114,2019-12-27,751,0,751,60,811,811,0,0
48115,2019-12-27,537,0,537,53,590,590,0,0
48116,2019-12-27,343,0,343,27,370,370,0,0
48117,2019-12-27,353,0,353,28,381,381,0,0
48118,2019-12-27,1437,0,1437,114,1551,1551,0,0
48119,2019-12-27,668,0,668,53,721,721,0,0
48120,2019-12-27,380,0,380,30,410,410,0,0
48121,2019-12-27,773,0,773,77,850,850,0,0
48122,2019-12-27,112,0,112,8,120,120,0,0
48123,2019-12-27,704,0,704,70,774,774,0,0
48124,2019-12-27,306,0,306,24,330,0,0,330
48125,2019-12-27,1546,0,1546,154,1700,0,1700,0
48126,2019-12-27,2092,0,2092,209,2301,2301,0,0
48127,2019-12-27,937,0,937,74,1011,1011,0,0
48128,2019-12-27,740,0,740,74,814,814,0,0
48129,2019-12-27,1546,0,1546,154,1700,0,0,1700
48130,2019-12-27,772,0,772,61,833,833,0,0
48131,2019-12-27,687,0,687,54,741,741,0,0
48132,2019-12-27,891,0,891,89,980,980,0,0
48133,2019-12-27,538,0,538,43,581,0,0,581
48134,2019-12-27,139,0,139,11,150,150,0,0
48135,2019-12-27,233,0,233,18,251,251,0,0
48136,2019-12-27,370,0,370,37,407,407,0,0
48137,2019-12-27,722,0,722,72,794,794,0,0
48138,2019-12-27,601,0,601,48,649,649,0,0
48139,2019-12-27,1435,0,1435,143,1578,1578,0,0
48140,2019-12-27,429,0,429,34,463,463,0,0
48141,2019-12-27,437,0,437,34,471,471,0,0
48142,2019-12-27,492,0,492,39,531,531,0,0
48143,2019-12-27,919,0,919,73,992,992,0,0
48144,2019-12-27,1334,0,1334,133,1467,1467,0,0
48145,2019-12-27,-389,0,-389,-39,-428,-428,0,0
48146,2019-12-27,628,0,628,50,678,678,0,0
48147,2019-12-27,724,0,724,57,781,0,781,0
48148,2019-12-27,1188,0,1188,95,1283,1283,0,0
48149,2019-12-27,260,0,260,20,280,280,0,0
48150,2019-12-27,798,0,798,79,877,877,0,0
48151,2019-12-27,1009,0,1009,100,1109,0,0,1109
48152,2019-12-27,260,0,260,20,280,280,0,0
48153,2019-12-27,773,0,773,77,850,0,850,0
48154,2019-12-27,538,0,538,43,581,0,0,581
48155,2019-12-27,-538,0,-538,-43,-581,-581,0,0
48156,2019-12-27,1140,0,1140,114,1254,0,1254,0
48157,2019-12-27,269,0,269,21,290,290,0,0
48158,2019-12-27,1105,0,1105,88,1193,1193,0,0
48159,2019-12-27,1227,0,1227,98,1325,1325,0,0
48160,2019-12-27,1021,0,1021,81,1102,0,1102,0
48161,2019-12-27,1068,0,1068,85,1153,1153,0,0
48162,2019-12-27,538,0,538,43,581,581,0,0
48163,2019-12-27,352,0,352,35,387,387,0,0
48164,2019-12-27,575,0,575,57,632,632,0,0
48165,2019-12-27,631,0,631,50,681,681,0,0
48166,2019-12-27,594,0,594,47,641,641,0,0
48167,2019-12-27,2115,0,2115,169,2284,0,2284,0
48168,2019-12-27,1215,0,1215,97,1312,1312,0,0
48169,2019-12-27,112,0,112,8,120,120,0,0
48170,2019-12-27,640,0,640,51,691,691,0,0
48171,2019-12-27,773,0,773,77,850,850,0,0
48172,2019-12-27,112,0,112,8,120,120,0,0
48173,2019-12-27,1546,0,1546,154,1700,1700,0,0
48174,2019-12-27,454,0,454,45,499,499,0,0
48175,2019-12-27,483,0,483,38,521,521,0,0
48176,2019-12-27,987,0,987,78,1065,1065,0,0
48177,2019-12-27,929,0,929,74,1003,0,0,1003
48178,2019-12-27,1383,0,1383,110,1493,0,1493,0
48179,2019-12-27,857,0,857,68,925,925,0,0
48180,2019-12-27,742,0,742,59,801,801,0,0
48181,2019-12-27,509,0,509,50,559,0,559,0
48182,2019-12-27,1046,0,1046,98,1144,0,1144,0
48183,2019-12-27,2154,0,2154,172,2326,2326,0,0
48184,2019-12-27,705,0,705,56,761,761,0,0
48185,2019-12-27,273,0,273,27,300,300,0,0
48186,2019-12-27,695,0,695,55,750,750,0,0
48187,2019-12-27,834,0,834,83,917,0,917,0
48188,2019-12-27,241,0,241,24,265,0,265,0
48189,2019-12-27,1546,0,1546,154,1700,0,0,1700
48190,2019-12-27,362,0,362,28,390,390,0,0
48191,2019-12-27,1912,0,1912,152,2064,0,2064,0
48192,2019-12-27,362,-36,326,26,352,352,0,0
48193,2019-12-27,139,0,139,11,150,150,0,0
48194,2019-12-27,3865,0,3865,386,4251,0,4251,0
48195,2019-12-27,455,0,455,45,500,0,500,0
48196,2019-12-28,628,0,628,62,690,690,0,0
48197,2019-12-28,546,0,546,54,600,600,0,0
48198,2019-12-28,628,0,628,62,690,690,0,0
48199,2019-12-28,628,0,628,62,690,690,0,0
48200,2019-12-28,623,0,623,49,672,672,0,0
48201,2019-12-28,628,0,628,62,690,0,690,0
48202,2019-12-28,1262,0,1262,126,1388,1388,0,0
48203,2019-12-28,362,0,362,28,390,0,390,0
48204,2019-12-28,1782,0,1782,178,1960,1960,0,0
48205,2019-12-28,628,0,628,62,690,690,0,0
48206,2019-12-28,491,0,491,39,530,530,0,0
48207,2019-12-28,1782,0,1782,178,1960,0,1960,0
48208,2019-12-28,1839,0,1839,183,2022,2022,0,0
48209,2019-12-28,381,0,381,30,411,411,0,0
48210,2019-12-28,269,0,269,21,290,0,0,290
48211,2019-12-28,696,0,696,55,751,751,0,0
48212,2019-12-28,791,0,791,63,854,854,0,0
48213,2019-12-28,3564,0,3564,356,3920,0,3920,0
48214,2019-12-28,494,0,494,39,533,533,0,0
48215,2019-12-28,918,0,918,73,991,991,0,0
48216,2019-12-28,1782,0,1782,178,1960,0,1960,0
48217,2019-12-28,344,0,344,27,371,371,0,0
48218,2019-12-28,2673,0,2673,267,2940,2940,0,0
48219,2019-12-28,3349,0,3349,267,3616,3616,0,0
48220,2019-12-28,362,0,362,28,390,390,0,0
48221,2019-12-28,316,0,316,25,341,341,0,0
48222,2019-12-28,288,0,288,23,311,311,0,0
48223,2019-12-28,2880,-288,2592,250,2842,0,2842,0
48224,2019-12-28,891,0,891,89,980,980,0,0
48225,2019-12-28,919,0,919,73,992,992,0,0
48226,2019-12-28,844,0,844,67,911,911,0,0
48227,2019-12-28,946,0,946,94,1040,1040,0,0
48228,2019-12-28,1187,0,1187,107,1294,0,1294,0
48229,2019-12-28,1957,0,1957,195,2152,0,2152,0
48230,2019-12-28,1029,0,1029,102,1131,1131,0,0
48231,2019-12-28,1021,0,1021,96,1117,1117,0,0
48232,2019-12-28,279,0,279,22,301,301,0,0
48233,2019-12-28,2673,-267,2406,240,2646,2646,0,0
48234,2019-12-28,1782,0,1782,178,1960,0,1960,0
48235,2019-12-28,901,0,901,72,973,973,0,0
48236,2019-12-28,676,0,676,67,743,0,743,0
48237,2019-12-28,891,0,891,89,980,0,980,0
48238,2019-12-28,891,0,891,89,980,0,980,0
48239,2019-12-28,891,0,891,89,980,980,0,0
48240,2019-12-28,1280,0,1280,128,1408,1408,0,0
48241,2019-12-28,807,0,807,64,871,0,0,871
48242,2019-12-28,1160,0,1160,92,1252,0,1252,0
48243,2019-12-28,519,0,519,41,560,560,0,0
48244,2019-12-28,214,0,214,17,231,231,0,0
48245,2019-12-28,668,0,668,53,721,0,0,721
48246,2019-12-28,484,0,484,38,522,522,0,0
48247,2019-12-28,1759,0,1759,175,1934,1934,0,0
48248,2019-12-28,492,-49,443,35,478,478,0,0
48249,2019-12-28,1389,0,1389,138,1527,1527,0,0
48250,2019-12-28,362,0,362,28,390,390,0,0
48251,2019-12-28,372,0,372,29,401,401,0,0
48252,2019-12-28,510,0,510,45,555,555,0,0
48253,2019-12-28,740,0,740,74,814,814,0,0
48254,2019-12-28,678,0,678,54,732,732,0,0
48255,2019-12-28,260,0,260,20,280,280,0,0
48256,2019-12-28,613,0,613,58,671,671,0,0
48257,2019-12-28,250,0,250,20,270,270,0,0
48258,2019-12-28,1121,0,1121,89,1210,1210,0,0
48259,2019-12-28,494,0,494,39,533,533,0,0
48260,2019-12-28,269,0,269,21,290,290,0,0
48261,2019-12-28,585,0,585,46,631,631,0,0
48262,2019-12-28,260,0,260,20,280,280,0,0
48263,2019-12-28,899,0,899,89,988,988,0,0
48264,2019-12-28,2150,0,2150,215,2365,2365,0,0
48265,2019-12-28,519,0,519,51,570,570,0,0
48266,2019-12-28,306,0,306,24,330,330,0,0
48267,2019-12-28,1819,0,1819,145,1964,1964,0,0
48268,2019-12-28,493,0,493,39,532,532,0,0
48269,2019-12-28,826,0,826,66,892,892,0,0
48270,2019-12-28,241,0,241,19,260,260,0,0
48271,2019-12-28,2975,0,2975,297,3272,3272,0,0
48272,2019-12-28,492,-98,394,31,425,425,0,0
48273,2019-12-28,269,0,269,21,290,290,0,0
48274,2019-12-28,1160,0,1160,92,1252,1252,0,0
48275,2019-12-28,2002,0,2002,200,2202,2202,0,0
48276,2019-12-28,278,0,278,22,300,300,0,0
48277,2019-12-28,595,0,595,47,642,0,0,642
48278,2019-12-28,2189,0,2189,215,2404,2404,0,0
48279,2019-12-28,530,0,530,42,572,572,0,0
48280,2019-12-28,251,0,251,20,271,271,0,0
48281,2019-12-28,1455,0,1455,145,1600,1600,0,0
48282,2019-12-28,566,0,566,45,611,611,0,0
48283,2019-12-28,1363,0,1363,136,1499,0,1499,0
48284,2019-12-28,112,0,112,8,120,120,0,0
48285,2019-12-28,130,0,130,10,140,140,0,0
48286,2019-12-28,846,0,846,84,930,930,0,0
48287,2019-12-28,1130,0,1130,113,1243,1243,0,0
48288,2019-12-28,399,0,399,39,438,438,0,0
48289,2019-12-28,530,0,530,42,572,572,0,0
48290,2019-12-28,260,0,260,26,286,286,0,0
48291,2019-12-28,149,0,149,11,160,160,0,0
48292,2019-12-28,3031,0,3031,303,3334,0,0,3334
48293,2019-12-28,278,0,278,22,300,300,0,0
48294,2019-12-28,297,-29,268,21,289,289,0,0
48295,2019-12-28,224,0,224,22,246,246,0,0
48296,2019-12-28,594,0,594,47,641,641,0,0
48297,2019-12-28,139,0,139,11,150,0,0,150
48298,2019-12-28,102,0,102,8,110,110,0,0
48299,2019-12-28,603,0,603,48,651,651,0,0
48300,2019-12-28,1782,0,1782,178,1960,1960,0,0
48301,2019-12-28,872,0,872,69,941,941,0,0
48302,2019-12-28,908,0,908,90,998,998,0,0
48303,2019-12-28,112,0,112,11,123,123,0,0
48304,2019-12-28,773,0,773,77,850,850,0,0
48305,2019-12-28,773,0,773,77,850,850,0,0
48306,2019-12-28,2865,0,2865,286,3151,0,0,3151
48307,2019-12-28,269,0,269,21,290,290,0,0
48308,2019-12-28,773,0,773,77,850,850,0,0
48309,2019-12-28,773,0,773,77,850,850,0,0
48310,2019-12-28,1546,0,1546,154,1700,1700,0,0
48311,2019-12-28,464,0,464,37,501,501,0,0
48312,2019-12-28,1546,0,1546,154,1700,1700,0,0
48313,2019-12-28,273,0,273,27,300,300,0,0
48314,2019-12-28,3092,0,3092,309,3401,0,3401,0
48315,2019-12-28,418,0,418,33,451,451,0,0
48316,2019-12-28,773,0,773,77,850,850,0,0
48317,2019-12-28,400,0,400,32,432,0,0,432
48318,2019-12-28,773,0,773,77,850,850,0,0
48319,2019-12-28,1546,0,1546,154,1700,1700,0,0
48320,2019-12-28,389,0,389,31,420,0,420,0
48321,2019-12-28,389,0,389,31,420,420,0,0
48322,2019-12-28,2092,0,2092,209,2301,2301,0,0
48323,2019-12-28,1597,0,1597,127,1724,1724,0,0
48324,2019-12-28,890,0,890,71,961,961,0,0
48325,2019-12-28,2170,0,2170,173,2343,2343,0,0
48326,2019-12-28,-1546,0,-1546,-154,-1700,-1700,0,0
48327,2019-12-28,1546,0,1546,154,1700,1700,0,0
48328,2019-12-28,1483,0,1483,148,1631,1631,0,0
48329,2019-12-28,1040,0,1040,83,1123,1123,0,0
48330,2019-12-28,612,0,612,48,660,660,0,0
48331,2019-12-28,696,0,696,55,751,751,0,0
48332,2019-12-28,380,0,380,30,410,410,0,0
48333,2019-12-28,102,0,102,8,110,0,0,110
48334,2019-12-28,752,0,752,60,812,812,0,0
48335,2019-12-28,376,0,376,30,406,406,0,0
48336,2019-12-28,603,0,603,48,651,651,0,0
48337,2019-12-28,902,0,902,72,974,974,0,0
48338,2019-12-28,502,0,502,40,542,0,542,0
48339,2019-12-28,918,0,918,73,991,991,0,0
48340,2019-12-28,603,0,603,48,651,651,0,0
48341,2019-12-28,425,0,425,34,459,459,0,0
48342,2019-12-28,705,0,705,66,771,0,771,0
48343,2019-12-28,473,0,473,37,510,510,0,0
48344,2019-12-28,224,0,224,17,241,241,0,0
48345,2019-12-28,1174,0,1174,117,1291,1291,0,0
48346,2019-12-28,251,0,251,20,271,271,0,0
48347,2019-12-28,186,0,186,14,200,200,0,0
48348,2019-12-28,399,0,399,31,430,430,0,0
48349,2019-12-28,381,0,381,30,411,411,0,0
48350,2019-12-28,362,0,362,28,390,0,0,390
48351,2019-12-28,1546,0,1546,154,1700,1700,0,0
48352,2019-12-28,2420,0,2420,193,2613,0,2613,0
48353,2019-12-28,380,0,380,30,410,410,0,0
48354,2019-12-28,1983,0,1983,198,2181,0,2181,0
48355,2019-12-28,139,0,139,11,150,150,0,0
48356,2019-12-28,651,0,651,52,703,703,0,0
48357,2019-12-28,223,0,223,17,240,0,240,0
48358,2019-12-28,680,0,680,54,734,734,0,0
48359,2019-12-28,559,0,559,44,603,603,0,0
48360,2019-12-28,1669,0,1669,133,1802,1802,0,0
48361,2019-12-28,343,0,343,27,370,370,0,0
48362,2019-12-28,1179,0,1179,94,1273,1273,0,0
48363,2019-12-28,1546,0,1546,154,1700,0,1700,0
48364,2019-12-28,343,0,343,27,370,370,0,0
48365,2019-12-28,649,0,649,51,700,700,0,0
48366,2019-12-28,149,0,149,11,160,160,0,0
48367,2019-12-28,1233,0,1233,98,1331,1331,0,0
48368,2019-12-28,983,0,983,78,1061,1061,0,0
48369,2019-12-28,139,0,139,11,150,150,0,0
48370,2019-12-28,149,0,149,11,160,160,0,0
48371,2019-12-28,981,0,981,98,1079,1079,0,0
48372,2019-12-28,891,-89,802,80,882,882,0,0
48373,2019-12-28,335,0,335,26,361,361,0,0
48374,2019-12-28,1379,0,1379,137,1516,1516,0,0
48375,2019-12-28,148,0,148,11,159,159,0,0
48376,2019-12-28,697,0,697,55,752,752,0,0
48377,2019-12-28,1206,0,1206,96,1302,1302,0,0
48378,2019-12-28,983,0,983,78,1061,0,0,1061
48379,2019-12-28,1862,0,1862,186,2048,2048,0,0
48380,2019-12-28,1327,0,1327,106,1433,1433,0,0
48381,2019-12-28,510,0,510,40,550,0,0,550
48382,2019-12-28,1250,0,1250,125,1375,1375,0,0
48383,2019-12-28,853,0,853,68,921,921,0,0
48384,2019-12-28,1663,0,1663,166,1829,1829,0,0
48385,2019-12-28,817,0,817,65,882,882,0,0
48386,2019-12-28,315,0,315,25,340,340,0,0
48387,2019-12-28,530,0,530,42,572,572,0,0
48388,2019-12-28,2909,0,2909,283,3192,0,0,3192
48389,2019-12-28,334,0,334,26,360,360,0,0
48390,2019-12-28,1631,0,1631,163,1794,1794,0,0
48391,2019-12-28,547,0,547,54,601,601,0,0
48392,2019-12-28,854,0,854,68,922,922,0,0
48393,2019-12-28,2077,0,2077,207,2284,2284,0,0
48394,2019-12-28,890,0,890,71,961,0,0,961
48395,2019-12-28,204,0,204,20,224,224,0,0
48396,2019-12-28,1683,0,1683,134,1817,1817,0,0
48397,2019-12-28,279,0,279,22,301,301,0,0
48398,2019-12-28,370,0,370,37,407,407,0,0
48399,2019-12-28,372,0,372,29,401,401,0,0
48400,2019-12-28,1179,0,1179,94,1273,0,0,1273
48401,2019-12-28,279,0,279,22,301,0,0,301
48402,2019-12-28,1197,0,1197,119,1316,1316,0,0
48403,2019-12-28,807,0,807,64,871,871,0,0
48404,2019-12-28,1688,0,1688,135,1823,1823,0,0
48405,2019-12-29,1410,0,1410,141,1551,1551,0,0
48406,2019-12-29,603,0,603,48,651,651,0,0
48407,2019-12-29,370,0,370,37,407,407,0,0
48408,2019-12-29,232,0,232,18,250,250,0,0
48409,2019-12-29,529,0,529,42,571,571,0,0
48410,2019-12-29,1187,0,1187,94,1281,1281,0,0
48411,2019-12-29,1523,0,1523,121,1644,0,1644,0
48412,2019-12-29,2351,0,2351,235,2586,0,0,2586
48413,2019-12-29,1235,0,1235,98,1333,1333,0,0
48414,2019-12-29,4455,0,4455,445,4900,4900,0,0
48415,2019-12-29,4455,0,4455,445,4900,0,4900,0
48416,2019-12-29,436,0,436,34,470,470,0,0
48417,2019-12-29,2673,0,2673,267,2940,0,2940,0
48418,2019-12-29,224,0,224,17,241,241,0,0
48419,2019-12-29,761,0,761,60,821,821,0,0
48420,2019-12-29,390,0,390,31,421,421,0,0
48421,2019-12-29,1289,0,1289,128,1417,0,1417,0
48422,2019-12-29,2001,0,2001,160,2161,2161,0,0
48423,2019-12-29,1187,0,1187,94,1281,0,0,1281
48424,2019-12-29,677,0,677,67,744,744,0,0
48425,2019-12-29,334,0,334,26,360,360,0,0
48426,2019-12-29,491,0,491,49,540,0,540,0
48427,2019-12-29,2673,0,2673,267,2940,0,2940,0
48428,2019-12-29,352,0,352,35,387,387,0,0
48429,2019-12-29,491,0,491,49,540,540,0,0
48430,2019-12-29,779,0,779,77,856,856,0,0
48431,2019-12-29,1847,0,1847,147,1994,1994,0,0
48432,2019-12-29,658,0,658,52,710,710,0,0
48433,2019-12-29,478,0,478,38,516,516,0,0
48434,2019-12-29,250,0,250,20,270,270,0,0
48435,2019-12-29,1114,0,1114,89,1203,1203,0,0
48436,2019-12-29,818,0,818,81,899,899,0,0
48437,2019-12-29,1066,0,1066,106,1172,1172,0,0
48438,2019-12-29,696,0,696,55,751,751,0,0
48439,2019-12-29,1931,-193,1738,139,1877,1877,0,0
48440,2019-12-29,437,0,437,34,471,471,0,0
48441,2019-12-29,1110,0,1110,88,1198,1198,0,0
48442,2019-12-29,279,0,279,27,306,306,0,0
48443,2019-12-29,611,0,611,61,672,672,0,0
48444,2019-12-29,316,0,316,25,341,341,0,0
48445,2019-12-29,418,0,418,33,451,451,0,0
48446,2019-12-29,334,0,334,26,360,0,360,0
48447,2019-12-29,260,0,260,20,280,280,0,0
48448,2019-12-29,1782,0,1782,178,1960,0,0,1960
48449,2019-12-29,334,0,334,26,360,360,0,0
48450,2019-12-29,956,0,956,86,1042,1042,0,0
48451,2019-12-29,269,0,269,21,290,290,0,0
48452,2019-12-29,316,0,316,25,341,341,0,0
48453,2019-12-29,408,0,408,32,440,440,0,0
48454,2019-12-29,853,0,853,68,921,0,921,0
48455,2019-12-29,632,0,632,50,682,682,0,0
48456,2019-12-29,861,0,861,86,947,947,0,0
48457,2019-12-29,1636,0,1636,130,1766,1766,0,0
48458,2019-12-29,937,0,937,74,1011,1011,0,0
48459,2019-12-29,696,0,696,55,751,751,0,0
48460,2019-12-29,707,0,707,56,763,0,763,0
48461,2019-12-29,807,0,807,64,871,871,0,0
48462,2019-12-29,604,0,604,48,652,652,0,0
48463,2019-12-29,1529,0,1529,152,1681,0,0,1681
48464,2019-12-29,326,0,326,26,352,352,0,0
48465,2019-12-29,121,0,121,9,130,0,0,130
48466,2019-12-29,891,0,891,89,980,980,0,0
48467,2019-12-29,980,0,980,98,1078,0,1078,0
48468,2019-12-29,270,0,270,27,297,297,0,0
48469,2019-12-29,594,0,594,47,641,641,0,0
48470,2019-12-29,-47,0,-47,-3,-50,0,0,-50
48471,2019-12-29,482,0,482,38,520,520,0,0
48472,2019-12-29,1603,0,1603,128,1731,1731,0,0
48473,2019-12-29,492,0,492,39,531,531,0,0
48474,2019-12-29,270,0,270,21,291,291,0,0
48475,2019-12-29,232,0,232,18,250,0,0,250
48476,2019-12-29,1541,0,1541,123,1664,1664,0,0
48477,2019-12-29,688,0,688,55,743,0,0,743
48478,2019-12-29,789,0,789,63,852,0,852,0
48479,2019-12-29,779,0,779,62,841,0,0,841
48480,2019-12-29,1782,0,1782,178,1960,1960,0,0
48481,2019-12-29,1522,0,1522,121,1643,1643,0,0
48482,2019-12-29,584,0,584,58,642,642,0,0
48483,2019-12-29,1047,0,1047,104,1151,0,1151,0
48484,2019-12-29,740,0,740,74,814,814,0,0
48485,2019-12-29,473,0,473,37,510,510,0,0
48486,2019-12-29,1256,0,1256,125,1381,1381,0,0
48487,2019-12-29,149,0,149,11,160,160,0,0
48488,2019-12-29,47,0,47,3,50,0,0,50
48489,2019-12-29,628,0,628,62,690,690,0,0
48490,2019-12-29,891,0,891,89,980,980,0,0
48491,2019-12-29,1104,0,1104,88,1192,1192,0,0
48492,2019-12-29,473,0,473,37,510,510,0,0
48493,2019-12-29,1047,0,1047,104,1151,1151,0,0
48494,2019-12-29,1399,0,1399,111,1510,1510,0,0
48495,2019-12-29,1640,0,1640,158,1798,1798,0,0
48496,2019-12-29,769,0,769,61,830,0,0,830
48497,2019-12-29,575,0,575,46,621,621,0,0
48498,2019-12-29,2566,0,2566,256,2822,0,2822,0
48499,2019-12-29,3092,0,3092,309,3401,3401,0,0
48500,2019-12-29,241,0,241,19,260,260,0,0
48501,2019-12-29,1546,0,1546,154,1700,0,0,1700
48502,2019-12-29,686,0,686,54,740,740,0,0
48503,2019-12-29,389,0,389,38,427,427,0,0
48504,2019-12-29,1150,0,1150,92,1242,1242,0,0
48505,2019-12-29,714,0,714,71,785,0,785,0
48506,2019-12-29,2474,0,2474,247,2721,2721,0,0
48507,2019-12-29,538,0,538,43,581,581,0,0
48508,2019-12-29,1546,0,1546,154,1700,0,1700,0
48509,2019-12-29,649,0,649,51,700,700,0,0
48510,2019-12-29,1546,0,1546,154,1700,1700,0,0
48511,2019-12-29,399,0,399,31,430,430,0,0
48512,2019-12-29,273,0,273,21,294,294,0,0
48513,2019-12-29,1546,0,1546,154,1700,1700,0,0
48514,2019-12-29,1819,0,1819,181,2000,2000,0,0
48515,2019-12-29,1782,0,1782,178,1960,0,1960,0
48516,2019-12-29,603,0,603,48,651,0,651,0
48517,2019-12-29,269,0,269,21,290,0,0,290
48518,2019-12-29,278,0,278,22,300,300,0,0
48519,2019-12-29,928,0,928,74,1002,1002,0,0
48520,2019-12-29,1799,0,1799,179,1978,1978,0,0
48521,2019-12-29,926,0,926,92,1018,0,1018,0
48522,2019-12-29,760,0,760,76,836,836,0,0
48523,2019-12-29,781,0,781,62,843,843,0,0
48524,2019-12-29,1539,0,1539,153,1692,1692,0,0
48525,2019-12-29,483,0,483,38,521,521,0,0
48526,2019-12-29,278,0,278,22,300,300,0,0
48527,2019-12-29,1436,0,1436,143,1579,0,0,1579
48528,2019-12-29,740,0,740,74,814,814,0,0
48529,2019-12-29,483,0,483,38,521,521,0,0
48530,2019-12-29,362,0,362,28,390,390,0,0
48531,2019-12-29,241,0,241,19,260,260,0,0
48532,2019-12-29,232,-46,186,14,200,200,0,0
48533,2019-12-29,491,0,491,49,540,540,0,0
48534,2019-12-29,1546,0,1546,154,1700,1700,0,0
48535,2019-12-29,278,0,278,22,300,300,0,0
48536,2019-12-29,352,0,352,28,380,380,0,0
48537,2019-12-29,1178,-117,1061,106,1167,1167,0,0
48538,2019-12-29,1483,0,1483,148,1631,1631,0,0
48539,2019-12-29,1252,0,1252,100,1352,1352,0,0
48540,2019-12-29,1546,0,1546,154,1700,0,1700,0
48541,2019-12-29,622,0,622,49,671,671,0,0
48542,2019-12-29,1782,0,1782,178,1960,0,1960,0
48543,2019-12-29,835,0,835,66,901,901,0,0
48544,2019-12-29,688,0,688,55,743,0,0,743
48545,2019-12-29,1187,0,1187,94,1281,1281,0,0
48546,2019-12-29,567,0,567,45,612,612,0,0
48547,2019-12-29,677,0,677,54,731,731,0,0
48548,2019-12-29,445,0,445,35,480,480,0,0
48549,2019-12-29,780,0,780,62,842,842,0,0
48550,2019-12-29,232,0,232,18,250,250,0,0
48551,2019-12-29,520,0,520,41,561,561,0,0
48552,2019-12-29,473,0,473,37,510,510,0,0
48553,2019-12-29,473,0,473,37,510,510,0,0
48554,2019-12-29,872,-87,785,62,847,847,0,0
48555,2019-12-29,1648,0,1648,162,1810,1810,0,0
48556,2019-12-29,630,0,630,63,693,693,0,0
48557,2019-12-29,1546,0,1546,154,1700,1700,0,0
48558,2019-12-29,3092,0,3092,309,3401,3401,0,0
48559,2019-12-29,1546,0,1546,154,1700,1700,0,0
48560,2019-12-29,389,0,389,31,420,0,420,0
48561,2019-12-29,640,0,640,51,691,691,0,0
48562,2019-12-29,269,0,269,21,290,290,0,0
48563,2019-12-29,808,0,808,64,872,872,0,0
48564,2019-12-29,1546,0,1546,154,1700,1700,0,0
48565,2019-12-29,1546,0,1546,154,1700,1700,0,0
48566,2019-12-29,390,-39,351,28,379,0,0,379
48567,2019-12-29,1243,0,1243,99,1342,1342,0,0
48568,2019-12-29,1546,0,1546,154,1700,1700,0,0
48569,2019-12-29,3092,0,3092,309,3401,0,3401,0
48570,2019-12-29,561,0,561,44,605,0,605,0
48571,2019-12-29,2092,0,2092,209,2301,2301,0,0
48572,2019-12-29,612,0,612,61,673,673,0,0
48573,2019-12-29,2662,0,2662,266,2928,0,2928,0
48574,2019-12-29,1546,0,1546,154,1700,1700,0,0
48575,2019-12-29,520,-52,468,37,505,505,0,0
48576,2019-12-29,593,0,593,47,640,640,0,0
48577,2019-12-29,773,0,773,77,850,850,0,0
48578,2019-12-30,455,0,455,36,491,0,0,491
48579,2019-12-30,778,0,778,77,855,855,0,0
48580,2019-12-30,1782,0,1782,178,1960,1960,0,0
48581,2019-12-30,139,0,139,11,150,150,0,0
48582,2019-12-30,139,0,139,11,150,150,0,0
48583,2019-12-30,3564,0,3564,356,3920,3920,0,0
48584,2019-12-30,260,0,260,20,280,280,0,0
48585,2019-12-30,2673,0,2673,267,2940,0,2940,0
48586,2019-12-30,446,0,446,35,481,481,0,0
48587,2019-12-30,1121,0,1121,112,1233,1233,0,0
48588,2019-12-30,585,0,585,46,631,631,0,0
48589,2019-12-30,408,0,408,32,440,440,0,0
48590,2019-12-30,473,0,473,37,510,510,0,0
48591,2019-12-30,726,0,726,58,784,784,0,0
48592,2019-12-30,102,0,102,8,110,110,0,0
48593,2019-12-30,714,0,714,71,785,785,0,0
48594,2019-12-30,2673,0,2673,267,2940,2940,0,0
48595,2019-12-30,705,0,705,66,771,0,0,771
48596,2019-12-30,751,0,751,60,811,811,0,0
48597,2019-12-30,538,-53,485,38,523,523,0,0
48598,2019-12-30,622,0,622,49,671,671,0,0
48599,2019-12-30,363,0,363,29,392,392,0,0
48600,2019-12-30,800,0,800,64,864,864,0,0
48601,2019-12-30,1170,0,1170,93,1263,1263,0,0
48602,2019-12-30,1546,0,1546,154,1700,1700,0,0
48603,2019-12-30,621,0,621,62,683,0,0,683
48604,2019-12-30,1500,0,1500,120,1620,1620,0,0
48605,2019-12-30,2905,0,2905,232,3137,3137,0,0
48606,2019-12-30,787,0,787,78,865,865,0,0
48607,2019-12-30,1782,0,1782,178,1960,1960,0,0
48608,2019-12-30,269,0,269,21,290,290,0,0
48609,2019-12-30,278,0,278,22,300,300,0,0
48610,2019-12-30,779,0,779,62,841,841,0,0
48611,2019-12-30,735,0,735,58,793,793,0,0
48612,2019-12-30,1320,0,1320,105,1425,1425,0,0
48613,2019-12-30,1059,0,1059,105,1164,0,1164,0
48614,2019-12-30,1485,0,1485,118,1603,1603,0,0
48615,2019-12-30,335,0,335,26,361,361,0,0
48616,2019-12-30,1319,0,1319,105,1424,1424,0,0
48617,2019-12-30,2473,0,2473,247,2720,0,2720,0
48618,2019-12-30,417,0,417,33,450,0,0,450
48619,2019-12-30,585,0,585,46,631,0,631,0
48620,2019-12-30,390,0,390,31,421,0,421,0
48621,2019-12-30,232,0,232,18,250,250,0,0
48622,2019-12-30,1298,0,1298,129,1427,1427,0,0
48623,2019-12-30,420,0,420,33,453,0,453,0
48624,2019-12-30,557,0,557,44,601,601,0,0
48625,2019-12-30,336,0,336,26,362,362,0,0
48626,2019-12-30,3715,0,3715,318,4033,4033,0,0
48627,2019-12-30,909,0,909,72,981,981,0,0
48628,2019-12-30,522,0,522,52,574,574,0,0
48629,2019-12-30,260,0,260,20,280,280,0,0
48630,2019-12-30,344,0,344,34,378,378,0,0
48631,2019-12-30,345,0,345,27,372,372,0,0
48632,2019-12-30,557,0,557,46,603,0,603,0
48633,2019-12-30,168,0,168,13,181,181,0,0
48634,2019-12-30,1225,0,1225,98,1323,1323,0,0
48635,2019-12-30,531,0,531,42,573,573,0,0
48636,2019-12-30,706,0,706,56,762,762,0,0
48637,2019-12-30,1177,0,1177,117,1294,1294,0,0
48638,2019-12-30,417,0,417,33,450,450,0,0
48639,2019-12-30,280,0,280,28,308,308,0,0
48640,2019-12-30,1782,0,1782,178,1960,1960,0,0
48641,2019-12-30,605,0,605,48,653,653,0,0
48642,2019-12-30,1269,0,1269,126,1395,1395,0,0
48643,2019-12-30,630,0,630,63,693,693,0,0
48644,2019-12-30,1251,0,1251,125,1376,1376,0,0
48645,2019-12-30,334,0,334,26,360,360,0,0
48646,2019-12-30,445,0,445,44,489,489,0,0
48647,2019-12-30,854,0,854,85,939,939,0,0
48648,2019-12-30,611,0,611,61,672,672,0,0
48649,2019-12-30,537,0,537,53,590,590,0,0
48650,2019-12-30,390,0,390,31,421,0,0,421
48651,2019-12-30,1327,0,1327,106,1433,1433,0,0
48652,2019-12-30,706,0,706,56,762,762,0,0
48653,2019-12-30,743,0,743,59,802,802,0,0
48654,2019-12-30,1531,0,1531,153,1684,1684,0,0
48655,2019-12-30,621,0,621,49,670,670,0,0
48656,2019-12-30,1279,0,1279,127,1406,1406,0,0
48657,2019-12-30,1472,0,1472,147,1619,1619,0,0
48658,2019-12-30,1727,0,1727,138,1865,1865,0,0
48659,2019-12-30,1012,0,1012,80,1092,1092,0,0
48660,2019-12-30,370,0,370,37,407,407,0,0
48661,2019-12-30,1546,0,1546,154,1700,1700,0,0
48662,2019-12-30,2319,0,2319,231,2550,0,0,2550
48663,2019-12-30,2159,0,2159,215,2374,2374,0,0
48664,2019-12-30,584,0,584,46,630,630,0,0
48665,2019-12-30,273,0,273,27,300,0,0,300
48666,2019-12-30,1546,0,1546,154,1700,1700,0,0
48667,2019-12-30,2037,0,2037,203,2240,0,2240,0
48668,2019-12-30,232,0,232,18,250,0,0,250
48669,2019-12-30,2774,0,2774,221,2995,0,0,2995
48670,2019-12-30,1546,0,1546,154,1700,1700,0,0
48671,2019-12-30,1997,0,1997,159,2156,2156,0,0
48672,2019-12-30,2032,0,2032,162,2194,2194,0,0
48673,2019-12-30,546,0,546,54,600,600,0,0
48674,2019-12-30,752,0,752,60,812,812,0,0
48675,2019-12-30,446,0,446,35,481,481,0,0
48676,2019-12-30,5594,0,5594,447,6041,6041,0,0
48677,2019-12-30,529,0,529,42,571,571,0,0
48678,2019-12-30,279,0,279,22,301,301,0,0
48679,2019-12-30,1104,0,1104,88,1192,0,1192,0
48680,2019-12-30,102,0,102,8,110,110,0,0
48681,2019-12-30,370,0,370,37,407,407,0,0
48682,2019-12-30,1251,0,1251,125,1376,1376,0,0
48683,2019-12-30,1928,0,1928,183,2111,2111,0,0
48684,2019-12-30,429,0,429,34,463,463,0,0
48685,2019-12-30,2095,0,2095,197,2292,2292,0,0
48686,2019-12-30,771,0,771,61,832,832,0,0
48687,2019-12-30,2662,0,2662,212,2874,2874,0,0
48688,2019-12-30,539,0,539,53,592,592,0,0
48689,2019-12-30,1440,0,1440,115,1555,1555,0,0
48690,2019-12-30,678,0,678,54,732,732,0,0
48691,2019-12-30,603,0,603,48,651,651,0,0
48692,2019-12-30,1019,0,1019,101,1120,0,1120,0
48693,2019-12-30,936,0,936,74,1010,1010,0,0
48694,2019-12-30,1446,0,1446,144,1590,1590,0,0
48695,2019-12-30,408,0,408,32,440,0,0,440
48696,2019-12-30,1287,0,1287,128,1415,1415,0,0
48697,2019-12-30,1287,0,1287,128,1415,0,1415,0
48698,2019-12-30,2319,0,2319,231,2550,2550,0,0
48699,2019-12-30,1546,0,1546,154,1700,1700,0,0
48700,2019-12-30,1409,0,1409,140,1549,1549,0,0
48701,2019-12-30,1380,0,1380,138,1518,0,0,1518
48702,2019-12-30,567,0,567,45,612,612,0,0
48703,2019-12-30,937,0,937,74,1011,1011,0,0
48704,2019-12-30,511,0,511,40,551,551,0,0
48705,2019-12-30,176,0,176,14,190,190,0,0
48706,2019-12-30,2319,0,2319,231,2550,2550,0,0
48707,2019-12-30,740,0,740,74,814,814,0,0
48708,2019-12-30,1364,0,1364,109,1473,1473,0,0
48709,2019-12-30,372,0,372,29,401,401,0,0
48710,2019-12-30,1546,0,1546,154,1700,0,1700,0
48711,2019-12-30,1546,0,1546,154,1700,1700,0,0
48712,2019-12-30,797,0,797,63,860,860,0,0
48713,2019-12-30,603,0,603,48,651,0,0,651
48714,2019-12-30,1002,0,1002,80,1082,1082,0,0
48715,2019-12-30,391,0,391,31,422,422,0,0
48716,2019-12-30,928,0,928,74,1002,1002,0,0
48717,2019-12-30,1546,0,1546,154,1700,0,0,1700
48718,2019-12-30,722,0,722,72,794,794,0,0
48719,2019-12-30,1874,0,1874,149,2023,2023,0,0
48720,2019-12-30,907,0,907,90,997,997,0,0
48721,2019-12-30,1040,0,1040,83,1123,1123,0,0
48722,2019-12-30,2495,0,2495,249,2744,2744,0,0
48723,2019-12-30,436,-43,393,31,424,424,0,0
48724,2019-12-30,1251,0,1251,100,1351,1351,0,0
48725,2019-12-30,773,0,773,77,850,850,0,0
48726,2019-12-30,1546,0,1546,154,1700,1700,0,0
48727,2019-12-30,1886,0,1886,188,2074,2074,0,0
48728,2019-12-30,864,0,864,69,933,933,0,0
48729,2019-12-30,1983,0,1983,198,2181,2181,0,0
48730,2019-12-30,3138,0,3138,313,3451,3451,0,0
48731,2019-12-30,1307,0,1307,104,1411,1411,0,0
48732,2019-12-30,389,0,389,38,427,427,0,0
48733,2019-12-30,1270,0,1270,127,1397,1397,0,0
48734,2019-12-30,773,0,773,77,850,850,0,0
48735,2019-12-30,659,0,659,52,711,711,0,0
48736,2019-12-30,955,0,955,76,1031,1031,0,0
48737,2019-12-30,446,0,446,35,481,481,0,0
48738,2019-12-30,2300,0,2300,184,2484,2484,0,0
48739,2019-12-30,1086,0,1086,86,1172,1172,0,0
48740,2019-12-30,491,-49,442,35,477,477,0,0
48741,2019-12-30,308,0,308,24,332,332,0,0
